"Codi Província";"Nom Província";"Codi Vegueria";"Nom Vegueria";"Codi Comarca";"Nom Comarca";"Codi Municipi";"Nom Municipi";"Districte";"Secció";"Mesa";"Cens electoral";"Participació 13:00";"Participació 18.00";"Participació 20.00";"Abstenció";"Vots nuls";"Vots en blanc";"Vots a candidatures";"Vots vàlids"
"8";"Barcelona";"1";"Barcelona";"11";"Baix Llobregat";"08001";"Abrera";"1";"1";"A";"380";"144";"253";"302";"78";"4";"1";"297";"298"
"8";"Barcelona";"1";"Barcelona";"11";"Baix Llobregat";"08001";"Abrera";"1";"1";"B";"368";"140";"241";"299";"69";"1";"1";"297";"298"
"8";"Barcelona";"1";"Barcelona";"11";"Baix Llobregat";"08001";"Abrera";"1";"1";"C";"408";"164";"267";"329";"79";"2";"0";"327";"327"
"8";"Barcelona";"1";"Barcelona";"11";"Baix Llobregat";"08001";"Abrera";"1";"2";"A";"395";"163";"264";"315";"80";"0";"1";"314";"315"
"8";"Barcelona";"1";"Barcelona";"11";"Baix Llobregat";"08001";"Abrera";"1";"2";"B";"423";"152";"263";"331";"92";"0";"3";"328";"331"
"8";"Barcelona";"1";"Barcelona";"11";"Baix Llobregat";"08001";"Abrera";"1";"2";"C";"423";"157";"273";"326";"97";"0";"2";"324";"326"
"8";"Barcelona";"1";"Barcelona";"11";"Baix Llobregat";"08001";"Abrera";"1";"3";"U";"570";"227";"393";"477";"93";"3";"1";"473";"474"
"8";"Barcelona";"1";"Barcelona";"11";"Baix Llobregat";"08001";"Abrera";"1";"4";"A";"816";"310";"529";"670";"146";"1";"3";"666";"669"
"8";"Barcelona";"1";"Barcelona";"11";"Baix Llobregat";"08001";"Abrera";"1";"4";"B";"481";"148";"309";"401";"80";"2";"5";"394";"399"
"8";"Barcelona";"1";"Barcelona";"11";"Baix Llobregat";"08001";"Abrera";"1";"5";"A";"649";"243";"394";"483";"166";"2";"4";"477";"481"
"8";"Barcelona";"1";"Barcelona";"11";"Baix Llobregat";"08001";"Abrera";"1";"5";"B";"707";"281";"442";"546";"161";"0";"4";"542";"546"
"8";"Barcelona";"1";"Barcelona";"11";"Baix Llobregat";"08001";"Abrera";"1";"7";"A";"526";"200";"321";"418";"108";"2";"1";"415";"416"
"8";"Barcelona";"1";"Barcelona";"11";"Baix Llobregat";"08001";"Abrera";"1";"7";"B";"627";"238";"404";"491";"136";"6";"2";"483";"485"
"8";"Barcelona";"1";"Barcelona";"11";"Baix Llobregat";"08001";"Abrera";"1";"7";"C";"684";"276";"430";"556";"128";"0";"4";"552";"556"
"8";"Barcelona";"1";"Barcelona";"11";"Baix Llobregat";"08001";"Abrera";"1";"8";"A";"619";"222";"403";"505";"114";"5";"3";"497";"500"
"8";"Barcelona";"1";"Barcelona";"11";"Baix Llobregat";"08001";"Abrera";"1";"8";"B";"752";"264";"487";"624";"128";"0";"5";"619";"624"
"8";"Barcelona";"1";"Barcelona";"41";"Vallès Oriental";"08014";"Aiguafreda";"1";"1";"A";"638";"261";"440";"530";"108";"3";"0";"527";"527"
"8";"Barcelona";"1";"Barcelona";"41";"Vallès Oriental";"08014";"Aiguafreda";"1";"1";"B";"570";"216";"401";"467";"103";"3";"5";"459";"464"
"8";"Barcelona";"1";"Barcelona";"41";"Vallès Oriental";"08014";"Aiguafreda";"1";"1";"C";"751";"308";"536";"643";"108";"1";"1";"641";"642"
"8";"Barcelona";"1";"Barcelona";"21";"Maresme";"08003";"Alella";"1";"1";"A";"655";"248";"444";"554";"101";"3";"5";"546";"551"
"8";"Barcelona";"1";"Barcelona";"21";"Maresme";"08003";"Alella";"1";"1";"B";"634";"258";"441";"528";"106";"1";"4";"523";"527"
"8";"Barcelona";"1";"Barcelona";"21";"Maresme";"08003";"Alella";"1";"1";"C";"669";"269";"473";"557";"112";"3";"5";"549";"554"
"8";"Barcelona";"1";"Barcelona";"21";"Maresme";"08003";"Alella";"1";"2";"A";"818";"300";"550";"671";"147";"2";"3";"666";"669"
"8";"Barcelona";"1";"Barcelona";"21";"Maresme";"08003";"Alella";"1";"2";"B";"986";"348";"675";"805";"181";"0";"2";"803";"805"
"8";"Barcelona";"1";"Barcelona";"21";"Maresme";"08003";"Alella";"1";"3";"A";"835";"300";"567";"684";"151";"0";"1";"683";"684"
"8";"Barcelona";"1";"Barcelona";"21";"Maresme";"08003";"Alella";"1";"3";"B";"876";"311";"593";"738";"138";"0";"1";"737";"738"
"8";"Barcelona";"1";"Barcelona";"21";"Maresme";"08003";"Alella";"1";"4";"A";"769";"314";"540";"631";"138";"3";"4";"624";"628"
"8";"Barcelona";"1";"Barcelona";"21";"Maresme";"08003";"Alella";"1";"4";"B";"876";"290";"567";"717";"159";"3";"3";"711";"714"
"8";"Barcelona";"1";"Barcelona";"41";"Vallès Oriental";"08005";"Ametlla del Vallès, l'";"1";"1";"A";"562";"164";"332";"427";"135";"1";"1";"425";"426"
"8";"Barcelona";"1";"Barcelona";"41";"Vallès Oriental";"08005";"Ametlla del Vallès, l'";"1";"1";"B";"646";"216";"392";"501";"145";"2";"5";"494";"499"
"8";"Barcelona";"1";"Barcelona";"41";"Vallès Oriental";"08005";"Ametlla del Vallès, l'";"1";"1";"C";"548";"172";"342";"445";"103";"1";"1";"443";"444"
"8";"Barcelona";"1";"Barcelona";"41";"Vallès Oriental";"08005";"Ametlla del Vallès, l'";"1";"2";"A";"626";"247";"433";"525";"101";"0";"0";"525";"525"
"8";"Barcelona";"1";"Barcelona";"41";"Vallès Oriental";"08005";"Ametlla del Vallès, l'";"1";"2";"B";"650";"274";"461";"536";"114";"0";"2";"534";"536"
"8";"Barcelona";"1";"Barcelona";"41";"Vallès Oriental";"08005";"Ametlla del Vallès, l'";"1";"3";"A";"609";"230";"435";"528";"81";"0";"1";"527";"528"
"8";"Barcelona";"1";"Barcelona";"41";"Vallès Oriental";"08005";"Ametlla del Vallès, l'";"1";"3";"B";"580";"203";"385";"479";"101";"2";"2";"475";"477"
"8";"Barcelona";"1";"Barcelona";"41";"Vallès Oriental";"08005";"Ametlla del Vallès, l'";"1";"3";"C";"596";"230";"419";"507";"89";"1";"2";"504";"506"
"8";"Barcelona";"1";"Barcelona";"41";"Vallès Oriental";"08005";"Ametlla del Vallès, l'";"1";"4";"A";"368";"122";"241";"293";"75";"2";"0";"291";"291"
"8";"Barcelona";"1";"Barcelona";"41";"Vallès Oriental";"08005";"Ametlla del Vallès, l'";"1";"4";"B";"400";"147";"261";"341";"59";"0";"4";"337";"341"
"8";"Barcelona";"1";"Barcelona";"41";"Vallès Oriental";"08005";"Ametlla del Vallès, l'";"1";"5";"U";"572";"202";"391";"480";"92";"0";"0";"480";"480"
"8";"Barcelona";"1";"Barcelona";"21";"Maresme";"08006";"Arenys de Mar";"1";"1";"A";"791";"311";"527";"627";"164";"2";"0";"625";"625"
"8";"Barcelona";"1";"Barcelona";"21";"Maresme";"08006";"Arenys de Mar";"1";"1";"B";"916";"339";"612";"733";"183";"2";"1";"730";"731"
"8";"Barcelona";"1";"Barcelona";"21";"Maresme";"08006";"Arenys de Mar";"1";"2";"A";"511";"231";"347";"416";"95";"0";"2";"414";"416"
"8";"Barcelona";"1";"Barcelona";"21";"Maresme";"08006";"Arenys de Mar";"1";"2";"B";"592";"245";"380";"460";"132";"1";"2";"457";"459"
"8";"Barcelona";"1";"Barcelona";"21";"Maresme";"08006";"Arenys de Mar";"1";"2";"C";"524";"212";"367";"430";"94";"1";"1";"428";"429"
"8";"Barcelona";"1";"Barcelona";"21";"Maresme";"08006";"Arenys de Mar";"1";"3";"A";"430";"132";"251";"310";"120";"1";"1";"308";"309"
"8";"Barcelona";"1";"Barcelona";"21";"Maresme";"08006";"Arenys de Mar";"1";"3";"B";"501";"191";"312";"381";"120";"1";"2";"378";"380"
"8";"Barcelona";"1";"Barcelona";"21";"Maresme";"08006";"Arenys de Mar";"1";"4";"U";"840";"310";"529";"631";"209";"2";"1";"628";"629"
"8";"Barcelona";"1";"Barcelona";"21";"Maresme";"08006";"Arenys de Mar";"2";"1";"A";"608";"229";"374";"444";"164";"2";"2";"440";"442"
"8";"Barcelona";"1";"Barcelona";"21";"Maresme";"08006";"Arenys de Mar";"2";"1";"B";"684";"259";"430";"514";"170";"5";"3";"506";"509"
"8";"Barcelona";"1";"Barcelona";"21";"Maresme";"08006";"Arenys de Mar";"2";"2";"A";"672";"261";"456";"539";"133";"2";"3";"534";"537"
"8";"Barcelona";"1";"Barcelona";"21";"Maresme";"08006";"Arenys de Mar";"2";"2";"B";"712";"300";"493";"580";"132";"1";"3";"576";"579"
"8";"Barcelona";"1";"Barcelona";"21";"Maresme";"08006";"Arenys de Mar";"2";"3";"A";"634";"224";"382";"460";"174";"0";"4";"456";"460"
"8";"Barcelona";"1";"Barcelona";"21";"Maresme";"08006";"Arenys de Mar";"2";"3";"B";"773";"264";"473";"568";"205";"1";"4";"563";"567"
"8";"Barcelona";"1";"Barcelona";"21";"Maresme";"08006";"Arenys de Mar";"2";"4";"A";"538";"169";"341";"406";"132";"2";"1";"403";"404"
"8";"Barcelona";"1";"Barcelona";"21";"Maresme";"08006";"Arenys de Mar";"2";"4";"B";"652";"193";"388";"477";"175";"3";"3";"471";"474"
"8";"Barcelona";"1";"Barcelona";"21";"Maresme";"08006";"Arenys de Mar";"2";"5";"U";"1055";"343";"718";"830";"225";"1";"8";"821";"829"
"8";"Barcelona";"1";"Barcelona";"21";"Maresme";"08007";"Arenys de Munt";"1";"1";"A";"515";"162";"316";"391";"124";"1";"3";"387";"390"
"8";"Barcelona";"1";"Barcelona";"21";"Maresme";"08007";"Arenys de Munt";"1";"1";"B";"616";"241";"410";"507";"109";"1";"1";"505";"506"
"8";"Barcelona";"1";"Barcelona";"21";"Maresme";"08007";"Arenys de Munt";"1";"2";"A";"562";"237";"387";"473";"89";"1";"3";"469";"472"
"8";"Barcelona";"1";"Barcelona";"21";"Maresme";"08007";"Arenys de Munt";"1";"2";"B";"422";"182";"296";"347";"75";"2";"4";"341";"345"
"8";"Barcelona";"1";"Barcelona";"21";"Maresme";"08007";"Arenys de Munt";"1";"2";"C";"612";"233";"419";"516";"96";"2";"3";"511";"514"
"8";"Barcelona";"1";"Barcelona";"21";"Maresme";"08007";"Arenys de Munt";"1";"2";"D";"591";"255";"428";"496";"95";"0";"0";"496";"496"
"8";"Barcelona";"1";"Barcelona";"21";"Maresme";"08007";"Arenys de Munt";"2";"1";"A";"539";"231";"386";"473";"66";"1";"1";"471";"472"
"8";"Barcelona";"1";"Barcelona";"21";"Maresme";"08007";"Arenys de Munt";"2";"1";"B";"571";"241";"390";"467";"104";"3";"0";"464";"464"
"8";"Barcelona";"1";"Barcelona";"21";"Maresme";"08007";"Arenys de Munt";"2";"1";"C";"490";"226";"368";"425";"65";"2";"0";"423";"423"
"8";"Barcelona";"1";"Barcelona";"21";"Maresme";"08007";"Arenys de Munt";"2";"2";"A";"523";"213";"339";"411";"112";"0";"2";"409";"411"
"8";"Barcelona";"1";"Barcelona";"21";"Maresme";"08007";"Arenys de Munt";"2";"2";"B";"515";"176";"306";"394";"121";"3";"2";"389";"391"
"8";"Barcelona";"1";"Barcelona";"21";"Maresme";"08007";"Arenys de Munt";"2";"2";"C";"558";"222";"371";"454";"104";"3";"2";"449";"451"
"8";"Barcelona";"1";"Barcelona";"21";"Maresme";"08009";"Argentona";"1";"1";"A";"298";"124";"202";"253";"45";"0";"3";"250";"253"
"8";"Barcelona";"1";"Barcelona";"21";"Maresme";"08009";"Argentona";"1";"1";"B";"314";"141";"212";"261";"53";"0";"2";"259";"261"
"8";"Barcelona";"1";"Barcelona";"21";"Maresme";"08009";"Argentona";"1";"2";"A";"565";"239";"388";"467";"98";"0";"1";"466";"467"
"8";"Barcelona";"1";"Barcelona";"21";"Maresme";"08009";"Argentona";"1";"2";"B";"638";"240";"433";"536";"102";"1";"1";"534";"535"
"8";"Barcelona";"1";"Barcelona";"21";"Maresme";"08009";"Argentona";"1";"3";"A";"382";"137";"248";"286";"96";"2";"3";"281";"284"
"8";"Barcelona";"1";"Barcelona";"21";"Maresme";"08009";"Argentona";"1";"3";"B";"467";"156";"291";"341";"126";"2";"2";"337";"339"
"8";"Barcelona";"1";"Barcelona";"21";"Maresme";"08009";"Argentona";"1";"4";"A";"602";"203";"367";"450";"152";"4";"3";"443";"446"
"8";"Barcelona";"1";"Barcelona";"21";"Maresme";"08009";"Argentona";"1";"4";"B";"764";"295";"464";"587";"177";"1";"1";"585";"586"
"8";"Barcelona";"1";"Barcelona";"21";"Maresme";"08009";"Argentona";"1";"5";"A";"374";"151";"270";"330";"44";"0";"0";"330";"330"
"8";"Barcelona";"1";"Barcelona";"21";"Maresme";"08009";"Argentona";"1";"5";"B";"414";"169";"284";"356";"58";"2";"0";"354";"354"
"8";"Barcelona";"1";"Barcelona";"21";"Maresme";"08009";"Argentona";"1";"6";"A";"524";"188";"365";"441";"83";"2";"3";"436";"439"
"8";"Barcelona";"1";"Barcelona";"21";"Maresme";"08009";"Argentona";"1";"6";"B";"512";"237";"380";"443";"69";"1";"0";"442";"442"
"8";"Barcelona";"1";"Barcelona";"21";"Maresme";"08009";"Argentona";"1";"6";"C";"410";"176";"291";"352";"58";"1";"1";"350";"351"
"8";"Barcelona";"1";"Barcelona";"21";"Maresme";"08009";"Argentona";"2";"1";"A";"627";"233";"410";"504";"123";"1";"4";"499";"503"
"8";"Barcelona";"1";"Barcelona";"21";"Maresme";"08009";"Argentona";"2";"1";"B";"618";"231";"416";"499";"119";"0";"4";"495";"499"
"8";"Barcelona";"1";"Barcelona";"21";"Maresme";"08009";"Argentona";"2";"1";"C";"620";"247";"432";"522";"98";"3";"3";"516";"519"
"8";"Barcelona";"1";"Barcelona";"21";"Maresme";"08009";"Argentona";"2";"2";"A";"470";"190";"331";"397";"73";"0";"3";"394";"397"
"8";"Barcelona";"1";"Barcelona";"21";"Maresme";"08009";"Argentona";"2";"2";"B";"524";"185";"357";"429";"95";"2";"3";"424";"427"
"8";"Barcelona";"1";"Barcelona";"3";"Alt Penedès";"08013";"Avinyonet del Penedès";"1";"1";"A";"584";"198";"376";"466";"118";"2";"3";"461";"464"
"8";"Barcelona";"1";"Barcelona";"3";"Alt Penedès";"08013";"Avinyonet del Penedès";"1";"1";"B";"640";"275";"446";"531";"109";"4";"2";"525";"527"
"8";"Barcelona";"1";"Barcelona";"13";"Barcelonès";"08015";"Badalona";"1";"1";"A";"519";"232";"411";"458";"61";"0";"0";"458";"458"
"8";"Barcelona";"1";"Barcelona";"13";"Barcelonès";"08015";"Badalona";"1";"1";"B";"616";"240";"439";"520";"96";"0";"0";"520";"520"
"8";"Barcelona";"1";"Barcelona";"13";"Barcelonès";"08015";"Badalona";"1";"2";"A";"392";"156";"267";"319";"73";"0";"6";"313";"319"
"8";"Barcelona";"1";"Barcelona";"13";"Barcelonès";"08015";"Badalona";"1";"2";"B";"563";"208";"377";"461";"102";"2";"2";"457";"459"
"8";"Barcelona";"1";"Barcelona";"13";"Barcelonès";"08015";"Badalona";"1";"3";"U";"764";"276";"573";"647";"117";"1";"3";"643";"646"
"8";"Barcelona";"1";"Barcelona";"13";"Barcelonès";"08015";"Badalona";"1";"4";"U";"672";"264";"474";"583";"89";"1";"2";"580";"582"
"8";"Barcelona";"1";"Barcelona";"13";"Barcelonès";"08015";"Badalona";"1";"5";"A";"543";"244";"405";"456";"87";"1";"2";"453";"455"
"8";"Barcelona";"1";"Barcelona";"13";"Barcelonès";"08015";"Badalona";"1";"5";"B";"587";"265";"427";"495";"92";"3";"2";"490";"492"
"8";"Barcelona";"1";"Barcelona";"13";"Barcelonès";"08015";"Badalona";"1";"7";"A";"418";"165";"302";"355";"63";"1";"2";"352";"354"
"8";"Barcelona";"1";"Barcelona";"13";"Barcelonès";"08015";"Badalona";"1";"7";"B";"547";"210";"387";"472";"75";"1";"1";"470";"471"
"8";"Barcelona";"1";"Barcelona";"13";"Barcelonès";"08015";"Badalona";"1";"8";"U";"502";"232";"379";"432";"70";"0";"2";"430";"432"
"8";"Barcelona";"1";"Barcelona";"13";"Barcelonès";"08015";"Badalona";"2";"1";"U";"999";"271";"600";"741";"258";"3";"2";"736";"738"
"8";"Barcelona";"1";"Barcelona";"13";"Barcelonès";"08015";"Badalona";"2";"10";"A";"492";"170";"277";"340";"152";"2";"0";"338";"338"
"8";"Barcelona";"1";"Barcelona";"13";"Barcelonès";"08015";"Badalona";"2";"10";"B";"567";"191";"296";"380";"187";"2";"1";"377";"378"
"8";"Barcelona";"1";"Barcelona";"13";"Barcelonès";"08015";"Badalona";"2";"11";"A";"561";"229";"327";"411";"150";"2";"1";"408";"409"
"8";"Barcelona";"1";"Barcelona";"13";"Barcelonès";"08015";"Badalona";"2";"11";"B";"651";"251";"379";"491";"160";"3";"3";"485";"488"
"8";"Barcelona";"1";"Barcelona";"13";"Barcelonès";"08015";"Badalona";"2";"12";"U";"805";"311";"495";"564";"241";"2";"4";"558";"562"
"8";"Barcelona";"1";"Barcelona";"13";"Barcelonès";"08015";"Badalona";"2";"13";"U";"831";"312";"495";"606";"225";"3";"1";"602";"603"
"8";"Barcelona";"1";"Barcelona";"13";"Barcelonès";"08015";"Badalona";"2";"15";"U";"774";"280";"467";"561";"213";"6";"5";"550";"555"
"8";"Barcelona";"1";"Barcelona";"13";"Barcelonès";"08015";"Badalona";"2";"2";"A";"622";"261";"455";"544";"78";"0";"2";"542";"544"
"8";"Barcelona";"1";"Barcelona";"13";"Barcelonès";"08015";"Badalona";"2";"2";"B";"683";"264";"492";"591";"92";"3";"1";"587";"588"
"8";"Barcelona";"1";"Barcelona";"13";"Barcelonès";"08015";"Badalona";"2";"3";"U";"692";"248";"501";"584";"108";"1";"3";"580";"583"
"8";"Barcelona";"1";"Barcelona";"13";"Barcelonès";"08015";"Badalona";"2";"4";"A";"784";"264";"537";"667";"117";"2";"4";"661";"665"
"8";"Barcelona";"1";"Barcelona";"13";"Barcelonès";"08015";"Badalona";"2";"4";"B";"780";"249";"519";"666";"114";"3";"1";"662";"663"
"8";"Barcelona";"1";"Barcelona";"13";"Barcelonès";"08015";"Badalona";"2";"5";"U";"929";"267";"530";"650";"279";"4";"0";"646";"646"
"8";"Barcelona";"1";"Barcelona";"13";"Barcelonès";"08015";"Badalona";"2";"7";"U";"908";"308";"500";"626";"282";"3";"2";"621";"623"
"8";"Barcelona";"1";"Barcelona";"13";"Barcelonès";"08015";"Badalona";"2";"8";"A";"842";"322";"595";"716";"126";"2";"3";"711";"714"
"8";"Barcelona";"1";"Barcelona";"13";"Barcelonès";"08015";"Badalona";"2";"8";"B";"835";"323";"594";"699";"136";"2";"1";"696";"697"
"8";"Barcelona";"1";"Barcelona";"13";"Barcelonès";"08015";"Badalona";"2";"9";"U";"776";"243";"384";"479";"297";"0";"2";"477";"479"
"8";"Barcelona";"1";"Barcelona";"13";"Barcelonès";"08015";"Badalona";"3";"1";"A";"767";"281";"472";"576";"191";"1";"4";"571";"575"
"8";"Barcelona";"1";"Barcelona";"13";"Barcelonès";"08015";"Badalona";"3";"1";"B";"835";"293";"496";"653";"182";"4";"8";"641";"649"
"8";"Barcelona";"1";"Barcelona";"13";"Barcelonès";"08015";"Badalona";"3";"10";"U";"741";"301";"479";"582";"159";"3";"9";"570";"579"
"8";"Barcelona";"1";"Barcelona";"13";"Barcelonès";"08015";"Badalona";"3";"11";"U";"851";"300";"540";"687";"164";"1";"1";"685";"686"
"8";"Barcelona";"1";"Barcelona";"13";"Barcelonès";"08015";"Badalona";"3";"13";"A";"578";"194";"379";"486";"92";"0";"1";"485";"486"
"8";"Barcelona";"1";"Barcelona";"13";"Barcelonès";"08015";"Badalona";"3";"13";"B";"644";"209";"408";"533";"111";"1";"7";"525";"532"
"8";"Barcelona";"1";"Barcelona";"13";"Barcelonès";"08015";"Badalona";"3";"13";"C";"704";"229";"464";"590";"114";"0";"2";"588";"590"
"8";"Barcelona";"1";"Barcelona";"13";"Barcelonès";"08015";"Badalona";"3";"3";"A";"661";"240";"427";"520";"141";"3";"2";"515";"517"
"8";"Barcelona";"1";"Barcelona";"13";"Barcelonès";"08015";"Badalona";"3";"3";"B";"686";"237";"458";"560";"126";"4";"0";"556";"556"
"8";"Barcelona";"1";"Barcelona";"13";"Barcelonès";"08015";"Badalona";"3";"4";"A";"615";"201";"390";"500";"115";"3";"5";"492";"497"
"8";"Barcelona";"1";"Barcelona";"13";"Barcelonès";"08015";"Badalona";"3";"4";"B";"697";"237";"436";"588";"109";"1";"3";"584";"587"
"8";"Barcelona";"1";"Barcelona";"13";"Barcelonès";"08015";"Badalona";"3";"5";"U";"985";"345";"576";"707";"278";"0";"2";"705";"707"
"8";"Barcelona";"1";"Barcelona";"13";"Barcelonès";"08015";"Badalona";"3";"6";"U";"925";"326";"659";"799";"126";"0";"5";"794";"799"
"8";"Barcelona";"1";"Barcelona";"13";"Barcelonès";"08015";"Badalona";"3";"7";"A";"485";"202";"329";"420";"65";"2";"1";"417";"418"
"8";"Barcelona";"1";"Barcelona";"13";"Barcelonès";"08015";"Badalona";"3";"7";"B";"531";"236";"386";"463";"68";"1";"2";"460";"462"
"8";"Barcelona";"1";"Barcelona";"13";"Barcelonès";"08015";"Badalona";"3";"8";"U";"512";"190";"351";"422";"90";"0";"1";"421";"422"
"8";"Barcelona";"1";"Barcelona";"13";"Barcelonès";"08015";"Badalona";"3";"9";"A";"685";"289";"479";"568";"117";"4";"1";"563";"564"
"8";"Barcelona";"1";"Barcelona";"13";"Barcelonès";"08015";"Badalona";"3";"9";"B";"735";"304";"526";"615";"120";"4";"1";"610";"611"
"8";"Barcelona";"1";"Barcelona";"13";"Barcelonès";"08015";"Badalona";"4";"1";"A";"728";"207";"406";"515";"213";"2";"3";"510";"513"
"8";"Barcelona";"1";"Barcelona";"13";"Barcelonès";"08015";"Badalona";"4";"1";"B";"801";"254";"500";"608";"193";"1";"2";"605";"607"
"8";"Barcelona";"1";"Barcelona";"13";"Barcelonès";"08015";"Badalona";"4";"10";"U";"924";"257";"537";"636";"288";"5";"0";"631";"631"
"8";"Barcelona";"1";"Barcelona";"13";"Barcelonès";"08015";"Badalona";"4";"11";"A";"501";"203";"328";"393";"108";"0";"2";"391";"393"
"8";"Barcelona";"1";"Barcelona";"13";"Barcelonès";"08015";"Badalona";"4";"11";"B";"601";"235";"389";"475";"126";"3";"3";"469";"472"
"8";"Barcelona";"1";"Barcelona";"13";"Barcelonès";"08015";"Badalona";"4";"12";"A";"508";"159";"269";"347";"161";"0";"2";"345";"347"
"8";"Barcelona";"1";"Barcelona";"13";"Barcelonès";"08015";"Badalona";"4";"12";"B";"609";"207";"370";"460";"149";"0";"5";"455";"460"
"8";"Barcelona";"1";"Barcelona";"13";"Barcelonès";"08015";"Badalona";"4";"13";"U";"896";"302";"594";"749";"147";"7";"2";"740";"742"
"8";"Barcelona";"1";"Barcelona";"13";"Barcelonès";"08015";"Badalona";"4";"14";"A";"531";"191";"363";"456";"75";"1";"2";"453";"455"
"8";"Barcelona";"1";"Barcelona";"13";"Barcelonès";"08015";"Badalona";"4";"14";"B";"700";"171";"455";"602";"98";"6";"0";"596";"596"
"8";"Barcelona";"1";"Barcelona";"13";"Barcelonès";"08015";"Badalona";"4";"14";"C";"704";"225";"461";"597";"107";"0";"0";"597";"597"
"8";"Barcelona";"1";"Barcelona";"13";"Barcelonès";"08015";"Badalona";"4";"15";"A";"484";"130";"306";"393";"91";"3";"0";"390";"390"
"8";"Barcelona";"1";"Barcelona";"13";"Barcelonès";"08015";"Badalona";"4";"15";"B";"579";"179";"371";"460";"119";"1";"3";"456";"459"
"8";"Barcelona";"1";"Barcelona";"13";"Barcelonès";"08015";"Badalona";"4";"16";"A";"646";"220";"424";"545";"101";"2";"3";"540";"543"
"8";"Barcelona";"1";"Barcelona";"13";"Barcelonès";"08015";"Badalona";"4";"16";"B";"814";"248";"537";"668";"146";"4";"5";"659";"664"
"8";"Barcelona";"1";"Barcelona";"13";"Barcelonès";"08015";"Badalona";"4";"2";"A";"537";"213";"353";"430";"107";"0";"2";"428";"430"
"8";"Barcelona";"1";"Barcelona";"13";"Barcelonès";"08015";"Badalona";"4";"2";"B";"674";"257";"453";"543";"131";"0";"2";"541";"543"
"8";"Barcelona";"1";"Barcelona";"13";"Barcelonès";"08015";"Badalona";"4";"3";"A";"490";"169";"309";"391";"99";"1";"3";"387";"390"
"8";"Barcelona";"1";"Barcelona";"13";"Barcelonès";"08015";"Badalona";"4";"3";"B";"560";"195";"357";"453";"107";"3";"1";"449";"450"
"8";"Barcelona";"1";"Barcelona";"13";"Barcelonès";"08015";"Badalona";"4";"4";"A";"891";"315";"578";"707";"184";"4";"1";"702";"703"
"8";"Barcelona";"1";"Barcelona";"13";"Barcelonès";"08015";"Badalona";"4";"4";"B";"887";"282";"565";"700";"187";"2";"4";"694";"698"
"8";"Barcelona";"1";"Barcelona";"13";"Barcelonès";"08015";"Badalona";"4";"5";"A";"537";"194";"339";"412";"125";"0";"6";"406";"412"
"8";"Barcelona";"1";"Barcelona";"13";"Barcelonès";"08015";"Badalona";"4";"5";"B";"631";"220";"398";"494";"137";"0";"0";"494";"494"
"8";"Barcelona";"1";"Barcelona";"13";"Barcelonès";"08015";"Badalona";"4";"6";"A";"836";"249";"495";"619";"217";"5";"4";"610";"614"
"8";"Barcelona";"1";"Barcelona";"13";"Barcelonès";"08015";"Badalona";"4";"6";"B";"1050";"249";"590";"768";"282";"6";"8";"754";"762"
"8";"Barcelona";"1";"Barcelona";"13";"Barcelonès";"08015";"Badalona";"4";"7";"A";"658";"214";"420";"535";"123";"6";"2";"527";"529"
"8";"Barcelona";"1";"Barcelona";"13";"Barcelonès";"08015";"Badalona";"4";"7";"B";"765";"283";"525";"661";"104";"4";"2";"655";"657"
"8";"Barcelona";"1";"Barcelona";"13";"Barcelonès";"08015";"Badalona";"4";"8";"A";"544";"203";"343";"410";"134";"1";"2";"407";"409"
"8";"Barcelona";"1";"Barcelona";"13";"Barcelonès";"08015";"Badalona";"4";"8";"B";"594";"192";"377";"468";"126";"2";"5";"461";"466"
"8";"Barcelona";"1";"Barcelona";"13";"Barcelonès";"08015";"Badalona";"4";"9";"U";"719";"241";"504";"588";"131";"1";"1";"586";"587"
"8";"Barcelona";"1";"Barcelona";"13";"Barcelonès";"08015";"Badalona";"5";"1";"A";"813";"332";"576";"686";"127";"3";"2";"681";"683"
"8";"Barcelona";"1";"Barcelona";"13";"Barcelonès";"08015";"Badalona";"5";"1";"B";"942";"386";"675";"786";"156";"3";"1";"782";"783"
"8";"Barcelona";"1";"Barcelona";"13";"Barcelonès";"08015";"Badalona";"5";"2";"U";"656";"269";"515";"584";"72";"3";"0";"581";"581"
"8";"Barcelona";"1";"Barcelona";"13";"Barcelonès";"08015";"Badalona";"5";"3";"A";"958";"290";"648";"792";"166";"3";"6";"783";"789"
"8";"Barcelona";"1";"Barcelona";"13";"Barcelonès";"08015";"Badalona";"5";"3";"B";"988";"305";"675";"828";"160";"2";"0";"826";"826"
"8";"Barcelona";"1";"Barcelona";"13";"Barcelonès";"08015";"Badalona";"5";"4";"A";"624";"219";"423";"515";"109";"1";"3";"511";"514"
"8";"Barcelona";"1";"Barcelona";"13";"Barcelonès";"08015";"Badalona";"5";"4";"B";"590";"208";"414";"498";"92";"5";"2";"491";"493"
"8";"Barcelona";"1";"Barcelona";"13";"Barcelonès";"08015";"Badalona";"5";"4";"C";"624";"202";"396";"502";"122";"0";"0";"502";"502"
"8";"Barcelona";"1";"Barcelona";"13";"Barcelonès";"08015";"Badalona";"5";"5";"A";"725";"202";"467";"571";"154";"3";"4";"564";"568"
"8";"Barcelona";"1";"Barcelona";"13";"Barcelonès";"08015";"Badalona";"5";"5";"B";"850";"261";"543";"683";"167";"2";"2";"679";"681"
"8";"Barcelona";"1";"Barcelona";"13";"Barcelonès";"08015";"Badalona";"5";"6";"A";"454";"187";"343";"396";"58";"0";"3";"393";"396"
"8";"Barcelona";"1";"Barcelona";"13";"Barcelonès";"08015";"Badalona";"5";"6";"B";"507";"206";"361";"428";"79";"0";"4";"424";"428"
"8";"Barcelona";"1";"Barcelona";"13";"Barcelonès";"08015";"Badalona";"6";"1";"U";"1025";"350";"663";"812";"213";"14";"2";"796";"798"
"8";"Barcelona";"1";"Barcelona";"13";"Barcelonès";"08015";"Badalona";"6";"2";"A";"422";"164";"268";"335";"87";"1";"0";"334";"334"
"8";"Barcelona";"1";"Barcelona";"13";"Barcelonès";"08015";"Badalona";"6";"2";"B";"530";"170";"331";"415";"115";"1";"1";"413";"414"
"8";"Barcelona";"1";"Barcelona";"13";"Barcelonès";"08015";"Badalona";"6";"2";"C";"363";"86";"221";"318";"45";"2";"3";"313";"316"
"8";"Barcelona";"1";"Barcelona";"13";"Barcelonès";"08015";"Badalona";"6";"3";"U";"885";"295";"506";"623";"262";"1";"0";"622";"622"
"8";"Barcelona";"1";"Barcelona";"13";"Barcelonès";"08015";"Badalona";"6";"4";"U";"984";"298";"580";"681";"303";"7";"0";"674";"674"
"8";"Barcelona";"1";"Barcelona";"13";"Barcelonès";"08015";"Badalona";"6";"5";"A";"543";"172";"306";"380";"163";"1";"0";"379";"379"
"8";"Barcelona";"1";"Barcelona";"13";"Barcelonès";"08015";"Badalona";"6";"5";"B";"603";"217";"345";"406";"197";"1";"0";"405";"405"
"8";"Barcelona";"1";"Barcelona";"13";"Barcelonès";"08015";"Badalona";"6";"6";"U";"822";"280";"491";"608";"214";"2";"2";"604";"606"
"8";"Barcelona";"1";"Barcelona";"13";"Barcelonès";"08015";"Badalona";"7";"1";"A";"571";"170";"320";"391";"180";"2";"1";"388";"389"
"8";"Barcelona";"1";"Barcelona";"13";"Barcelonès";"08015";"Badalona";"7";"1";"B";"684";"217";"400";"487";"197";"1";"1";"485";"486"
"8";"Barcelona";"1";"Barcelona";"13";"Barcelonès";"08015";"Badalona";"7";"10";"U";"583";"179";"307";"372";"211";"0";"0";"372";"372"
"8";"Barcelona";"1";"Barcelona";"13";"Barcelonès";"08015";"Badalona";"7";"11";"A";"691";"244";"384";"483";"208";"1";"0";"482";"482"
"8";"Barcelona";"1";"Barcelona";"13";"Barcelonès";"08015";"Badalona";"7";"11";"B";"776";"271";"463";"581";"195";"2";"2";"577";"579"
"8";"Barcelona";"1";"Barcelona";"13";"Barcelonès";"08015";"Badalona";"7";"12";"U";"1008";"309";"609";"751";"257";"1";"1";"749";"750"
"8";"Barcelona";"1";"Barcelona";"13";"Barcelonès";"08015";"Badalona";"7";"13";"A";"558";"180";"275";"345";"213";"3";"2";"340";"342"
"8";"Barcelona";"1";"Barcelona";"13";"Barcelonès";"08015";"Badalona";"7";"13";"B";"664";"173";"307";"417";"247";"3";"2";"412";"414"
"8";"Barcelona";"1";"Barcelona";"13";"Barcelonès";"08015";"Badalona";"7";"14";"A";"557";"184";"317";"390";"167";"0";"0";"390";"390"
"8";"Barcelona";"1";"Barcelona";"13";"Barcelonès";"08015";"Badalona";"7";"14";"B";"680";"203";"354";"465";"215";"0";"0";"465";"465"
"8";"Barcelona";"1";"Barcelona";"13";"Barcelonès";"08015";"Badalona";"7";"15";"U";"582";"167";"287";"358";"224";"0";"1";"357";"358"
"8";"Barcelona";"1";"Barcelona";"13";"Barcelonès";"08015";"Badalona";"7";"17";"A";"802";"232";"411";"490";"312";"3";"2";"485";"487"
"8";"Barcelona";"1";"Barcelona";"13";"Barcelonès";"08015";"Badalona";"7";"17";"B";"945";"270";"515";"628";"317";"6";"1";"621";"622"
"8";"Barcelona";"1";"Barcelona";"13";"Barcelonès";"08015";"Badalona";"7";"18";"A";"593";"226";"413";"503";"90";"4";"0";"499";"499"
"8";"Barcelona";"1";"Barcelona";"13";"Barcelonès";"08015";"Badalona";"7";"18";"B";"694";"257";"474";"581";"113";"4";"3";"574";"577"
"8";"Barcelona";"1";"Barcelona";"13";"Barcelonès";"08015";"Badalona";"7";"2";"A";"889";"291";"542";"706";"183";"4";"3";"699";"702"
"8";"Barcelona";"1";"Barcelona";"13";"Barcelonès";"08015";"Badalona";"7";"2";"B";"928";"276";"562";"718";"210";"1";"5";"712";"717"
"8";"Barcelona";"1";"Barcelona";"13";"Barcelonès";"08015";"Badalona";"7";"20";"U";"828";"293";"487";"621";"207";"3";"4";"614";"618"
"8";"Barcelona";"1";"Barcelona";"13";"Barcelonès";"08015";"Badalona";"7";"21";"U";"675";"236";"376";"485";"190";"1";"3";"481";"484"
"8";"Barcelona";"1";"Barcelona";"13";"Barcelonès";"08015";"Badalona";"7";"22";"U";"630";"229";"409";"502";"128";"2";"2";"498";"500"
"8";"Barcelona";"1";"Barcelona";"13";"Barcelonès";"08015";"Badalona";"7";"23";"A";"727";"259";"492";"611";"116";"4";"5";"602";"607"
"8";"Barcelona";"1";"Barcelona";"13";"Barcelonès";"08015";"Badalona";"7";"23";"B";"887";"267";"581";"732";"155";"0";"3";"729";"732"
"8";"Barcelona";"1";"Barcelona";"13";"Barcelonès";"08015";"Badalona";"7";"24";"A";"575";"185";"355";"444";"131";"3";"3";"438";"441"
"8";"Barcelona";"1";"Barcelona";"13";"Barcelonès";"08015";"Badalona";"7";"24";"B";"735";"258";"453";"569";"166";"6";"2";"561";"563"
"8";"Barcelona";"1";"Barcelona";"13";"Barcelonès";"08015";"Badalona";"7";"28";"A";"612";"178";"316";"400";"212";"3";"1";"396";"397"
"8";"Barcelona";"1";"Barcelona";"13";"Barcelonès";"08015";"Badalona";"7";"28";"B";"772";"265";"439";"560";"212";"4";"3";"553";"556"
"8";"Barcelona";"1";"Barcelona";"13";"Barcelonès";"08015";"Badalona";"7";"29";"A";"437";"163";"296";"374";"63";"0";"0";"374";"374"
"8";"Barcelona";"1";"Barcelona";"13";"Barcelonès";"08015";"Badalona";"7";"29";"B";"650";"234";"415";"518";"132";"0";"4";"514";"518"
"8";"Barcelona";"1";"Barcelona";"13";"Barcelonès";"08015";"Badalona";"7";"29";"C";"617";"233";"412";"503";"114";"0";"3";"500";"503"
"8";"Barcelona";"1";"Barcelona";"13";"Barcelonès";"08015";"Badalona";"7";"3";"A";"529";"146";"299";"378";"151";"1";"2";"375";"377"
"8";"Barcelona";"1";"Barcelona";"13";"Barcelonès";"08015";"Badalona";"7";"3";"B";"601";"176";"364";"424";"177";"2";"2";"420";"422"
"8";"Barcelona";"1";"Barcelona";"13";"Barcelonès";"08015";"Badalona";"7";"30";"A";"701";"212";"430";"566";"135";"0";"2";"564";"566"
"8";"Barcelona";"1";"Barcelona";"13";"Barcelonès";"08015";"Badalona";"7";"30";"B";"870";"277";"557";"727";"143";"5";"3";"719";"722"
"8";"Barcelona";"1";"Barcelona";"13";"Barcelonès";"08015";"Badalona";"7";"31";"A";"467";"153";"302";"372";"95";"4";"4";"364";"368"
"8";"Barcelona";"1";"Barcelona";"13";"Barcelonès";"08015";"Badalona";"7";"31";"B";"565";"158";"365";"456";"109";"0";"0";"456";"456"
"8";"Barcelona";"1";"Barcelona";"13";"Barcelonès";"08015";"Badalona";"7";"4";"U";"877";"325";"570";"681";"196";"4";"7";"670";"677"
"8";"Barcelona";"1";"Barcelona";"13";"Barcelonès";"08015";"Badalona";"7";"5";"U";"575";"206";"332";"418";"157";"3";"2";"413";"415"
"8";"Barcelona";"1";"Barcelona";"13";"Barcelonès";"08015";"Badalona";"7";"6";"U";"799";"299";"541";"650";"149";"2";"2";"646";"648"
"8";"Barcelona";"1";"Barcelona";"13";"Barcelonès";"08015";"Badalona";"7";"7";"U";"637";"189";"306";"378";"259";"0";"2";"376";"378"
"8";"Barcelona";"1";"Barcelona";"13";"Barcelonès";"08015";"Badalona";"7";"8";"U";"820";"243";"425";"539";"281";"2";"4";"533";"537"
"8";"Barcelona";"1";"Barcelona";"13";"Barcelonès";"08015";"Badalona";"7";"9";"U";"505";"161";"282";"357";"148";"1";"2";"354";"356"
"8";"Barcelona";"1";"Barcelona";"13";"Barcelonès";"08015";"Badalona";"8";"1";"A";"729";"246";"421";"498";"231";"3";"2";"493";"495"
"8";"Barcelona";"1";"Barcelona";"13";"Barcelonès";"08015";"Badalona";"8";"1";"B";"814";"254";"453";"555";"259";"5";"4";"546";"550"
"8";"Barcelona";"1";"Barcelona";"13";"Barcelonès";"08015";"Badalona";"8";"11";"U";"674";"248";"437";"516";"158";"4";"1";"511";"512"
"8";"Barcelona";"1";"Barcelona";"13";"Barcelonès";"08015";"Badalona";"8";"12";"A";"620";"236";"427";"526";"94";"0";"3";"523";"526"
"8";"Barcelona";"1";"Barcelona";"13";"Barcelonès";"08015";"Badalona";"8";"12";"B";"653";"237";"455";"555";"98";"0";"2";"553";"555"
"8";"Barcelona";"1";"Barcelona";"13";"Barcelonès";"08015";"Badalona";"8";"12";"C";"615";"237";"437";"535";"80";"0";"1";"534";"535"
"8";"Barcelona";"1";"Barcelona";"13";"Barcelonès";"08015";"Badalona";"8";"13";"U";"745";"234";"471";"618";"127";"2";"0";"616";"616"
"8";"Barcelona";"1";"Barcelona";"13";"Barcelonès";"08015";"Badalona";"8";"2";"A";"557";"187";"342";"422";"135";"1";"4";"417";"421"
"8";"Barcelona";"1";"Barcelona";"13";"Barcelonès";"08015";"Badalona";"8";"2";"B";"680";"224";"429";"540";"140";"1";"1";"538";"539"
"8";"Barcelona";"1";"Barcelona";"13";"Barcelonès";"08015";"Badalona";"8";"2";"C";"649";"229";"403";"496";"153";"0";"2";"494";"496"
"8";"Barcelona";"1";"Barcelona";"13";"Barcelonès";"08015";"Badalona";"8";"3";"A";"692";"253";"436";"530";"162";"2";"2";"526";"528"
"8";"Barcelona";"1";"Barcelona";"13";"Barcelonès";"08015";"Badalona";"8";"3";"B";"793";"301";"526";"623";"170";"0";"0";"623";"623"
"8";"Barcelona";"1";"Barcelona";"13";"Barcelonès";"08015";"Badalona";"8";"4";"U";"580";"201";"385";"468";"112";"0";"1";"467";"468"
"8";"Barcelona";"1";"Barcelona";"13";"Barcelonès";"08015";"Badalona";"8";"5";"U";"723";"226";"413";"490";"233";"0";"0";"490";"490"
"8";"Barcelona";"1";"Barcelona";"13";"Barcelonès";"08015";"Badalona";"8";"6";"A";"580";"184";"378";"455";"125";"1";"5";"449";"454"
"8";"Barcelona";"1";"Barcelona";"13";"Barcelonès";"08015";"Badalona";"8";"6";"B";"755";"246";"481";"596";"159";"0";"1";"595";"596"
"8";"Barcelona";"1";"Barcelona";"13";"Barcelonès";"08015";"Badalona";"8";"7";"U";"911";"270";"501";"626";"285";"1";"3";"622";"625"
"8";"Barcelona";"1";"Barcelona";"13";"Barcelonès";"08015";"Badalona";"8";"8";"A";"706";"210";"435";"523";"183";"2";"1";"520";"521"
"8";"Barcelona";"1";"Barcelona";"13";"Barcelonès";"08015";"Badalona";"8";"8";"B";"795";"180";"489";"625";"170";"2";"1";"622";"623"
"8";"Barcelona";"1";"Barcelona";"13";"Barcelonès";"08015";"Badalona";"8";"9";"U";"1030";"328";"600";"780";"250";"0";"2";"778";"780"
"8";"Barcelona";"1";"Barcelona";"13";"Barcelonès";"08015";"Badalona";"9";"1";"A";"538";"166";"287";"337";"201";"2";"3";"332";"335"
"8";"Barcelona";"1";"Barcelona";"13";"Barcelonès";"08015";"Badalona";"9";"1";"B";"603";"181";"341";"396";"207";"0";"1";"395";"396"
"8";"Barcelona";"1";"Barcelona";"13";"Barcelonès";"08015";"Badalona";"9";"10";"U";"1070";"298";"566";"691";"379";"3";"4";"684";"688"
"8";"Barcelona";"1";"Barcelona";"13";"Barcelonès";"08015";"Badalona";"9";"11";"U";"689";"261";"400";"486";"203";"0";"2";"484";"486"
"8";"Barcelona";"1";"Barcelona";"13";"Barcelonès";"08015";"Badalona";"9";"12";"A";"524";"194";"298";"371";"153";"0";"1";"370";"371"
"8";"Barcelona";"1";"Barcelona";"13";"Barcelonès";"08015";"Badalona";"9";"12";"B";"547";"194";"315";"396";"151";"0";"1";"395";"396"
"8";"Barcelona";"1";"Barcelona";"13";"Barcelonès";"08015";"Badalona";"9";"13";"U";"574";"211";"369";"433";"141";"5";"3";"425";"428"
"8";"Barcelona";"1";"Barcelona";"13";"Barcelonès";"08015";"Badalona";"9";"14";"A";"505";"200";"342";"406";"99";"1";"2";"403";"405"
"8";"Barcelona";"1";"Barcelona";"13";"Barcelonès";"08015";"Badalona";"9";"14";"B";"630";"224";"403";"483";"147";"0";"2";"481";"483"
"8";"Barcelona";"1";"Barcelona";"13";"Barcelonès";"08015";"Badalona";"9";"15";"A";"516";"156";"248";"328";"188";"0";"0";"328";"328"
"8";"Barcelona";"1";"Barcelona";"13";"Barcelonès";"08015";"Badalona";"9";"15";"B";"630";"190";"337";"435";"195";"1";"5";"429";"434"
"8";"Barcelona";"1";"Barcelona";"13";"Barcelonès";"08015";"Badalona";"9";"16";"A";"611";"191";"396";"450";"161";"0";"1";"449";"450"
"8";"Barcelona";"1";"Barcelona";"13";"Barcelonès";"08015";"Badalona";"9";"16";"B";"639";"218";"366";"478";"161";"1";"3";"474";"477"
"8";"Barcelona";"1";"Barcelona";"13";"Barcelonès";"08015";"Badalona";"9";"17";"U";"858";"233";"391";"498";"360";"1";"5";"492";"497"
"8";"Barcelona";"1";"Barcelona";"13";"Barcelonès";"08015";"Badalona";"9";"18";"A";"645";"193";"359";"435";"210";"3";"2";"430";"432"
"8";"Barcelona";"1";"Barcelona";"13";"Barcelonès";"08015";"Badalona";"9";"18";"B";"727";"245";"412";"518";"209";"3";"1";"514";"515"
"8";"Barcelona";"1";"Barcelona";"13";"Barcelonès";"08015";"Badalona";"9";"19";"U";"786";"274";"445";"535";"251";"2";"1";"532";"533"
"8";"Barcelona";"1";"Barcelona";"13";"Barcelonès";"08015";"Badalona";"9";"2";"U";"1041";"249";"464";"586";"455";"0";"6";"580";"586"
"8";"Barcelona";"1";"Barcelona";"13";"Barcelonès";"08015";"Badalona";"9";"20";"U";"534";"171";"319";"407";"127";"1";"1";"405";"406"
"8";"Barcelona";"1";"Barcelona";"13";"Barcelonès";"08015";"Badalona";"9";"21";"U";"1067";"351";"634";"762";"305";"3";"6";"753";"759"
"8";"Barcelona";"1";"Barcelona";"13";"Barcelonès";"08015";"Badalona";"9";"22";"U";"1002";"187";"505";"771";"231";"2";"3";"766";"769"
"8";"Barcelona";"1";"Barcelona";"13";"Barcelonès";"08015";"Badalona";"9";"23";"U";"512";"142";"267";"339";"173";"0";"2";"337";"339"
"8";"Barcelona";"1";"Barcelona";"13";"Barcelonès";"08015";"Badalona";"9";"24";"A";"674";"233";"414";"506";"168";"2";"2";"502";"504"
"8";"Barcelona";"1";"Barcelona";"13";"Barcelonès";"08015";"Badalona";"9";"24";"B";"807";"270";"486";"624";"183";"4";"2";"618";"620"
"8";"Barcelona";"1";"Barcelona";"13";"Barcelonès";"08015";"Badalona";"9";"25";"U";"843";"247";"465";"582";"261";"2";"1";"579";"580"
"8";"Barcelona";"1";"Barcelona";"13";"Barcelonès";"08015";"Badalona";"9";"26";"U";"932";"280";"599";"740";"192";"7";"2";"731";"733"
"8";"Barcelona";"1";"Barcelona";"13";"Barcelonès";"08015";"Badalona";"9";"27";"U";"539";"173";"318";"389";"150";"2";"1";"386";"387"
"8";"Barcelona";"1";"Barcelona";"13";"Barcelonès";"08015";"Badalona";"9";"28";"A";"718";"221";"359";"481";"237";"3";"1";"477";"478"
"8";"Barcelona";"1";"Barcelona";"13";"Barcelonès";"08015";"Badalona";"9";"28";"B";"850";"269";"459";"576";"274";"0";"0";"576";"576"
"8";"Barcelona";"1";"Barcelona";"13";"Barcelonès";"08015";"Badalona";"9";"3";"U";"630";"168";"320";"402";"228";"0";"3";"399";"402"
"8";"Barcelona";"1";"Barcelona";"13";"Barcelonès";"08015";"Badalona";"9";"30";"A";"565";"142";"287";"386";"179";"0";"1";"385";"386"
"8";"Barcelona";"1";"Barcelona";"13";"Barcelonès";"08015";"Badalona";"9";"30";"B";"569";"131";"307";"395";"174";"0";"1";"394";"395"
"8";"Barcelona";"1";"Barcelona";"13";"Barcelonès";"08015";"Badalona";"9";"31";"U";"779";"303";"524";"625";"154";"2";"1";"622";"623"
"8";"Barcelona";"1";"Barcelona";"13";"Barcelonès";"08015";"Badalona";"9";"32";"U";"622";"204";"389";"411";"211";"1";"2";"408";"410"
"8";"Barcelona";"1";"Barcelona";"13";"Barcelonès";"08015";"Badalona";"9";"33";"A";"542";"194";"329";"420";"122";"3";"1";"416";"417"
"8";"Barcelona";"1";"Barcelona";"13";"Barcelonès";"08015";"Badalona";"9";"33";"B";"671";"265";"432";"523";"148";"2";"2";"519";"521"
"8";"Barcelona";"1";"Barcelona";"13";"Barcelonès";"08015";"Badalona";"9";"34";"A";"662";"217";"413";"527";"135";"0";"2";"525";"527"
"8";"Barcelona";"1";"Barcelona";"13";"Barcelonès";"08015";"Badalona";"9";"34";"B";"747";"245";"508";"598";"149";"4";"1";"593";"594"
"8";"Barcelona";"1";"Barcelona";"13";"Barcelonès";"08015";"Badalona";"9";"35";"U";"1060";"250";"590";"770";"290";"6";"1";"763";"764"
"8";"Barcelona";"1";"Barcelona";"13";"Barcelonès";"08015";"Badalona";"9";"36";"U";"952";"300";"575";"708";"244";"3";"2";"703";"705"
"8";"Barcelona";"1";"Barcelona";"13";"Barcelonès";"08015";"Badalona";"9";"37";"U";"622";"161";"294";"357";"265";"1";"4";"352";"356"
"8";"Barcelona";"1";"Barcelona";"13";"Barcelonès";"08015";"Badalona";"9";"38";"U";"813";"230";"414";"500";"313";"1";"1";"498";"499"
"8";"Barcelona";"1";"Barcelona";"13";"Barcelonès";"08015";"Badalona";"9";"4";"U";"931";"175";"339";"444";"487";"0";"1";"443";"444"
"8";"Barcelona";"1";"Barcelona";"13";"Barcelonès";"08015";"Badalona";"9";"42";"U";"730";"81";"202";"276";"454";"0";"1";"275";"276"
"8";"Barcelona";"1";"Barcelona";"13";"Barcelonès";"08015";"Badalona";"9";"43";"A";"642";"157";"400";"506";"136";"0";"1";"505";"506"
"8";"Barcelona";"1";"Barcelona";"13";"Barcelonès";"08015";"Badalona";"9";"43";"B";"747";"80";"350";"593";"154";"0";"4";"589";"593"
"8";"Barcelona";"1";"Barcelona";"13";"Barcelonès";"08015";"Badalona";"9";"44";"U";"662";"233";"366";"461";"201";"2";"1";"458";"459"
"8";"Barcelona";"1";"Barcelona";"13";"Barcelonès";"08015";"Badalona";"9";"45";"A";"543";"168";"319";"410";"133";"2";"3";"405";"408"
"8";"Barcelona";"1";"Barcelona";"13";"Barcelonès";"08015";"Badalona";"9";"45";"B";"672";"241";"401";"513";"159";"1";"2";"510";"512"
"8";"Barcelona";"1";"Barcelona";"13";"Barcelonès";"08015";"Badalona";"9";"47";"U";"709";"201";"395";"487";"222";"4";"0";"483";"483"
"8";"Barcelona";"1";"Barcelona";"13";"Barcelonès";"08015";"Badalona";"9";"49";"U";"957";"330";"594";"696";"261";"3";"3";"690";"693"
"8";"Barcelona";"1";"Barcelona";"13";"Barcelonès";"08015";"Badalona";"9";"5";"U";"770";"253";"418";"493";"277";"0";"1";"492";"493"
"8";"Barcelona";"1";"Barcelona";"13";"Barcelonès";"08015";"Badalona";"9";"50";"U";"618";"185";"375";"445";"173";"5";"0";"440";"440"
"8";"Barcelona";"1";"Barcelona";"13";"Barcelonès";"08015";"Badalona";"9";"52";"U";"665";"249";"425";"514";"151";"2";"4";"508";"512"
"8";"Barcelona";"1";"Barcelona";"13";"Barcelonès";"08015";"Badalona";"9";"53";"U";"791";"257";"465";"551";"240";"6";"4";"541";"545"
"8";"Barcelona";"1";"Barcelona";"13";"Barcelonès";"08015";"Badalona";"9";"54";"U";"845";"317";"572";"687";"158";"0";"1";"686";"687"
"8";"Barcelona";"1";"Barcelona";"13";"Barcelonès";"08015";"Badalona";"9";"57";"U";"911";"254";"540";"641";"270";"0";"2";"639";"641"
"8";"Barcelona";"1";"Barcelona";"13";"Barcelonès";"08015";"Badalona";"9";"58";"A";"495";"201";"316";"385";"110";"0";"0";"385";"385"
"8";"Barcelona";"1";"Barcelona";"13";"Barcelonès";"08015";"Badalona";"9";"58";"B";"589";"209";"366";"469";"120";"1";"2";"466";"468"
"8";"Barcelona";"1";"Barcelona";"13";"Barcelonès";"08015";"Badalona";"9";"59";"U";"851";"290";"518";"636";"215";"2";"3";"631";"634"
"8";"Barcelona";"1";"Barcelona";"13";"Barcelonès";"08015";"Badalona";"9";"6";"U";"862";"223";"384";"456";"406";"1";"2";"453";"455"
"8";"Barcelona";"1";"Barcelona";"13";"Barcelonès";"08015";"Badalona";"9";"8";"U";"1061";"268";"542";"671";"390";"3";"3";"665";"668"
"8";"Barcelona";"1";"Barcelona";"13";"Barcelonès";"08015";"Badalona";"9";"9";"U";"820";"320";"505";"639";"181";"2";"7";"630";"637"
"8";"Barcelona";"1";"Barcelona";"40";"Vallès Occidental";"08904";"Badia del Vallès";"1";"1";"A";"408";"147";"227";"284";"124";"2";"0";"282";"282"
"8";"Barcelona";"1";"Barcelona";"40";"Vallès Occidental";"08904";"Badia del Vallès";"1";"1";"B";"447";"164";"285";"352";"95";"1";"1";"350";"351"
"8";"Barcelona";"1";"Barcelona";"40";"Vallès Occidental";"08904";"Badia del Vallès";"1";"10";"A";"360";"121";"224";"276";"84";"0";"3";"273";"276"
"8";"Barcelona";"1";"Barcelona";"40";"Vallès Occidental";"08904";"Badia del Vallès";"1";"10";"B";"371";"149";"248";"294";"77";"6";"2";"286";"288"
"8";"Barcelona";"1";"Barcelona";"40";"Vallès Occidental";"08904";"Badia del Vallès";"1";"11";"A";"465";"158";"271";"349";"116";"3";"1";"345";"346"
"8";"Barcelona";"1";"Barcelona";"40";"Vallès Occidental";"08904";"Badia del Vallès";"1";"11";"B";"462";"165";"272";"348";"114";"3";"3";"342";"345"
"8";"Barcelona";"1";"Barcelona";"40";"Vallès Occidental";"08904";"Badia del Vallès";"1";"12";"A";"465";"160";"297";"368";"97";"0";"2";"366";"368"
"8";"Barcelona";"1";"Barcelona";"40";"Vallès Occidental";"08904";"Badia del Vallès";"1";"12";"B";"457";"156";"281";"348";"109";"2";"2";"344";"346"
"8";"Barcelona";"1";"Barcelona";"40";"Vallès Occidental";"08904";"Badia del Vallès";"1";"2";"U";"655";"177";"315";"421";"234";"3";"2";"416";"418"
"8";"Barcelona";"1";"Barcelona";"40";"Vallès Occidental";"08904";"Badia del Vallès";"1";"3";"A";"465";"159";"286";"346";"119";"0";"1";"345";"346"
"8";"Barcelona";"1";"Barcelona";"40";"Vallès Occidental";"08904";"Badia del Vallès";"1";"3";"B";"485";"152";"272";"339";"146";"2";"1";"336";"337"
"8";"Barcelona";"1";"Barcelona";"40";"Vallès Occidental";"08904";"Badia del Vallès";"1";"4";"A";"430";"134";"233";"289";"141";"1";"0";"288";"288"
"8";"Barcelona";"1";"Barcelona";"40";"Vallès Occidental";"08904";"Badia del Vallès";"1";"4";"B";"490";"152";"270";"334";"156";"1";"1";"332";"333"
"8";"Barcelona";"1";"Barcelona";"40";"Vallès Occidental";"08904";"Badia del Vallès";"1";"5";"A";"456";"128";"239";"307";"149";"0";"2";"305";"307"
"8";"Barcelona";"1";"Barcelona";"40";"Vallès Occidental";"08904";"Badia del Vallès";"1";"5";"B";"485";"171";"281";"343";"142";"0";"2";"341";"343"
"8";"Barcelona";"1";"Barcelona";"40";"Vallès Occidental";"08904";"Badia del Vallès";"1";"6";"A";"542";"171";"289";"367";"175";"3";"1";"363";"364"
"8";"Barcelona";"1";"Barcelona";"40";"Vallès Occidental";"08904";"Badia del Vallès";"1";"6";"B";"583";"227";"350";"437";"146";"2";"2";"433";"435"
"8";"Barcelona";"1";"Barcelona";"40";"Vallès Occidental";"08904";"Badia del Vallès";"1";"7";"A";"470";"163";"279";"338";"132";"3";"1";"334";"335"
"8";"Barcelona";"1";"Barcelona";"40";"Vallès Occidental";"08904";"Badia del Vallès";"1";"7";"B";"385";"130";"227";"281";"104";"0";"2";"279";"281"
"8";"Barcelona";"1";"Barcelona";"40";"Vallès Occidental";"08904";"Badia del Vallès";"1";"8";"A";"490";"148";"260";"341";"149";"4";"3";"334";"337"
"8";"Barcelona";"1";"Barcelona";"40";"Vallès Occidental";"08904";"Badia del Vallès";"1";"8";"B";"363";"117";"212";"265";"98";"1";"3";"261";"264"
"8";"Barcelona";"1";"Barcelona";"40";"Vallès Occidental";"08904";"Badia del Vallès";"1";"9";"A";"473";"154";"265";"323";"150";"0";"1";"322";"323"
"8";"Barcelona";"1";"Barcelona";"40";"Vallès Occidental";"08904";"Badia del Vallès";"1";"9";"B";"376";"120";"217";"273";"103";"1";"2";"270";"272"
"8";"Barcelona";"1";"Barcelona";"40";"Vallès Occidental";"08252";"Barberà del Vallès";"1";"1";"A";"547";"198";"391";"459";"88";"1";"3";"455";"458"
"8";"Barcelona";"1";"Barcelona";"40";"Vallès Occidental";"08252";"Barberà del Vallès";"1";"1";"B";"685";"230";"436";"549";"136";"1";"2";"546";"548"
"8";"Barcelona";"1";"Barcelona";"40";"Vallès Occidental";"08252";"Barberà del Vallès";"1";"1";"C";"715";"243";"446";"551";"164";"5";"3";"543";"546"
"8";"Barcelona";"1";"Barcelona";"40";"Vallès Occidental";"08252";"Barberà del Vallès";"1";"10";"A";"536";"188";"348";"450";"86";"1";"3";"446";"449"
"8";"Barcelona";"1";"Barcelona";"40";"Vallès Occidental";"08252";"Barberà del Vallès";"1";"10";"B";"563";"191";"341";"450";"113";"2";"3";"445";"448"
"8";"Barcelona";"1";"Barcelona";"40";"Vallès Occidental";"08252";"Barberà del Vallès";"1";"11";"A";"697";"255";"437";"575";"122";"4";"1";"570";"571"
"8";"Barcelona";"1";"Barcelona";"40";"Vallès Occidental";"08252";"Barberà del Vallès";"1";"11";"B";"624";"236";"408";"511";"113";"2";"0";"509";"509"
"8";"Barcelona";"1";"Barcelona";"40";"Vallès Occidental";"08252";"Barberà del Vallès";"1";"18";"U";"792";"234";"465";"592";"200";"0";"1";"591";"592"
"8";"Barcelona";"1";"Barcelona";"40";"Vallès Occidental";"08252";"Barberà del Vallès";"1";"19";"A";"573";"198";"347";"438";"135";"2";"2";"434";"436"
"8";"Barcelona";"1";"Barcelona";"40";"Vallès Occidental";"08252";"Barberà del Vallès";"1";"19";"B";"470";"167";"293";"371";"99";"0";"2";"369";"371"
"8";"Barcelona";"1";"Barcelona";"40";"Vallès Occidental";"08252";"Barberà del Vallès";"1";"2";"U";"897";"305";"567";"722";"175";"1";"4";"717";"721"
"8";"Barcelona";"1";"Barcelona";"40";"Vallès Occidental";"08252";"Barberà del Vallès";"1";"20";"U";"758";"283";"475";"570";"188";"1";"7";"562";"569"
"8";"Barcelona";"1";"Barcelona";"40";"Vallès Occidental";"08252";"Barberà del Vallès";"1";"21";"A";"519";"180";"334";"407";"112";"3";"1";"403";"404"
"8";"Barcelona";"1";"Barcelona";"40";"Vallès Occidental";"08252";"Barberà del Vallès";"1";"21";"B";"487";"147";"301";"395";"92";"1";"0";"394";"394"
"8";"Barcelona";"1";"Barcelona";"40";"Vallès Occidental";"08252";"Barberà del Vallès";"1";"22";"A";"864";"251";"523";"702";"162";"0";"5";"697";"702"
"8";"Barcelona";"1";"Barcelona";"40";"Vallès Occidental";"08252";"Barberà del Vallès";"1";"22";"B";"807";"289";"484";"657";"150";"4";"1";"652";"653"
"8";"Barcelona";"1";"Barcelona";"40";"Vallès Occidental";"08252";"Barberà del Vallès";"1";"23";"U";"637";"233";"415";"508";"129";"2";"2";"504";"506"
"8";"Barcelona";"1";"Barcelona";"40";"Vallès Occidental";"08252";"Barberà del Vallès";"1";"24";"U";"727";"193";"410";"538";"189";"0";"3";"535";"538"
"8";"Barcelona";"1";"Barcelona";"40";"Vallès Occidental";"08252";"Barberà del Vallès";"1";"25";"U";"832";"300";"504";"655";"177";"3";"3";"649";"652"
"8";"Barcelona";"1";"Barcelona";"40";"Vallès Occidental";"08252";"Barberà del Vallès";"1";"26";"A";"918";"256";"546";"726";"192";"2";"1";"723";"724"
"8";"Barcelona";"1";"Barcelona";"40";"Vallès Occidental";"08252";"Barberà del Vallès";"1";"26";"B";"770";"237";"464";"579";"191";"0";"5";"574";"579"
"8";"Barcelona";"1";"Barcelona";"40";"Vallès Occidental";"08252";"Barberà del Vallès";"1";"27";"A";"777";"241";"493";"649";"128";"3";"4";"642";"646"
"8";"Barcelona";"1";"Barcelona";"40";"Vallès Occidental";"08252";"Barberà del Vallès";"1";"27";"B";"680";"228";"413";"547";"133";"1";"5";"541";"546"
"8";"Barcelona";"1";"Barcelona";"40";"Vallès Occidental";"08252";"Barberà del Vallès";"1";"28";"A";"587";"203";"350";"468";"119";"1";"6";"461";"467"
"8";"Barcelona";"1";"Barcelona";"40";"Vallès Occidental";"08252";"Barberà del Vallès";"1";"28";"B";"570";"200";"349";"457";"113";"2";"4";"451";"455"
"8";"Barcelona";"1";"Barcelona";"40";"Vallès Occidental";"08252";"Barberà del Vallès";"1";"29";"A";"565";"177";"372";"478";"87";"1";"2";"475";"477"
"8";"Barcelona";"1";"Barcelona";"40";"Vallès Occidental";"08252";"Barberà del Vallès";"1";"29";"B";"516";"165";"328";"441";"75";"1";"2";"438";"440"
"8";"Barcelona";"1";"Barcelona";"40";"Vallès Occidental";"08252";"Barberà del Vallès";"1";"3";"A";"575";"165";"324";"419";"156";"1";"1";"417";"418"
"8";"Barcelona";"1";"Barcelona";"40";"Vallès Occidental";"08252";"Barberà del Vallès";"1";"3";"B";"490";"140";"276";"355";"135";"0";"2";"353";"355"
"8";"Barcelona";"1";"Barcelona";"40";"Vallès Occidental";"08252";"Barberà del Vallès";"1";"4";"A";"540";"155";"299";"390";"150";"2";"2";"386";"388"
"8";"Barcelona";"1";"Barcelona";"40";"Vallès Occidental";"08252";"Barberà del Vallès";"1";"4";"B";"544";"166";"309";"399";"145";"3";"0";"396";"396"
"8";"Barcelona";"1";"Barcelona";"40";"Vallès Occidental";"08252";"Barberà del Vallès";"1";"5";"A";"543";"181";"329";"410";"133";"0";"3";"407";"410"
"8";"Barcelona";"1";"Barcelona";"40";"Vallès Occidental";"08252";"Barberà del Vallès";"1";"5";"B";"515";"154";"315";"407";"108";"3";"0";"404";"404"
"8";"Barcelona";"1";"Barcelona";"40";"Vallès Occidental";"08252";"Barberà del Vallès";"1";"6";"U";"819";"288";"530";"649";"170";"4";"5";"640";"645"
"8";"Barcelona";"1";"Barcelona";"40";"Vallès Occidental";"08252";"Barberà del Vallès";"1";"7";"U";"697";"233";"461";"573";"124";"3";"5";"565";"570"
"8";"Barcelona";"1";"Barcelona";"40";"Vallès Occidental";"08252";"Barberà del Vallès";"1";"8";"A";"517";"197";"304";"381";"136";"2";"2";"377";"379"
"8";"Barcelona";"1";"Barcelona";"40";"Vallès Occidental";"08252";"Barberà del Vallès";"1";"8";"B";"427";"140";"227";"311";"116";"1";"1";"309";"310"
"8";"Barcelona";"1";"Barcelona";"40";"Vallès Occidental";"08252";"Barberà del Vallès";"1";"9";"U";"635";"213";"388";"490";"145";"0";"4";"486";"490"
"8";"Barcelona";"1";"Barcelona";"13";"Barcelonès";"08019";"Barcelona";"1";"1";"U";"614";"164";"307";"372";"242";"0";"1";"371";"372"
"8";"Barcelona";"1";"Barcelona";"13";"Barcelonès";"08019";"Barcelona";"1";"10";"U";"861";"226";"381";"446";"415";"0";"1";"445";"446"
"8";"Barcelona";"1";"Barcelona";"13";"Barcelonès";"08019";"Barcelona";"1";"11";"U";"1255";"288";"526";"644";"611";"3";"6";"635";"641"
"8";"Barcelona";"1";"Barcelona";"13";"Barcelonès";"08019";"Barcelona";"1";"12";"U";"907";"252";"434";"531";"376";"1";"2";"528";"530"
"8";"Barcelona";"1";"Barcelona";"13";"Barcelonès";"08019";"Barcelona";"1";"13";"U";"752";"239";"406";"508";"244";"0";"4";"504";"508"
"8";"Barcelona";"1";"Barcelona";"13";"Barcelonès";"08019";"Barcelona";"1";"14";"U";"943";"251";"441";"552";"391";"2";"2";"548";"550"
"8";"Barcelona";"1";"Barcelona";"13";"Barcelonès";"08019";"Barcelona";"1";"15";"U";"1044";"247";"510";"616";"428";"2";"5";"609";"614"
"8";"Barcelona";"1";"Barcelona";"13";"Barcelonès";"08019";"Barcelona";"1";"16";"U";"917";"247";"440";"546";"371";"6";"3";"537";"540"
"8";"Barcelona";"1";"Barcelona";"13";"Barcelonès";"08019";"Barcelona";"1";"17";"U";"1048";"250";"466";"563";"485";"4";"1";"558";"559"
"8";"Barcelona";"1";"Barcelona";"13";"Barcelonès";"08019";"Barcelona";"1";"18";"U";"760";"217";"363";"451";"309";"1";"0";"450";"450"
"8";"Barcelona";"1";"Barcelona";"13";"Barcelonès";"08019";"Barcelona";"1";"19";"U";"1209";"354";"531";"665";"544";"2";"2";"661";"663"
"8";"Barcelona";"1";"Barcelona";"13";"Barcelonès";"08019";"Barcelona";"1";"2";"U";"630";"145";"246";"320";"310";"3";"0";"317";"317"
"8";"Barcelona";"1";"Barcelona";"13";"Barcelonès";"08019";"Barcelona";"1";"20";"A";"609";"204";"357";"429";"180";"2";"6";"421";"427"
"8";"Barcelona";"1";"Barcelona";"13";"Barcelonès";"08019";"Barcelona";"1";"20";"B";"575";"183";"331";"406";"169";"0";"1";"405";"406"
"8";"Barcelona";"1";"Barcelona";"13";"Barcelonès";"08019";"Barcelona";"1";"21";"U";"1117";"284";"543";"747";"370";"2";"2";"743";"745"
"8";"Barcelona";"1";"Barcelona";"13";"Barcelonès";"08019";"Barcelona";"1";"22";"U";"703";"220";"423";"516";"187";"1";"1";"514";"515"
"8";"Barcelona";"1";"Barcelona";"13";"Barcelonès";"08019";"Barcelona";"1";"23";"A";"594";"173";"328";"393";"201";"0";"5";"388";"393"
"8";"Barcelona";"1";"Barcelona";"13";"Barcelonès";"08019";"Barcelona";"1";"23";"B";"592";"191";"324";"400";"192";"1";"1";"398";"399"
"8";"Barcelona";"1";"Barcelona";"13";"Barcelonès";"08019";"Barcelona";"1";"25";"U";"646";"195";"341";"416";"230";"0";"1";"415";"416"
"8";"Barcelona";"1";"Barcelona";"13";"Barcelonès";"08019";"Barcelona";"1";"26";"U";"970";"244";"438";"557";"413";"1";"0";"556";"556"
"8";"Barcelona";"1";"Barcelona";"13";"Barcelonès";"08019";"Barcelona";"1";"27";"U";"832";"248";"424";"547";"285";"2";"2";"543";"545"
"8";"Barcelona";"1";"Barcelona";"13";"Barcelonès";"08019";"Barcelona";"1";"28";"U";"906";"248";"429";"593";"313";"2";"2";"589";"591"
"8";"Barcelona";"1";"Barcelona";"13";"Barcelonès";"08019";"Barcelona";"1";"29";"U";"634";"158";"298";"374";"260";"1";"0";"373";"373"
"8";"Barcelona";"1";"Barcelona";"13";"Barcelonès";"08019";"Barcelona";"1";"3";"A";"733";"182";"322";"394";"339";"0";"1";"393";"394"
"8";"Barcelona";"1";"Barcelona";"13";"Barcelonès";"08019";"Barcelona";"1";"3";"B";"677";"200";"329";"405";"272";"0";"1";"404";"405"
"8";"Barcelona";"1";"Barcelona";"13";"Barcelonès";"08019";"Barcelona";"1";"30";"A";"654";"175";"302";"372";"282";"4";"2";"366";"368"
"8";"Barcelona";"1";"Barcelona";"13";"Barcelonès";"08019";"Barcelona";"1";"30";"B";"614";"168";"309";"384";"230";"0";"1";"383";"384"
"8";"Barcelona";"1";"Barcelona";"13";"Barcelonès";"08019";"Barcelona";"1";"31";"U";"710";"165";"325";"400";"310";"1";"0";"399";"399"
"8";"Barcelona";"1";"Barcelona";"13";"Barcelonès";"08019";"Barcelona";"1";"32";"U";"1040";"282";"537";"695";"345";"2";"3";"690";"693"
"8";"Barcelona";"1";"Barcelona";"13";"Barcelonès";"08019";"Barcelona";"1";"33";"U";"641";"178";"321";"402";"239";"1";"3";"398";"401"
"8";"Barcelona";"1";"Barcelona";"13";"Barcelonès";"08019";"Barcelona";"1";"34";"U";"607";"161";"270";"329";"278";"1";"2";"326";"328"
"8";"Barcelona";"1";"Barcelona";"13";"Barcelonès";"08019";"Barcelona";"1";"35";"U";"762";"239";"368";"456";"306";"1";"2";"453";"455"
"8";"Barcelona";"1";"Barcelona";"13";"Barcelonès";"08019";"Barcelona";"1";"36";"U";"836";"261";"436";"515";"321";"2";"3";"510";"513"
"8";"Barcelona";"1";"Barcelona";"13";"Barcelonès";"08019";"Barcelona";"1";"37";"U";"983";"324";"552";"652";"331";"3";"1";"648";"649"
"8";"Barcelona";"1";"Barcelona";"13";"Barcelonès";"08019";"Barcelona";"1";"38";"U";"754";"216";"399";"470";"284";"2";"0";"468";"468"
"8";"Barcelona";"1";"Barcelona";"13";"Barcelonès";"08019";"Barcelona";"1";"39";"U";"819";"275";"457";"550";"269";"5";"4";"541";"545"
"8";"Barcelona";"1";"Barcelona";"13";"Barcelonès";"08019";"Barcelona";"1";"4";"A";"669";"187";"312";"389";"280";"3";"3";"383";"386"
"8";"Barcelona";"1";"Barcelona";"13";"Barcelonès";"08019";"Barcelona";"1";"4";"B";"650";"163";"314";"408";"242";"0";"0";"408";"408"
"8";"Barcelona";"1";"Barcelona";"13";"Barcelonès";"08019";"Barcelona";"1";"40";"U";"635";"214";"380";"434";"201";"3";"4";"427";"431"
"8";"Barcelona";"1";"Barcelona";"13";"Barcelonès";"08019";"Barcelona";"1";"41";"U";"723";"209";"376";"452";"271";"0";"4";"448";"452"
"8";"Barcelona";"1";"Barcelona";"13";"Barcelonès";"08019";"Barcelona";"1";"42";"A";"688";"251";"381";"440";"248";"2";"2";"436";"438"
"8";"Barcelona";"1";"Barcelona";"13";"Barcelonès";"08019";"Barcelona";"1";"42";"B";"613";"202";"325";"383";"230";"4";"3";"376";"379"
"8";"Barcelona";"1";"Barcelona";"13";"Barcelonès";"08019";"Barcelona";"1";"43";"U";"694";"172";"358";"473";"221";"2";"4";"467";"471"
"8";"Barcelona";"1";"Barcelona";"13";"Barcelonès";"08019";"Barcelona";"1";"44";"U";"822";"245";"452";"581";"241";"2";"4";"575";"579"
"8";"Barcelona";"1";"Barcelona";"13";"Barcelonès";"08019";"Barcelona";"1";"45";"U";"1065";"300";"517";"647";"418";"5";"2";"640";"642"
"8";"Barcelona";"1";"Barcelona";"13";"Barcelonès";"08019";"Barcelona";"1";"46";"U";"887";"268";"461";"546";"341";"2";"4";"540";"544"
"8";"Barcelona";"1";"Barcelona";"13";"Barcelonès";"08019";"Barcelona";"1";"47";"U";"940";"262";"467";"580";"360";"0";"2";"578";"580"
"8";"Barcelona";"1";"Barcelona";"13";"Barcelonès";"08019";"Barcelona";"1";"48";"U";"1115";"277";"511";"620";"495";"3";"5";"612";"617"
"8";"Barcelona";"1";"Barcelona";"13";"Barcelonès";"08019";"Barcelona";"1";"49";"U";"779";"221";"440";"521";"258";"0";"3";"518";"521"
"8";"Barcelona";"1";"Barcelona";"13";"Barcelonès";"08019";"Barcelona";"1";"5";"U";"1140";"302";"536";"639";"501";"3";"4";"632";"636"
"8";"Barcelona";"1";"Barcelona";"13";"Barcelonès";"08019";"Barcelona";"1";"50";"U";"832";"247";"476";"564";"268";"1";"2";"561";"563"
"8";"Barcelona";"1";"Barcelona";"13";"Barcelonès";"08019";"Barcelona";"1";"51";"U";"852";"210";"394";"505";"347";"4";"4";"497";"501"
"8";"Barcelona";"1";"Barcelona";"13";"Barcelonès";"08019";"Barcelona";"1";"52";"A";"633";"186";"362";"464";"169";"2";"3";"459";"462"
"8";"Barcelona";"1";"Barcelona";"13";"Barcelonès";"08019";"Barcelona";"1";"52";"B";"579";"179";"348";"433";"146";"1";"3";"429";"432"
"8";"Barcelona";"1";"Barcelona";"13";"Barcelonès";"08019";"Barcelona";"1";"53";"U";"1140";"326";"600";"724";"416";"0";"4";"720";"724"
"8";"Barcelona";"1";"Barcelona";"13";"Barcelonès";"08019";"Barcelona";"1";"54";"U";"695";"206";"374";"443";"252";"2";"2";"439";"441"
"8";"Barcelona";"1";"Barcelona";"13";"Barcelonès";"08019";"Barcelona";"1";"55";"U";"863";"321";"519";"641";"222";"0";"3";"638";"641"
"8";"Barcelona";"1";"Barcelona";"13";"Barcelonès";"08019";"Barcelona";"1";"6";"U";"642";"163";"238";"335";"307";"2";"1";"332";"333"
"8";"Barcelona";"1";"Barcelona";"13";"Barcelonès";"08019";"Barcelona";"1";"7";"U";"810";"187";"298";"426";"384";"0";"2";"424";"426"
"8";"Barcelona";"1";"Barcelona";"13";"Barcelonès";"08019";"Barcelona";"1";"8";"U";"1249";"288";"519";"594";"655";"5";"4";"585";"589"
"8";"Barcelona";"1";"Barcelona";"13";"Barcelonès";"08019";"Barcelona";"1";"9";"U";"955";"289";"474";"568";"387";"2";"3";"563";"566"
"8";"Barcelona";"1";"Barcelona";"13";"Barcelonès";"08019";"Barcelona";"10";"1";"U";"1148";"264";"668";"813";"335";"1";"3";"809";"812"
"8";"Barcelona";"1";"Barcelona";"13";"Barcelonès";"08019";"Barcelona";"10";"10";"A";"636";"194";"377";"458";"178";"2";"3";"453";"456"
"8";"Barcelona";"1";"Barcelona";"13";"Barcelonès";"08019";"Barcelona";"10";"10";"B";"594";"193";"375";"472";"122";"0";"1";"471";"472"
"8";"Barcelona";"1";"Barcelona";"13";"Barcelonès";"08019";"Barcelona";"10";"100";"U";"1163";"362";"720";"895";"268";"5";"8";"882";"890"
"8";"Barcelona";"1";"Barcelona";"13";"Barcelonès";"08019";"Barcelona";"10";"101";"U";"903";"356";"587";"660";"243";"0";"0";"660";"660"
"8";"Barcelona";"1";"Barcelona";"13";"Barcelonès";"08019";"Barcelona";"10";"102";"A";"1022";"341";"640";"784";"238";"6";"4";"774";"778"
"8";"Barcelona";"1";"Barcelona";"13";"Barcelonès";"08019";"Barcelona";"10";"102";"B";"880";"294";"572";"706";"174";"3";"12";"691";"703"
"8";"Barcelona";"1";"Barcelona";"13";"Barcelonès";"08019";"Barcelona";"10";"103";"A";"964";"297";"615";"768";"196";"3";"3";"762";"765"
"8";"Barcelona";"1";"Barcelona";"13";"Barcelonès";"08019";"Barcelona";"10";"103";"B";"829";"325";"574";"687";"142";"2";"1";"684";"685"
"8";"Barcelona";"1";"Barcelona";"13";"Barcelonès";"08019";"Barcelona";"10";"104";"A";"799";"324";"574";"697";"102";"1";"2";"694";"696"
"8";"Barcelona";"1";"Barcelona";"13";"Barcelonès";"08019";"Barcelona";"10";"104";"B";"641";"231";"445";"548";"93";"2";"3";"543";"546"
"8";"Barcelona";"1";"Barcelona";"13";"Barcelonès";"08019";"Barcelona";"10";"105";"A";"885";"328";"550";"688";"197";"4";"6";"678";"684"
"8";"Barcelona";"1";"Barcelona";"13";"Barcelonès";"08019";"Barcelona";"10";"105";"B";"832";"278";"542";"678";"154";"1";"4";"673";"677"
"8";"Barcelona";"1";"Barcelona";"13";"Barcelonès";"08019";"Barcelona";"10";"106";"U";"801";"302";"518";"631";"170";"4";"2";"625";"627"
"8";"Barcelona";"1";"Barcelona";"13";"Barcelonès";"08019";"Barcelona";"10";"107";"U";"1186";"385";"775";"974";"212";"3";"8";"963";"971"
"8";"Barcelona";"1";"Barcelona";"13";"Barcelonès";"08019";"Barcelona";"10";"108";"U";"1105";"373";"714";"871";"234";"1";"4";"866";"870"
"8";"Barcelona";"1";"Barcelona";"13";"Barcelonès";"08019";"Barcelona";"10";"109";"U";"1195";"427";"761";"930";"265";"7";"7";"916";"923"
"8";"Barcelona";"1";"Barcelona";"13";"Barcelonès";"08019";"Barcelona";"10";"11";"U";"915";"312";"585";"719";"196";"3";"3";"713";"716"
"8";"Barcelona";"1";"Barcelona";"13";"Barcelonès";"08019";"Barcelona";"10";"110";"A";"634";"268";"430";"503";"131";"3";"3";"497";"500"
"8";"Barcelona";"1";"Barcelona";"13";"Barcelonès";"08019";"Barcelona";"10";"110";"B";"600";"230";"393";"454";"146";"1";"1";"452";"453"
"8";"Barcelona";"1";"Barcelona";"13";"Barcelonès";"08019";"Barcelona";"10";"111";"U";"990";"362";"672";"784";"206";"0";"1";"783";"784"
"8";"Barcelona";"1";"Barcelona";"13";"Barcelonès";"08019";"Barcelona";"10";"112";"A";"663";"240";"481";"574";"89";"1";"2";"571";"573"
"8";"Barcelona";"1";"Barcelona";"13";"Barcelonès";"08019";"Barcelona";"10";"112";"B";"602";"243";"429";"515";"87";"0";"4";"511";"515"
"8";"Barcelona";"1";"Barcelona";"13";"Barcelonès";"08019";"Barcelona";"10";"113";"U";"833";"297";"523";"653";"180";"0";"2";"651";"653"
"8";"Barcelona";"1";"Barcelona";"13";"Barcelonès";"08019";"Barcelona";"10";"114";"U";"1031";"335";"625";"749";"282";"3";"4";"742";"746"
"8";"Barcelona";"1";"Barcelona";"13";"Barcelonès";"08019";"Barcelona";"10";"115";"U";"1095";"353";"620";"757";"338";"5";"6";"746";"752"
"8";"Barcelona";"1";"Barcelona";"13";"Barcelonès";"08019";"Barcelona";"10";"116";"A";"705";"239";"406";"500";"205";"1";"3";"496";"499"
"8";"Barcelona";"1";"Barcelona";"13";"Barcelonès";"08019";"Barcelona";"10";"116";"B";"662";"244";"404";"484";"178";"1";"0";"483";"483"
"8";"Barcelona";"1";"Barcelona";"13";"Barcelonès";"08019";"Barcelona";"10";"117";"U";"995";"325";"625";"777";"218";"6";"2";"769";"771"
"8";"Barcelona";"1";"Barcelona";"13";"Barcelonès";"08019";"Barcelona";"10";"118";"U";"801";"332";"577";"667";"134";"0";"4";"663";"667"
"8";"Barcelona";"1";"Barcelona";"13";"Barcelonès";"08019";"Barcelona";"10";"119";"U";"886";"311";"567";"672";"214";"0";"1";"671";"672"
"8";"Barcelona";"1";"Barcelona";"13";"Barcelonès";"08019";"Barcelona";"10";"12";"A";"726";"281";"463";"577";"149";"2";"4";"571";"575"
"8";"Barcelona";"1";"Barcelona";"13";"Barcelonès";"08019";"Barcelona";"10";"12";"B";"611";"227";"421";"508";"103";"0";"1";"507";"508"
"8";"Barcelona";"1";"Barcelona";"13";"Barcelonès";"08019";"Barcelona";"10";"120";"U";"1027";"265";"625";"756";"271";"0";"5";"751";"756"
"8";"Barcelona";"1";"Barcelona";"13";"Barcelonès";"08019";"Barcelona";"10";"121";"U";"1132";"321";"643";"820";"312";"5";"6";"809";"815"
"8";"Barcelona";"1";"Barcelona";"13";"Barcelonès";"08019";"Barcelona";"10";"122";"A";"657";"258";"474";"575";"82";"6";"3";"566";"569"
"8";"Barcelona";"1";"Barcelona";"13";"Barcelonès";"08019";"Barcelona";"10";"122";"B";"610";"283";"459";"522";"88";"1";"0";"521";"521"
"8";"Barcelona";"1";"Barcelona";"13";"Barcelonès";"08019";"Barcelona";"10";"123";"U";"1059";"355";"669";"847";"212";"2";"5";"840";"845"
"8";"Barcelona";"1";"Barcelona";"13";"Barcelonès";"08019";"Barcelona";"10";"124";"U";"910";"293";"540";"718";"192";"0";"1";"717";"718"
"8";"Barcelona";"1";"Barcelona";"13";"Barcelonès";"08019";"Barcelona";"10";"125";"U";"882";"298";"568";"676";"206";"4";"1";"671";"672"
"8";"Barcelona";"1";"Barcelona";"13";"Barcelonès";"08019";"Barcelona";"10";"126";"U";"870";"296";"564";"718";"152";"1";"8";"709";"717"
"8";"Barcelona";"1";"Barcelona";"13";"Barcelonès";"08019";"Barcelona";"10";"127";"U";"742";"256";"452";"583";"159";"0";"2";"581";"583"
"8";"Barcelona";"1";"Barcelona";"13";"Barcelonès";"08019";"Barcelona";"10";"128";"A";"651";"252";"448";"552";"99";"3";"5";"544";"549"
"8";"Barcelona";"1";"Barcelona";"13";"Barcelonès";"08019";"Barcelona";"10";"128";"B";"650";"247";"440";"545";"105";"2";"8";"535";"543"
"8";"Barcelona";"1";"Barcelona";"13";"Barcelonès";"08019";"Barcelona";"10";"129";"U";"992";"305";"672";"851";"141";"2";"5";"844";"849"
"8";"Barcelona";"1";"Barcelona";"13";"Barcelonès";"08019";"Barcelona";"10";"13";"U";"1004";"328";"657";"770";"234";"2";"5";"763";"768"
"8";"Barcelona";"1";"Barcelona";"13";"Barcelonès";"08019";"Barcelona";"10";"130";"U";"915";"302";"552";"687";"228";"3";"1";"683";"684"
"8";"Barcelona";"1";"Barcelona";"13";"Barcelonès";"08019";"Barcelona";"10";"131";"U";"995";"298";"654";"811";"184";"3";"9";"799";"808"
"8";"Barcelona";"1";"Barcelona";"13";"Barcelonès";"08019";"Barcelona";"10";"132";"U";"984";"303";"642";"790";"194";"0";"0";"790";"790"
"8";"Barcelona";"1";"Barcelona";"13";"Barcelonès";"08019";"Barcelona";"10";"133";"A";"701";"263";"427";"541";"160";"0";"1";"540";"541"
"8";"Barcelona";"1";"Barcelona";"13";"Barcelonès";"08019";"Barcelona";"10";"133";"B";"584";"339";"461";"466";"118";"0";"0";"466";"466"
"8";"Barcelona";"1";"Barcelona";"13";"Barcelonès";"08019";"Barcelona";"10";"134";"A";"630";"210";"386";"464";"166";"2";"6";"456";"462"
"8";"Barcelona";"1";"Barcelona";"13";"Barcelonès";"08019";"Barcelona";"10";"134";"B";"571";"195";"353";"431";"140";"3";"0";"428";"428"
"8";"Barcelona";"1";"Barcelona";"13";"Barcelonès";"08019";"Barcelona";"10";"135";"U";"938";"280";"544";"684";"254";"0";"3";"681";"684"
"8";"Barcelona";"1";"Barcelona";"13";"Barcelonès";"08019";"Barcelona";"10";"136";"U";"1085";"350";"704";"849";"236";"1";"4";"844";"848"
"8";"Barcelona";"1";"Barcelona";"13";"Barcelonès";"08019";"Barcelona";"10";"137";"A";"622";"192";"348";"411";"211";"2";"2";"407";"409"
"8";"Barcelona";"1";"Barcelona";"13";"Barcelonès";"08019";"Barcelona";"10";"137";"B";"581";"154";"283";"392";"189";"1";"1";"390";"391"
"8";"Barcelona";"1";"Barcelona";"13";"Barcelonès";"08019";"Barcelona";"10";"138";"U";"1113";"295";"508";"722";"391";"5";"3";"714";"717"
"8";"Barcelona";"1";"Barcelona";"13";"Barcelonès";"08019";"Barcelona";"10";"139";"U";"1187";"393";"729";"865";"322";"3";"4";"858";"862"
"8";"Barcelona";"1";"Barcelona";"13";"Barcelonès";"08019";"Barcelona";"10";"14";"U";"1057";"361";"655";"759";"298";"0";"7";"752";"759"
"8";"Barcelona";"1";"Barcelona";"13";"Barcelonès";"08019";"Barcelona";"10";"140";"U";"1170";"281";"634";"819";"351";"1";"6";"812";"818"
"8";"Barcelona";"1";"Barcelona";"13";"Barcelonès";"08019";"Barcelona";"10";"141";"U";"862";"301";"493";"616";"246";"2";"2";"612";"614"
"8";"Barcelona";"1";"Barcelona";"13";"Barcelonès";"08019";"Barcelona";"10";"142";"U";"1190";"305";"602";"832";"358";"1";"4";"827";"831"
"8";"Barcelona";"1";"Barcelona";"13";"Barcelonès";"08019";"Barcelona";"10";"143";"A";"663";"208";"385";"471";"192";"1";"3";"467";"470"
"8";"Barcelona";"1";"Barcelona";"13";"Barcelonès";"08019";"Barcelona";"10";"143";"B";"588";"179";"331";"401";"187";"0";"0";"401";"401"
"8";"Barcelona";"1";"Barcelona";"13";"Barcelonès";"08019";"Barcelona";"10";"15";"A";"697";"263";"440";"530";"167";"1";"5";"524";"529"
"8";"Barcelona";"1";"Barcelona";"13";"Barcelonès";"08019";"Barcelona";"10";"15";"B";"628";"260";"397";"489";"139";"0";"2";"487";"489"
"8";"Barcelona";"1";"Barcelona";"13";"Barcelonès";"08019";"Barcelona";"10";"16";"U";"960";"348";"638";"776";"184";"1";"5";"770";"775"
"8";"Barcelona";"1";"Barcelona";"13";"Barcelonès";"08019";"Barcelona";"10";"17";"A";"671";"239";"405";"524";"147";"1";"4";"519";"523"
"8";"Barcelona";"1";"Barcelona";"13";"Barcelonès";"08019";"Barcelona";"10";"17";"B";"562";"216";"363";"437";"125";"0";"5";"432";"437"
"8";"Barcelona";"1";"Barcelona";"13";"Barcelonès";"08019";"Barcelona";"10";"18";"U";"983";"301";"587";"735";"248";"1";"1";"733";"734"
"8";"Barcelona";"1";"Barcelona";"13";"Barcelonès";"08019";"Barcelona";"10";"19";"A";"691";"224";"459";"548";"143";"3";"4";"541";"545"
"8";"Barcelona";"1";"Barcelona";"13";"Barcelonès";"08019";"Barcelona";"10";"19";"B";"569";"200";"381";"449";"120";"0";"3";"446";"449"
"8";"Barcelona";"1";"Barcelona";"13";"Barcelonès";"08019";"Barcelona";"10";"2";"A";"676";"246";"428";"539";"137";"2";"2";"535";"537"
"8";"Barcelona";"1";"Barcelona";"13";"Barcelonès";"08019";"Barcelona";"10";"2";"B";"607";"214";"375";"463";"144";"2";"3";"458";"461"
"8";"Barcelona";"1";"Barcelona";"13";"Barcelonès";"08019";"Barcelona";"10";"20";"U";"1106";"381";"695";"843";"263";"3";"5";"835";"840"
"8";"Barcelona";"1";"Barcelona";"13";"Barcelonès";"08019";"Barcelona";"10";"21";"U";"958";"310";"607";"720";"238";"4";"4";"712";"716"
"8";"Barcelona";"1";"Barcelona";"13";"Barcelonès";"08019";"Barcelona";"10";"22";"U";"974";"286";"593";"773";"201";"0";"3";"770";"773"
"8";"Barcelona";"1";"Barcelona";"13";"Barcelonès";"08019";"Barcelona";"10";"23";"U";"1053";"290";"671";"820";"233";"1";"8";"811";"819"
"8";"Barcelona";"1";"Barcelona";"13";"Barcelonès";"08019";"Barcelona";"10";"234";"A";"808";"243";"538";"653";"155";"3";"3";"647";"650"
"8";"Barcelona";"1";"Barcelona";"13";"Barcelonès";"08019";"Barcelona";"10";"234";"B";"692";"237";"454";"545";"147";"1";"1";"543";"544"
"8";"Barcelona";"1";"Barcelona";"13";"Barcelonès";"08019";"Barcelona";"10";"235";"U";"1015";"330";"657";"781";"234";"3";"4";"774";"778"
"8";"Barcelona";"1";"Barcelona";"13";"Barcelonès";"08019";"Barcelona";"10";"236";"A";"713";"279";"473";"564";"149";"3";"1";"560";"561"
"8";"Barcelona";"1";"Barcelona";"13";"Barcelonès";"08019";"Barcelona";"10";"236";"B";"595";"246";"383";"456";"139";"3";"0";"453";"453"
"8";"Barcelona";"1";"Barcelona";"13";"Barcelonès";"08019";"Barcelona";"10";"237";"U";"582";"197";"372";"443";"139";"4";"5";"434";"439"
"8";"Barcelona";"1";"Barcelona";"13";"Barcelonès";"08019";"Barcelona";"10";"24";"U";"1012";"355";"686";"806";"206";"3";"2";"801";"803"
"8";"Barcelona";"1";"Barcelona";"13";"Barcelonès";"08019";"Barcelona";"10";"25";"U";"995";"342";"633";"765";"230";"2";"2";"761";"763"
"8";"Barcelona";"1";"Barcelona";"13";"Barcelonès";"08019";"Barcelona";"10";"26";"U";"1052";"416";"712";"815";"237";"8";"4";"803";"807"
"8";"Barcelona";"1";"Barcelona";"13";"Barcelonès";"08019";"Barcelona";"10";"27";"U";"1165";"376";"754";"936";"229";"3";"11";"922";"933"
"8";"Barcelona";"1";"Barcelona";"13";"Barcelonès";"08019";"Barcelona";"10";"28";"A";"691";"244";"470";"550";"141";"1";"4";"545";"549"
"8";"Barcelona";"1";"Barcelona";"13";"Barcelonès";"08019";"Barcelona";"10";"28";"B";"619";"219";"408";"481";"138";"4";"0";"477";"477"
"8";"Barcelona";"1";"Barcelona";"13";"Barcelonès";"08019";"Barcelona";"10";"29";"U";"1100";"383";"733";"888";"212";"3";"9";"876";"885"
"8";"Barcelona";"1";"Barcelona";"13";"Barcelonès";"08019";"Barcelona";"10";"3";"U";"1154";"369";"740";"903";"251";"1";"5";"897";"902"
"8";"Barcelona";"1";"Barcelona";"13";"Barcelonès";"08019";"Barcelona";"10";"30";"A";"687";"239";"457";"547";"140";"1";"2";"544";"546"
"8";"Barcelona";"1";"Barcelona";"13";"Barcelonès";"08019";"Barcelona";"10";"30";"B";"653";"258";"458";"526";"127";"0";"2";"524";"526"
"8";"Barcelona";"1";"Barcelona";"13";"Barcelonès";"08019";"Barcelona";"10";"31";"U";"1174";"362";"740";"910";"264";"4";"4";"902";"906"
"8";"Barcelona";"1";"Barcelona";"13";"Barcelonès";"08019";"Barcelona";"10";"32";"U";"1067";"396";"714";"880";"187";"5";"4";"871";"875"
"8";"Barcelona";"1";"Barcelona";"13";"Barcelonès";"08019";"Barcelona";"10";"33";"U";"749";"277";"530";"640";"109";"4";"6";"630";"636"
"8";"Barcelona";"1";"Barcelona";"13";"Barcelonès";"08019";"Barcelona";"10";"34";"A";"729";"276";"475";"579";"150";"1";"2";"576";"578"
"8";"Barcelona";"1";"Barcelona";"13";"Barcelonès";"08019";"Barcelona";"10";"34";"B";"631";"244";"435";"507";"124";"0";"0";"507";"507"
"8";"Barcelona";"1";"Barcelona";"13";"Barcelonès";"08019";"Barcelona";"10";"35";"A";"786";"261";"523";"655";"131";"1";"6";"648";"654"
"8";"Barcelona";"1";"Barcelona";"13";"Barcelonès";"08019";"Barcelona";"10";"35";"B";"728";"242";"485";"600";"128";"1";"0";"599";"599"
"8";"Barcelona";"1";"Barcelona";"13";"Barcelonès";"08019";"Barcelona";"10";"36";"U";"997";"312";"655";"826";"171";"4";"1";"821";"822"
"8";"Barcelona";"1";"Barcelona";"13";"Barcelonès";"08019";"Barcelona";"10";"37";"U";"700";"200";"407";"479";"221";"2";"4";"473";"477"
"8";"Barcelona";"1";"Barcelona";"13";"Barcelonès";"08019";"Barcelona";"10";"38";"U";"1171";"402";"760";"907";"264";"2";"7";"898";"905"
"8";"Barcelona";"1";"Barcelona";"13";"Barcelonès";"08019";"Barcelona";"10";"39";"U";"1124";"353";"715";"864";"260";"2";"3";"859";"862"
"8";"Barcelona";"1";"Barcelona";"13";"Barcelonès";"08019";"Barcelona";"10";"4";"U";"1122";"422";"791";"922";"200";"1";"2";"919";"921"
"8";"Barcelona";"1";"Barcelona";"13";"Barcelonès";"08019";"Barcelona";"10";"40";"A";"694";"235";"415";"533";"161";"2";"6";"525";"531"
"8";"Barcelona";"1";"Barcelona";"13";"Barcelonès";"08019";"Barcelona";"10";"40";"B";"618";"212";"362";"444";"174";"2";"3";"439";"442"
"8";"Barcelona";"1";"Barcelona";"13";"Barcelonès";"08019";"Barcelona";"10";"41";"U";"1135";"365";"657";"880";"255";"7";"5";"868";"873"
"8";"Barcelona";"1";"Barcelona";"13";"Barcelonès";"08019";"Barcelona";"10";"42";"A";"841";"256";"502";"625";"216";"3";"3";"619";"622"
"8";"Barcelona";"1";"Barcelona";"13";"Barcelonès";"08019";"Barcelona";"10";"42";"B";"716";"231";"444";"530";"186";"1";"3";"526";"529"
"8";"Barcelona";"1";"Barcelona";"13";"Barcelonès";"08019";"Barcelona";"10";"43";"U";"1029";"303";"551";"706";"323";"5";"5";"696";"701"
"8";"Barcelona";"1";"Barcelona";"13";"Barcelonès";"08019";"Barcelona";"10";"44";"U";"1077";"278";"670";"867";"210";"5";"2";"860";"862"
"8";"Barcelona";"1";"Barcelona";"13";"Barcelonès";"08019";"Barcelona";"10";"45";"U";"932";"272";"593";"748";"184";"2";"1";"745";"746"
"8";"Barcelona";"1";"Barcelona";"13";"Barcelonès";"08019";"Barcelona";"10";"46";"U";"956";"294";"636";"774";"182";"0";"2";"772";"774"
"8";"Barcelona";"1";"Barcelona";"13";"Barcelonès";"08019";"Barcelona";"10";"47";"A";"676";"196";"421";"539";"137";"0";"1";"538";"539"
"8";"Barcelona";"1";"Barcelona";"13";"Barcelonès";"08019";"Barcelona";"10";"47";"B";"608";"200";"398";"484";"124";"3";"3";"478";"481"
"8";"Barcelona";"1";"Barcelona";"13";"Barcelonès";"08019";"Barcelona";"10";"48";"U";"1081";"359";"673";"846";"235";"1";"3";"842";"845"
"8";"Barcelona";"1";"Barcelona";"13";"Barcelonès";"08019";"Barcelona";"10";"49";"U";"981";"262";"624";"807";"174";"2";"6";"799";"805"
"8";"Barcelona";"1";"Barcelona";"13";"Barcelonès";"08019";"Barcelona";"10";"5";"A";"669";"203";"413";"527";"142";"2";"5";"520";"525"
"8";"Barcelona";"1";"Barcelona";"13";"Barcelonès";"08019";"Barcelona";"10";"5";"B";"595";"189";"328";"472";"123";"4";"3";"465";"468"
"8";"Barcelona";"1";"Barcelona";"13";"Barcelonès";"08019";"Barcelona";"10";"50";"A";"659";"197";"403";"524";"135";"0";"5";"519";"524"
"8";"Barcelona";"1";"Barcelona";"13";"Barcelonès";"08019";"Barcelona";"10";"50";"B";"559";"202";"374";"461";"98";"1";"2";"458";"460"
"8";"Barcelona";"1";"Barcelona";"13";"Barcelonès";"08019";"Barcelona";"10";"51";"U";"1079";"372";"712";"889";"190";"1";"5";"883";"888"
"8";"Barcelona";"1";"Barcelona";"13";"Barcelonès";"08019";"Barcelona";"10";"52";"A";"792";"273";"533";"674";"118";"2";"9";"663";"672"
"8";"Barcelona";"1";"Barcelona";"13";"Barcelonès";"08019";"Barcelona";"10";"52";"B";"730";"234";"503";"629";"101";"1";"7";"621";"628"
"8";"Barcelona";"1";"Barcelona";"13";"Barcelonès";"08019";"Barcelona";"10";"53";"A";"636";"197";"434";"555";"81";"1";"2";"552";"554"
"8";"Barcelona";"1";"Barcelona";"13";"Barcelonès";"08019";"Barcelona";"10";"53";"B";"601";"216";"418";"522";"79";"0";"2";"520";"522"
"8";"Barcelona";"1";"Barcelona";"13";"Barcelonès";"08019";"Barcelona";"10";"54";"U";"645";"206";"424";"529";"116";"1";"2";"526";"528"
"8";"Barcelona";"1";"Barcelona";"13";"Barcelonès";"08019";"Barcelona";"10";"55";"A";"887";"299";"646";"762";"125";"1";"6";"755";"761"
"8";"Barcelona";"1";"Barcelona";"13";"Barcelonès";"08019";"Barcelona";"10";"55";"B";"788";"246";"528";"688";"100";"1";"5";"682";"687"
"8";"Barcelona";"1";"Barcelona";"13";"Barcelonès";"08019";"Barcelona";"10";"56";"U";"1098";"303";"547";"704";"394";"4";"5";"695";"700"
"8";"Barcelona";"1";"Barcelona";"13";"Barcelonès";"08019";"Barcelona";"10";"57";"U";"916";"297";"534";"678";"238";"6";"4";"668";"672"
"8";"Barcelona";"1";"Barcelona";"13";"Barcelonès";"08019";"Barcelona";"10";"58";"U";"784";"210";"457";"583";"201";"9";"1";"573";"574"
"8";"Barcelona";"1";"Barcelona";"13";"Barcelonès";"08019";"Barcelona";"10";"59";"U";"1025";"301";"596";"766";"259";"1";"3";"762";"765"
"8";"Barcelona";"1";"Barcelona";"13";"Barcelonès";"08019";"Barcelona";"10";"6";"A";"695";"240";"436";"540";"155";"3";"0";"537";"537"
"8";"Barcelona";"1";"Barcelona";"13";"Barcelonès";"08019";"Barcelona";"10";"6";"B";"599";"220";"400";"467";"132";"2";"3";"462";"465"
"8";"Barcelona";"1";"Barcelona";"13";"Barcelonès";"08019";"Barcelona";"10";"60";"U";"978";"327";"612";"759";"219";"1";"4";"754";"758"
"8";"Barcelona";"1";"Barcelona";"13";"Barcelonès";"08019";"Barcelona";"10";"61";"A";"680";"260";"474";"570";"110";"2";"1";"567";"568"
"8";"Barcelona";"1";"Barcelona";"13";"Barcelonès";"08019";"Barcelona";"10";"61";"B";"653";"294";"473";"552";"101";"2";"6";"544";"550"
"8";"Barcelona";"1";"Barcelona";"13";"Barcelonès";"08019";"Barcelona";"10";"62";"A";"593";"229";"435";"514";"79";"1";"1";"512";"513"
"8";"Barcelona";"1";"Barcelona";"13";"Barcelonès";"08019";"Barcelona";"10";"62";"B";"539";"203";"375";"441";"98";"1";"1";"439";"440"
"8";"Barcelona";"1";"Barcelona";"13";"Barcelonès";"08019";"Barcelona";"10";"63";"U";"954";"330";"602";"726";"228";"1";"4";"721";"725"
"8";"Barcelona";"1";"Barcelona";"13";"Barcelonès";"08019";"Barcelona";"10";"64";"U";"1158";"362";"737";"910";"248";"1";"5";"904";"909"
"8";"Barcelona";"1";"Barcelona";"13";"Barcelonès";"08019";"Barcelona";"10";"65";"U";"1134";"329";"736";"894";"240";"0";"3";"891";"894"
"8";"Barcelona";"1";"Barcelona";"13";"Barcelonès";"08019";"Barcelona";"10";"66";"A";"734";"292";"477";"598";"136";"0";"4";"594";"598"
"8";"Barcelona";"1";"Barcelona";"13";"Barcelonès";"08019";"Barcelona";"10";"66";"B";"622";"218";"375";"503";"119";"2";"5";"496";"501"
"8";"Barcelona";"1";"Barcelona";"13";"Barcelonès";"08019";"Barcelona";"10";"67";"A";"607";"221";"403";"521";"86";"1";"1";"519";"520"
"8";"Barcelona";"1";"Barcelona";"13";"Barcelonès";"08019";"Barcelona";"10";"67";"B";"542";"193";"356";"453";"89";"0";"2";"451";"453"
"8";"Barcelona";"1";"Barcelona";"13";"Barcelonès";"08019";"Barcelona";"10";"68";"U";"1070";"310";"684";"881";"189";"2";"6";"873";"879"
"8";"Barcelona";"1";"Barcelona";"13";"Barcelonès";"08019";"Barcelona";"10";"69";"A";"700";"285";"455";"549";"151";"1";"8";"540";"548"
"8";"Barcelona";"1";"Barcelona";"13";"Barcelonès";"08019";"Barcelona";"10";"69";"B";"719";"252";"437";"546";"173";"2";"4";"540";"544"
"8";"Barcelona";"1";"Barcelona";"13";"Barcelonès";"08019";"Barcelona";"10";"7";"U";"1066";"298";"701";"911";"155";"3";"5";"903";"908"
"8";"Barcelona";"1";"Barcelona";"13";"Barcelonès";"08019";"Barcelona";"10";"70";"U";"1156";"352";"724";"899";"257";"6";"5";"888";"893"
"8";"Barcelona";"1";"Barcelona";"13";"Barcelonès";"08019";"Barcelona";"10";"71";"A";"709";"275";"489";"596";"113";"7";"6";"583";"589"
"8";"Barcelona";"1";"Barcelona";"13";"Barcelonès";"08019";"Barcelona";"10";"71";"B";"608";"253";"435";"493";"115";"0";"0";"493";"493"
"8";"Barcelona";"1";"Barcelona";"13";"Barcelonès";"08019";"Barcelona";"10";"72";"A";"721";"261";"446";"551";"170";"3";"1";"547";"548"
"8";"Barcelona";"1";"Barcelona";"13";"Barcelonès";"08019";"Barcelona";"10";"72";"B";"641";"248";"395";"498";"143";"1";"2";"495";"497"
"8";"Barcelona";"1";"Barcelona";"13";"Barcelonès";"08019";"Barcelona";"10";"73";"U";"1144";"352";"699";"881";"263";"4";"0";"877";"877"
"8";"Barcelona";"1";"Barcelona";"13";"Barcelonès";"08019";"Barcelona";"10";"74";"U";"1111";"340";"687";"846";"265";"5";"1";"840";"841"
"8";"Barcelona";"1";"Barcelona";"13";"Barcelonès";"08019";"Barcelona";"10";"75";"U";"1077";"357";"655";"838";"239";"0";"4";"834";"838"
"8";"Barcelona";"1";"Barcelona";"13";"Barcelonès";"08019";"Barcelona";"10";"76";"A";"740";"242";"446";"601";"139";"2";"4";"595";"599"
"8";"Barcelona";"1";"Barcelona";"13";"Barcelonès";"08019";"Barcelona";"10";"76";"B";"681";"225";"440";"571";"110";"1";"3";"567";"570"
"8";"Barcelona";"1";"Barcelona";"13";"Barcelonès";"08019";"Barcelona";"10";"77";"A";"585";"246";"411";"495";"90";"0";"1";"494";"495"
"8";"Barcelona";"1";"Barcelona";"13";"Barcelonès";"08019";"Barcelona";"10";"77";"B";"536";"200";"381";"460";"76";"0";"1";"459";"460"
"8";"Barcelona";"1";"Barcelona";"13";"Barcelonès";"08019";"Barcelona";"10";"78";"A";"693";"275";"476";"596";"97";"0";"4";"592";"596"
"8";"Barcelona";"1";"Barcelona";"13";"Barcelonès";"08019";"Barcelona";"10";"78";"B";"658";"261";"482";"591";"67";"1";"2";"588";"590"
"8";"Barcelona";"1";"Barcelona";"13";"Barcelonès";"08019";"Barcelona";"10";"79";"A";"657";"238";"433";"523";"134";"1";"2";"520";"522"
"8";"Barcelona";"1";"Barcelona";"13";"Barcelonès";"08019";"Barcelona";"10";"79";"B";"637";"253";"420";"505";"132";"0";"0";"505";"505"
"8";"Barcelona";"1";"Barcelona";"13";"Barcelonès";"08019";"Barcelona";"10";"8";"A";"653";"223";"417";"503";"150";"3";"2";"498";"500"
"8";"Barcelona";"1";"Barcelona";"13";"Barcelonès";"08019";"Barcelona";"10";"8";"B";"590";"232";"392";"476";"114";"2";"2";"472";"474"
"8";"Barcelona";"1";"Barcelona";"13";"Barcelonès";"08019";"Barcelona";"10";"80";"U";"1099";"335";"694";"867";"232";"1";"2";"864";"866"
"8";"Barcelona";"1";"Barcelona";"13";"Barcelonès";"08019";"Barcelona";"10";"81";"A";"728";"216";"395";"466";"262";"1";"3";"462";"465"
"8";"Barcelona";"1";"Barcelona";"13";"Barcelonès";"08019";"Barcelona";"10";"81";"B";"538";"195";"348";"349";"189";"1";"0";"348";"348"
"8";"Barcelona";"1";"Barcelona";"13";"Barcelonès";"08019";"Barcelona";"10";"82";"U";"896";"193";"385";"472";"424";"9";"5";"458";"463"
"8";"Barcelona";"1";"Barcelona";"13";"Barcelonès";"08019";"Barcelona";"10";"83";"U";"919";"213";"384";"457";"462";"5";"3";"449";"452"
"8";"Barcelona";"1";"Barcelona";"13";"Barcelonès";"08019";"Barcelona";"10";"84";"U";"947";"274";"507";"596";"351";"4";"6";"586";"592"
"8";"Barcelona";"1";"Barcelona";"13";"Barcelonès";"08019";"Barcelona";"10";"85";"U";"1147";"305";"602";"713";"434";"1";"5";"707";"712"
"8";"Barcelona";"1";"Barcelona";"13";"Barcelonès";"08019";"Barcelona";"10";"86";"A";"617";"210";"335";"407";"210";"0";"2";"405";"407"
"8";"Barcelona";"1";"Barcelona";"13";"Barcelonès";"08019";"Barcelona";"10";"86";"B";"578";"207";"300";"402";"176";"4";"4";"394";"398"
"8";"Barcelona";"1";"Barcelona";"13";"Barcelonès";"08019";"Barcelona";"10";"87";"U";"1173";"360";"615";"740";"433";"3";"6";"731";"737"
"8";"Barcelona";"1";"Barcelona";"13";"Barcelonès";"08019";"Barcelona";"10";"88";"A";"674";"196";"421";"525";"149";"2";"2";"521";"523"
"8";"Barcelona";"1";"Barcelona";"13";"Barcelonès";"08019";"Barcelona";"10";"88";"B";"598";"193";"360";"441";"157";"0";"2";"439";"441"
"8";"Barcelona";"1";"Barcelona";"13";"Barcelonès";"08019";"Barcelona";"10";"89";"U";"1100";"318";"540";"651";"449";"2";"2";"647";"649"
"8";"Barcelona";"1";"Barcelona";"13";"Barcelonès";"08019";"Barcelona";"10";"9";"A";"600";"211";"408";"474";"126";"1";"4";"469";"473"
"8";"Barcelona";"1";"Barcelona";"13";"Barcelonès";"08019";"Barcelona";"10";"9";"B";"594";"223";"411";"479";"115";"2";"2";"475";"477"
"8";"Barcelona";"1";"Barcelona";"13";"Barcelonès";"08019";"Barcelona";"10";"90";"U";"974";"317";"593";"709";"265";"4";"1";"704";"705"
"8";"Barcelona";"1";"Barcelona";"13";"Barcelonès";"08019";"Barcelona";"10";"91";"A";"783";"358";"468";"574";"209";"3";"1";"570";"571"
"8";"Barcelona";"1";"Barcelona";"13";"Barcelonès";"08019";"Barcelona";"10";"91";"B";"672";"225";"359";"470";"202";"3";"2";"465";"467"
"8";"Barcelona";"1";"Barcelona";"13";"Barcelonès";"08019";"Barcelona";"10";"92";"A";"714";"266";"471";"581";"133";"1";"3";"577";"580"
"8";"Barcelona";"1";"Barcelona";"13";"Barcelonès";"08019";"Barcelona";"10";"92";"B";"586";"197";"365";"472";"114";"0";"0";"472";"472"
"8";"Barcelona";"1";"Barcelona";"13";"Barcelonès";"08019";"Barcelona";"10";"93";"U";"927";"328";"649";"772";"155";"1";"3";"768";"771"
"8";"Barcelona";"1";"Barcelona";"13";"Barcelonès";"08019";"Barcelona";"10";"94";"A";"897";"259";"494";"651";"246";"1";"4";"646";"650"
"8";"Barcelona";"1";"Barcelona";"13";"Barcelonès";"08019";"Barcelona";"10";"94";"B";"737";"248";"437";"531";"206";"1";"3";"527";"530"
"8";"Barcelona";"1";"Barcelona";"13";"Barcelonès";"08019";"Barcelona";"10";"95";"U";"888";"250";"481";"583";"305";"2";"4";"577";"581"
"8";"Barcelona";"1";"Barcelona";"13";"Barcelonès";"08019";"Barcelona";"10";"96";"U";"1091";"365";"716";"903";"188";"4";"8";"891";"899"
"8";"Barcelona";"1";"Barcelona";"13";"Barcelonès";"08019";"Barcelona";"10";"97";"U";"1095";"397";"730";"888";"207";"5";"7";"876";"883"
"8";"Barcelona";"1";"Barcelona";"13";"Barcelonès";"08019";"Barcelona";"10";"98";"A";"799";"313";"526";"657";"142";"5";"2";"650";"652"
"8";"Barcelona";"1";"Barcelona";"13";"Barcelonès";"08019";"Barcelona";"10";"98";"B";"707";"232";"441";"585";"122";"2";"3";"580";"583"
"8";"Barcelona";"1";"Barcelona";"13";"Barcelonès";"08019";"Barcelona";"10";"99";"U";"827";"255";"464";"560";"267";"1";"2";"557";"559"
"8";"Barcelona";"1";"Barcelona";"13";"Barcelonès";"08019";"Barcelona";"2";"1";"U";"815";"296";"524";"626";"189";"1";"3";"622";"625"
"8";"Barcelona";"1";"Barcelona";"13";"Barcelonès";"08019";"Barcelona";"2";"10";"U";"845";"295";"590";"714";"131";"1";"8";"705";"713"
"8";"Barcelona";"1";"Barcelona";"13";"Barcelonès";"08019";"Barcelona";"2";"100";"U";"1048";"306";"693";"850";"198";"0";"7";"843";"850"
"8";"Barcelona";"1";"Barcelona";"13";"Barcelonès";"08019";"Barcelona";"2";"101";"A";"784";"272";"544";"623";"161";"3";"4";"616";"620"
"8";"Barcelona";"1";"Barcelona";"13";"Barcelonès";"08019";"Barcelona";"2";"101";"B";"724";"249";"451";"548";"176";"0";"0";"548";"548"
"8";"Barcelona";"1";"Barcelona";"13";"Barcelonès";"08019";"Barcelona";"2";"102";"U";"1062";"355";"711";"879";"183";"1";"6";"872";"878"
"8";"Barcelona";"1";"Barcelona";"13";"Barcelonès";"08019";"Barcelona";"2";"103";"U";"1186";"390";"756";"923";"263";"4";"1";"918";"919"
"8";"Barcelona";"1";"Barcelona";"13";"Barcelonès";"08019";"Barcelona";"2";"104";"U";"840";"285";"578";"687";"153";"0";"1";"686";"687"
"8";"Barcelona";"1";"Barcelona";"13";"Barcelonès";"08019";"Barcelona";"2";"105";"A";"741";"267";"478";"592";"149";"1";"6";"585";"591"
"8";"Barcelona";"1";"Barcelona";"13";"Barcelonès";"08019";"Barcelona";"2";"105";"B";"662";"239";"433";"520";"142";"0";"3";"517";"520"
"8";"Barcelona";"1";"Barcelona";"13";"Barcelonès";"08019";"Barcelona";"2";"106";"U";"993";"295";"608";"788";"205";"1";"4";"783";"787"
"8";"Barcelona";"1";"Barcelona";"13";"Barcelonès";"08019";"Barcelona";"2";"107";"A";"630";"229";"451";"534";"96";"0";"2";"532";"534"
"8";"Barcelona";"1";"Barcelona";"13";"Barcelonès";"08019";"Barcelona";"2";"107";"B";"604";"209";"411";"511";"93";"2";"2";"507";"509"
"8";"Barcelona";"1";"Barcelona";"13";"Barcelonès";"08019";"Barcelona";"2";"108";"A";"624";"193";"407";"522";"102";"3";"3";"516";"519"
"8";"Barcelona";"1";"Barcelona";"13";"Barcelonès";"08019";"Barcelona";"2";"108";"B";"548";"187";"364";"446";"102";"4";"1";"441";"442"
"8";"Barcelona";"1";"Barcelona";"13";"Barcelonès";"08019";"Barcelona";"2";"109";"A";"693";"233";"453";"563";"130";"0";"2";"561";"563"
"8";"Barcelona";"1";"Barcelona";"13";"Barcelonès";"08019";"Barcelona";"2";"109";"B";"759";"256";"497";"630";"129";"0";"3";"627";"630"
"8";"Barcelona";"1";"Barcelona";"13";"Barcelonès";"08019";"Barcelona";"2";"11";"U";"857";"247";"576";"703";"154";"0";"4";"699";"703"
"8";"Barcelona";"1";"Barcelona";"13";"Barcelonès";"08019";"Barcelona";"2";"110";"A";"641";"201";"395";"502";"139";"2";"5";"495";"500"
"8";"Barcelona";"1";"Barcelona";"13";"Barcelonès";"08019";"Barcelona";"2";"110";"B";"622";"219";"387";"484";"138";"1";"0";"483";"483"
"8";"Barcelona";"1";"Barcelona";"13";"Barcelonès";"08019";"Barcelona";"2";"111";"A";"687";"200";"401";"516";"171";"0";"0";"516";"516"
"8";"Barcelona";"1";"Barcelona";"13";"Barcelonès";"08019";"Barcelona";"2";"111";"B";"580";"208";"381";"456";"124";"6";"3";"447";"450"
"8";"Barcelona";"1";"Barcelona";"13";"Barcelonès";"08019";"Barcelona";"2";"112";"U";"1023";"305";"657";"873";"150";"3";"2";"868";"870"
"8";"Barcelona";"1";"Barcelona";"13";"Barcelonès";"08019";"Barcelona";"2";"113";"A";"821";"271";"524";"679";"142";"2";"1";"676";"677"
"8";"Barcelona";"1";"Barcelona";"13";"Barcelonès";"08019";"Barcelona";"2";"113";"B";"687";"242";"470";"593";"94";"3";"0";"590";"590"
"8";"Barcelona";"1";"Barcelona";"13";"Barcelonès";"08019";"Barcelona";"2";"114";"A";"651";"179";"425";"526";"125";"1";"3";"522";"525"
"8";"Barcelona";"1";"Barcelona";"13";"Barcelonès";"08019";"Barcelona";"2";"114";"B";"607";"197";"395";"480";"127";"0";"0";"480";"480"
"8";"Barcelona";"1";"Barcelona";"13";"Barcelonès";"08019";"Barcelona";"2";"115";"U";"966";"335";"620";"762";"204";"6";"3";"753";"756"
"8";"Barcelona";"1";"Barcelona";"13";"Barcelonès";"08019";"Barcelona";"2";"116";"U";"803";"265";"553";"691";"112";"0";"4";"687";"691"
"8";"Barcelona";"1";"Barcelona";"13";"Barcelonès";"08019";"Barcelona";"2";"117";"U";"891";"270";"606";"744";"147";"1";"1";"742";"743"
"8";"Barcelona";"1";"Barcelona";"13";"Barcelonès";"08019";"Barcelona";"2";"118";"U";"1102";"316";"730";"899";"203";"4";"3";"892";"895"
"8";"Barcelona";"1";"Barcelona";"13";"Barcelonès";"08019";"Barcelona";"2";"119";"U";"991";"292";"653";"838";"153";"0";"6";"832";"838"
"8";"Barcelona";"1";"Barcelona";"13";"Barcelonès";"08019";"Barcelona";"2";"12";"U";"1067";"360";"698";"838";"229";"1";"3";"834";"837"
"8";"Barcelona";"1";"Barcelona";"13";"Barcelonès";"08019";"Barcelona";"2";"120";"U";"897";"279";"610";"717";"180";"3";"7";"707";"714"
"8";"Barcelona";"1";"Barcelona";"13";"Barcelonès";"08019";"Barcelona";"2";"121";"U";"926";"274";"696";"746";"180";"1";"3";"742";"745"
"8";"Barcelona";"1";"Barcelona";"13";"Barcelonès";"08019";"Barcelona";"2";"122";"U";"837";"262";"555";"707";"130";"1";"5";"701";"706"
"8";"Barcelona";"1";"Barcelona";"13";"Barcelonès";"08019";"Barcelona";"2";"123";"U";"819";"281";"546";"654";"165";"0";"0";"654";"654"
"8";"Barcelona";"1";"Barcelona";"13";"Barcelonès";"08019";"Barcelona";"2";"124";"U";"910";"284";"623";"760";"150";"0";"0";"760";"760"
"8";"Barcelona";"1";"Barcelona";"13";"Barcelonès";"08019";"Barcelona";"2";"125";"A";"688";"247";"446";"551";"137";"1";"2";"548";"550"
"8";"Barcelona";"1";"Barcelona";"13";"Barcelonès";"08019";"Barcelona";"2";"125";"B";"588";"212";"388";"468";"120";"4";"2";"462";"464"
"8";"Barcelona";"1";"Barcelona";"13";"Barcelonès";"08019";"Barcelona";"2";"126";"U";"1176";"348";"753";"951";"225";"0";"4";"947";"951"
"8";"Barcelona";"1";"Barcelona";"13";"Barcelonès";"08019";"Barcelona";"2";"127";"U";"795";"247";"475";"591";"204";"1";"5";"585";"590"
"8";"Barcelona";"1";"Barcelona";"13";"Barcelonès";"08019";"Barcelona";"2";"128";"U";"915";"282";"533";"687";"228";"0";"2";"685";"687"
"8";"Barcelona";"1";"Barcelona";"13";"Barcelonès";"08019";"Barcelona";"2";"129";"U";"1144";"357";"719";"881";"263";"4";"2";"875";"877"
"8";"Barcelona";"1";"Barcelona";"13";"Barcelonès";"08019";"Barcelona";"2";"13";"U";"764";"256";"484";"573";"191";"2";"1";"570";"571"
"8";"Barcelona";"1";"Barcelona";"13";"Barcelonès";"08019";"Barcelona";"2";"130";"U";"893";"335";"525";"775";"118";"1";"3";"771";"774"
"8";"Barcelona";"1";"Barcelona";"13";"Barcelonès";"08019";"Barcelona";"2";"131";"U";"850";"318";"528";"659";"191";"4";"3";"652";"655"
"8";"Barcelona";"1";"Barcelona";"13";"Barcelonès";"08019";"Barcelona";"2";"132";"U";"881";"288";"541";"682";"199";"3";"2";"677";"679"
"8";"Barcelona";"1";"Barcelona";"13";"Barcelonès";"08019";"Barcelona";"2";"133";"U";"701";"269";"484";"584";"117";"1";"1";"582";"583"
"8";"Barcelona";"1";"Barcelona";"13";"Barcelonès";"08019";"Barcelona";"2";"134";"U";"1074";"330";"706";"829";"245";"2";"7";"820";"827"
"8";"Barcelona";"1";"Barcelona";"13";"Barcelonès";"08019";"Barcelona";"2";"135";"A";"782";"243";"497";"587";"195";"0";"6";"581";"587"
"8";"Barcelona";"1";"Barcelona";"13";"Barcelonès";"08019";"Barcelona";"2";"135";"B";"668";"185";"436";"521";"147";"0";"4";"517";"521"
"8";"Barcelona";"1";"Barcelona";"13";"Barcelonès";"08019";"Barcelona";"2";"136";"U";"683";"237";"452";"547";"136";"2";"2";"543";"545"
"8";"Barcelona";"1";"Barcelona";"13";"Barcelonès";"08019";"Barcelona";"2";"137";"U";"968";"307";"606";"748";"220";"7";"5";"736";"741"
"8";"Barcelona";"1";"Barcelona";"13";"Barcelonès";"08019";"Barcelona";"2";"138";"A";"724";"217";"482";"599";"125";"0";"0";"599";"599"
"8";"Barcelona";"1";"Barcelona";"13";"Barcelonès";"08019";"Barcelona";"2";"138";"B";"689";"225";"471";"572";"117";"2";"4";"566";"570"
"8";"Barcelona";"1";"Barcelona";"13";"Barcelonès";"08019";"Barcelona";"2";"139";"U";"1116";"387";"675";"832";"284";"4";"4";"824";"828"
"8";"Barcelona";"1";"Barcelona";"13";"Barcelonès";"08019";"Barcelona";"2";"14";"U";"803";"268";"485";"589";"214";"6";"1";"582";"583"
"8";"Barcelona";"1";"Barcelona";"13";"Barcelonès";"08019";"Barcelona";"2";"140";"A";"769";"250";"486";"616";"153";"1";"6";"609";"615"
"8";"Barcelona";"1";"Barcelona";"13";"Barcelonès";"08019";"Barcelona";"2";"140";"B";"679";"224";"436";"535";"144";"1";"4";"530";"534"
"8";"Barcelona";"1";"Barcelona";"13";"Barcelonès";"08019";"Barcelona";"2";"141";"U";"875";"259";"548";"677";"198";"3";"5";"669";"674"
"8";"Barcelona";"1";"Barcelona";"13";"Barcelonès";"08019";"Barcelona";"2";"142";"A";"746";"223";"452";"561";"185";"2";"3";"556";"559"
"8";"Barcelona";"1";"Barcelona";"13";"Barcelonès";"08019";"Barcelona";"2";"142";"B";"641";"212";"402";"490";"151";"3";"3";"484";"487"
"8";"Barcelona";"1";"Barcelona";"13";"Barcelonès";"08019";"Barcelona";"2";"143";"U";"885";"299";"581";"699";"186";"4";"3";"692";"695"
"8";"Barcelona";"1";"Barcelona";"13";"Barcelonès";"08019";"Barcelona";"2";"144";"U";"1026";"306";"663";"822";"204";"0";"3";"819";"822"
"8";"Barcelona";"1";"Barcelona";"13";"Barcelonès";"08019";"Barcelona";"2";"145";"U";"866";"239";"502";"604";"262";"2";"1";"601";"602"
"8";"Barcelona";"1";"Barcelona";"13";"Barcelonès";"08019";"Barcelona";"2";"146";"U";"848";"282";"534";"646";"202";"2";"1";"643";"644"
"8";"Barcelona";"1";"Barcelona";"13";"Barcelonès";"08019";"Barcelona";"2";"147";"A";"783";"278";"503";"612";"171";"2";"2";"608";"610"
"8";"Barcelona";"1";"Barcelona";"13";"Barcelonès";"08019";"Barcelona";"2";"147";"B";"737";"260";"473";"575";"162";"1";"3";"571";"574"
"8";"Barcelona";"1";"Barcelona";"13";"Barcelonès";"08019";"Barcelona";"2";"148";"U";"1156";"406";"753";"937";"219";"2";"4";"931";"935"
"8";"Barcelona";"1";"Barcelona";"13";"Barcelonès";"08019";"Barcelona";"2";"149";"A";"619";"203";"372";"470";"149";"0";"1";"469";"470"
"8";"Barcelona";"1";"Barcelona";"13";"Barcelonès";"08019";"Barcelona";"2";"149";"B";"593";"227";"393";"471";"122";"2";"0";"469";"469"
"8";"Barcelona";"1";"Barcelona";"13";"Barcelonès";"08019";"Barcelona";"2";"15";"U";"1085";"383";"635";"787";"298";"3";"3";"781";"784"
"8";"Barcelona";"1";"Barcelona";"13";"Barcelonès";"08019";"Barcelona";"2";"150";"U";"982";"289";"586";"714";"268";"1";"5";"708";"713"
"8";"Barcelona";"1";"Barcelona";"13";"Barcelonès";"08019";"Barcelona";"2";"151";"U";"987";"305";"631";"762";"225";"2";"1";"759";"760"
"8";"Barcelona";"1";"Barcelona";"13";"Barcelonès";"08019";"Barcelona";"2";"152";"U";"983";"315";"667";"803";"180";"0";"4";"799";"803"
"8";"Barcelona";"1";"Barcelona";"13";"Barcelonès";"08019";"Barcelona";"2";"153";"U";"1003";"408";"673";"820";"183";"0";"1";"819";"820"
"8";"Barcelona";"1";"Barcelona";"13";"Barcelonès";"08019";"Barcelona";"2";"154";"U";"660";"235";"432";"506";"154";"2";"6";"498";"504"
"8";"Barcelona";"1";"Barcelona";"13";"Barcelonès";"08019";"Barcelona";"2";"155";"A";"706";"279";"473";"541";"165";"3";"0";"538";"538"
"8";"Barcelona";"1";"Barcelona";"13";"Barcelonès";"08019";"Barcelona";"2";"155";"B";"636";"230";"420";"487";"149";"3";"3";"481";"484"
"8";"Barcelona";"1";"Barcelona";"13";"Barcelonès";"08019";"Barcelona";"2";"156";"U";"969";"314";"630";"773";"196";"5";"6";"762";"768"
"8";"Barcelona";"1";"Barcelona";"13";"Barcelonès";"08019";"Barcelona";"2";"157";"U";"816";"346";"573";"611";"205";"5";"3";"603";"606"
"8";"Barcelona";"1";"Barcelona";"13";"Barcelonès";"08019";"Barcelona";"2";"158";"A";"652";"259";"444";"535";"117";"1";"2";"532";"534"
"8";"Barcelona";"1";"Barcelona";"13";"Barcelonès";"08019";"Barcelona";"2";"158";"B";"556";"201";"364";"452";"104";"1";"3";"448";"451"
"8";"Barcelona";"1";"Barcelona";"13";"Barcelonès";"08019";"Barcelona";"2";"159";"A";"677";"270";"466";"556";"121";"2";"0";"554";"554"
"8";"Barcelona";"1";"Barcelona";"13";"Barcelonès";"08019";"Barcelona";"2";"159";"B";"592";"226";"390";"472";"120";"0";"1";"471";"472"
"8";"Barcelona";"1";"Barcelona";"13";"Barcelonès";"08019";"Barcelona";"2";"16";"A";"723";"237";"491";"595";"128";"0";"3";"592";"595"
"8";"Barcelona";"1";"Barcelona";"13";"Barcelonès";"08019";"Barcelona";"2";"16";"B";"628";"237";"425";"521";"107";"4";"4";"513";"517"
"8";"Barcelona";"1";"Barcelona";"13";"Barcelonès";"08019";"Barcelona";"2";"160";"A";"745";"243";"465";"589";"156";"4";"2";"583";"585"
"8";"Barcelona";"1";"Barcelona";"13";"Barcelonès";"08019";"Barcelona";"2";"160";"B";"674";"230";"441";"528";"146";"3";"2";"523";"525"
"8";"Barcelona";"1";"Barcelona";"13";"Barcelonès";"08019";"Barcelona";"2";"161";"U";"793";"270";"505";"625";"168";"0";"3";"622";"625"
"8";"Barcelona";"1";"Barcelona";"13";"Barcelonès";"08019";"Barcelona";"2";"162";"U";"975";"318";"573";"732";"243";"0";"3";"729";"732"
"8";"Barcelona";"1";"Barcelona";"13";"Barcelonès";"08019";"Barcelona";"2";"163";"A";"645";"227";"396";"483";"162";"1";"3";"479";"482"
"8";"Barcelona";"1";"Barcelona";"13";"Barcelonès";"08019";"Barcelona";"2";"163";"B";"635";"218";"393";"495";"140";"1";"4";"490";"494"
"8";"Barcelona";"1";"Barcelona";"13";"Barcelonès";"08019";"Barcelona";"2";"164";"U";"915";"236";"566";"696";"219";"3";"4";"689";"693"
"8";"Barcelona";"1";"Barcelona";"13";"Barcelonès";"08019";"Barcelona";"2";"165";"U";"1150";"311";"705";"876";"274";"2";"6";"868";"874"
"8";"Barcelona";"1";"Barcelona";"13";"Barcelonès";"08019";"Barcelona";"2";"166";"A";"746";"232";"449";"557";"189";"1";"1";"555";"556"
"8";"Barcelona";"1";"Barcelona";"13";"Barcelonès";"08019";"Barcelona";"2";"166";"B";"675";"226";"421";"527";"148";"1";"2";"524";"526"
"8";"Barcelona";"1";"Barcelona";"13";"Barcelonès";"08019";"Barcelona";"2";"167";"A";"829";"315";"571";"680";"149";"1";"5";"674";"679"
"8";"Barcelona";"1";"Barcelona";"13";"Barcelonès";"08019";"Barcelona";"2";"167";"B";"679";"242";"432";"517";"162";"1";"1";"515";"516"
"8";"Barcelona";"1";"Barcelona";"13";"Barcelonès";"08019";"Barcelona";"2";"168";"A";"798";"262";"513";"627";"171";"2";"2";"623";"625"
"8";"Barcelona";"1";"Barcelona";"13";"Barcelonès";"08019";"Barcelona";"2";"168";"B";"702";"215";"405";"506";"196";"4";"1";"501";"502"
"8";"Barcelona";"1";"Barcelona";"13";"Barcelonès";"08019";"Barcelona";"2";"169";"U";"1095";"396";"672";"818";"277";"5";"11";"802";"813"
"8";"Barcelona";"1";"Barcelona";"13";"Barcelonès";"08019";"Barcelona";"2";"17";"A";"666";"234";"432";"547";"119";"3";"1";"543";"544"
"8";"Barcelona";"1";"Barcelona";"13";"Barcelonès";"08019";"Barcelona";"2";"17";"B";"679";"230";"448";"548";"131";"1";"0";"547";"547"
"8";"Barcelona";"1";"Barcelona";"13";"Barcelonès";"08019";"Barcelona";"2";"170";"U";"1141";"294";"700";"852";"289";"2";"2";"848";"850"
"8";"Barcelona";"1";"Barcelona";"13";"Barcelonès";"08019";"Barcelona";"2";"171";"U";"1111";"320";"662";"808";"303";"3";"3";"802";"805"
"8";"Barcelona";"1";"Barcelona";"13";"Barcelonès";"08019";"Barcelona";"2";"172";"U";"1072";"287";"660";"736";"336";"1";"1";"734";"735"
"8";"Barcelona";"1";"Barcelona";"13";"Barcelonès";"08019";"Barcelona";"2";"173";"U";"1121";"280";"647";"857";"264";"3";"3";"851";"854"
"8";"Barcelona";"1";"Barcelona";"13";"Barcelonès";"08019";"Barcelona";"2";"18";"A";"702";"218";"489";"577";"125";"3";"2";"572";"574"
"8";"Barcelona";"1";"Barcelona";"13";"Barcelonès";"08019";"Barcelona";"2";"18";"B";"637";"242";"426";"519";"118";"0";"6";"513";"519"
"8";"Barcelona";"1";"Barcelona";"13";"Barcelonès";"08019";"Barcelona";"2";"19";"A";"719";"263";"489";"586";"133";"0";"3";"583";"586"
"8";"Barcelona";"1";"Barcelona";"13";"Barcelonès";"08019";"Barcelona";"2";"19";"B";"674";"219";"409";"534";"140";"2";"0";"532";"532"
"8";"Barcelona";"1";"Barcelona";"13";"Barcelonès";"08019";"Barcelona";"2";"2";"A";"737";"239";"406";"505";"232";"0";"2";"503";"505"
"8";"Barcelona";"1";"Barcelona";"13";"Barcelonès";"08019";"Barcelona";"2";"2";"B";"647";"216";"382";"454";"193";"1";"1";"452";"453"
"8";"Barcelona";"1";"Barcelona";"13";"Barcelonès";"08019";"Barcelona";"2";"20";"U";"947";"280";"562";"698";"249";"7";"1";"690";"691"
"8";"Barcelona";"1";"Barcelona";"13";"Barcelonès";"08019";"Barcelona";"2";"21";"U";"1067";"389";"694";"837";"230";"1";"5";"831";"836"
"8";"Barcelona";"1";"Barcelona";"13";"Barcelonès";"08019";"Barcelona";"2";"22";"U";"881";"312";"566";"695";"186";"2";"2";"691";"693"
"8";"Barcelona";"1";"Barcelona";"13";"Barcelonès";"08019";"Barcelona";"2";"23";"U";"865";"278";"557";"686";"179";"2";"2";"682";"684"
"8";"Barcelona";"1";"Barcelona";"13";"Barcelonès";"08019";"Barcelona";"2";"24";"U";"797";"253";"489";"611";"186";"1";"5";"605";"610"
"8";"Barcelona";"1";"Barcelona";"13";"Barcelonès";"08019";"Barcelona";"2";"25";"U";"845";"281";"542";"638";"207";"2";"4";"632";"636"
"8";"Barcelona";"1";"Barcelona";"13";"Barcelonès";"08019";"Barcelona";"2";"26";"A";"789";"266";"501";"613";"176";"0";"4";"609";"613"
"8";"Barcelona";"1";"Barcelona";"13";"Barcelonès";"08019";"Barcelona";"2";"26";"B";"723";"223";"473";"588";"135";"2";"0";"586";"586"
"8";"Barcelona";"1";"Barcelona";"13";"Barcelonès";"08019";"Barcelona";"2";"27";"A";"796";"229";"490";"628";"168";"4";"1";"623";"624"
"8";"Barcelona";"1";"Barcelona";"13";"Barcelonès";"08019";"Barcelona";"2";"27";"B";"703";"265";"479";"571";"132";"0";"1";"570";"571"
"8";"Barcelona";"1";"Barcelona";"13";"Barcelonès";"08019";"Barcelona";"2";"28";"A";"769";"249";"461";"614";"155";"0";"3";"611";"614"
"8";"Barcelona";"1";"Barcelona";"13";"Barcelonès";"08019";"Barcelona";"2";"28";"B";"707";"223";"444";"550";"157";"0";"3";"547";"550"
"8";"Barcelona";"1";"Barcelona";"13";"Barcelonès";"08019";"Barcelona";"2";"29";"U";"824";"295";"531";"638";"186";"0";"4";"634";"638"
"8";"Barcelona";"1";"Barcelona";"13";"Barcelonès";"08019";"Barcelona";"2";"3";"U";"893";"313";"600";"682";"211";"2";"2";"678";"680"
"8";"Barcelona";"1";"Barcelona";"13";"Barcelonès";"08019";"Barcelona";"2";"30";"U";"863";"273";"550";"674";"189";"8";"15";"651";"666"
"8";"Barcelona";"1";"Barcelona";"13";"Barcelonès";"08019";"Barcelona";"2";"31";"U";"840";"353";"613";"698";"142";"0";"2";"696";"698"
"8";"Barcelona";"1";"Barcelona";"13";"Barcelonès";"08019";"Barcelona";"2";"32";"U";"903";"303";"538";"650";"253";"2";"2";"646";"648"
"8";"Barcelona";"1";"Barcelona";"13";"Barcelonès";"08019";"Barcelona";"2";"33";"U";"865";"300";"551";"687";"178";"1";"0";"686";"686"
"8";"Barcelona";"1";"Barcelona";"13";"Barcelonès";"08019";"Barcelona";"2";"34";"U";"809";"274";"526";"617";"192";"3";"2";"612";"614"
"8";"Barcelona";"1";"Barcelona";"13";"Barcelonès";"08019";"Barcelona";"2";"35";"U";"981";"326";"640";"760";"221";"1";"5";"754";"759"
"8";"Barcelona";"1";"Barcelona";"13";"Barcelonès";"08019";"Barcelona";"2";"36";"U";"911";"323";"638";"751";"160";"2";"3";"746";"749"
"8";"Barcelona";"1";"Barcelona";"13";"Barcelonès";"08019";"Barcelona";"2";"37";"U";"941";"359";"642";"781";"160";"0";"2";"779";"781"
"8";"Barcelona";"1";"Barcelona";"13";"Barcelonès";"08019";"Barcelona";"2";"38";"A";"614";"202";"401";"504";"110";"1";"1";"502";"503"
"8";"Barcelona";"1";"Barcelona";"13";"Barcelonès";"08019";"Barcelona";"2";"38";"B";"584";"211";"429";"491";"93";"0";"3";"488";"491"
"8";"Barcelona";"1";"Barcelona";"13";"Barcelonès";"08019";"Barcelona";"2";"39";"A";"642";"215";"416";"495";"147";"1";"5";"489";"494"
"8";"Barcelona";"1";"Barcelona";"13";"Barcelonès";"08019";"Barcelona";"2";"39";"B";"601";"210";"379";"458";"143";"0";"0";"458";"458"
"8";"Barcelona";"1";"Barcelona";"13";"Barcelonès";"08019";"Barcelona";"2";"4";"U";"974";"313";"598";"756";"218";"0";"5";"751";"756"
"8";"Barcelona";"1";"Barcelona";"13";"Barcelonès";"08019";"Barcelona";"2";"40";"U";"1087";"343";"658";"775";"312";"0";"3";"772";"775"
"8";"Barcelona";"1";"Barcelona";"13";"Barcelonès";"08019";"Barcelona";"2";"41";"A";"638";"212";"411";"492";"146";"4";"2";"486";"488"
"8";"Barcelona";"1";"Barcelona";"13";"Barcelonès";"08019";"Barcelona";"2";"41";"B";"559";"176";"346";"434";"125";"3";"2";"429";"431"
"8";"Barcelona";"1";"Barcelona";"13";"Barcelonès";"08019";"Barcelona";"2";"42";"A";"691";"247";"476";"571";"120";"1";"1";"569";"570"
"8";"Barcelona";"1";"Barcelona";"13";"Barcelonès";"08019";"Barcelona";"2";"42";"B";"658";"237";"440";"530";"128";"0";"1";"529";"530"
"8";"Barcelona";"1";"Barcelona";"13";"Barcelonès";"08019";"Barcelona";"2";"43";"U";"1101";"354";"755";"918";"183";"1";"1";"916";"917"
"8";"Barcelona";"1";"Barcelona";"13";"Barcelonès";"08019";"Barcelona";"2";"44";"U";"884";"283";"572";"673";"211";"3";"1";"669";"670"
"8";"Barcelona";"1";"Barcelona";"13";"Barcelonès";"08019";"Barcelona";"2";"45";"U";"852";"286";"575";"679";"173";"5";"4";"670";"674"
"8";"Barcelona";"1";"Barcelona";"13";"Barcelonès";"08019";"Barcelona";"2";"46";"A";"732";"217";"426";"545";"187";"1";"4";"540";"544"
"8";"Barcelona";"1";"Barcelona";"13";"Barcelonès";"08019";"Barcelona";"2";"46";"B";"621";"208";"411";"478";"143";"1";"2";"475";"477"
"8";"Barcelona";"1";"Barcelona";"13";"Barcelonès";"08019";"Barcelona";"2";"47";"A";"678";"216";"437";"547";"131";"2";"2";"543";"545"
"8";"Barcelona";"1";"Barcelona";"13";"Barcelonès";"08019";"Barcelona";"2";"47";"B";"681";"229";"446";"537";"144";"2";"1";"534";"535"
"8";"Barcelona";"1";"Barcelona";"13";"Barcelonès";"08019";"Barcelona";"2";"48";"U";"823";"305";"566";"636";"187";"1";"0";"635";"635"
"8";"Barcelona";"1";"Barcelona";"13";"Barcelonès";"08019";"Barcelona";"2";"49";"A";"712";"250";"458";"548";"164";"1";"4";"543";"547"
"8";"Barcelona";"1";"Barcelona";"13";"Barcelonès";"08019";"Barcelona";"2";"49";"B";"661";"237";"424";"504";"157";"3";"0";"501";"501"
"8";"Barcelona";"1";"Barcelona";"13";"Barcelonès";"08019";"Barcelona";"2";"5";"A";"809";"276";"550";"687";"122";"1";"4";"682";"686"
"8";"Barcelona";"1";"Barcelona";"13";"Barcelonès";"08019";"Barcelona";"2";"5";"B";"699";"286";"485";"582";"117";"2";"4";"576";"580"
"8";"Barcelona";"1";"Barcelona";"13";"Barcelonès";"08019";"Barcelona";"2";"50";"U";"1124";"358";"669";"822";"302";"6";"6";"810";"816"
"8";"Barcelona";"1";"Barcelona";"13";"Barcelonès";"08019";"Barcelona";"2";"51";"A";"675";"207";"436";"504";"171";"0";"1";"503";"504"
"8";"Barcelona";"1";"Barcelona";"13";"Barcelonès";"08019";"Barcelona";"2";"51";"B";"617";"192";"362";"458";"159";"1";"1";"456";"457"
"8";"Barcelona";"1";"Barcelona";"13";"Barcelonès";"08019";"Barcelona";"2";"52";"A";"627";"207";"389";"492";"135";"2";"0";"490";"490"
"8";"Barcelona";"1";"Barcelona";"13";"Barcelonès";"08019";"Barcelona";"2";"52";"B";"595";"204";"429";"490";"105";"0";"1";"489";"490"
"8";"Barcelona";"1";"Barcelona";"13";"Barcelonès";"08019";"Barcelona";"2";"53";"A";"669";"250";"454";"532";"137";"2";"0";"530";"530"
"8";"Barcelona";"1";"Barcelona";"13";"Barcelonès";"08019";"Barcelona";"2";"53";"B";"606";"211";"400";"470";"136";"2";"0";"468";"468"
"8";"Barcelona";"1";"Barcelona";"13";"Barcelonès";"08019";"Barcelona";"2";"54";"A";"705";"266";"482";"592";"113";"3";"1";"588";"589"
"8";"Barcelona";"1";"Barcelona";"13";"Barcelonès";"08019";"Barcelona";"2";"54";"B";"601";"220";"404";"468";"133";"3";"2";"463";"465"
"8";"Barcelona";"1";"Barcelona";"13";"Barcelonès";"08019";"Barcelona";"2";"55";"A";"626";"201";"381";"477";"149";"3";"4";"470";"474"
"8";"Barcelona";"1";"Barcelona";"13";"Barcelonès";"08019";"Barcelona";"2";"55";"B";"687";"235";"453";"554";"133";"2";"2";"550";"552"
"8";"Barcelona";"1";"Barcelona";"13";"Barcelonès";"08019";"Barcelona";"2";"56";"U";"1038";"351";"656";"789";"249";"1";"7";"781";"788"
"8";"Barcelona";"1";"Barcelona";"13";"Barcelonès";"08019";"Barcelona";"2";"57";"U";"894";"305";"570";"732";"162";"1";"2";"729";"731"
"8";"Barcelona";"1";"Barcelona";"13";"Barcelonès";"08019";"Barcelona";"2";"58";"U";"1024";"351";"716";"852";"172";"1";"9";"842";"851"
"8";"Barcelona";"1";"Barcelona";"13";"Barcelonès";"08019";"Barcelona";"2";"59";"A";"588";"212";"396";"493";"95";"4";"0";"489";"489"
"8";"Barcelona";"1";"Barcelona";"13";"Barcelonès";"08019";"Barcelona";"2";"59";"B";"603";"197";"404";"501";"102";"0";"3";"498";"501"
"8";"Barcelona";"1";"Barcelona";"13";"Barcelonès";"08019";"Barcelona";"2";"6";"A";"577";"220";"403";"485";"92";"4";"3";"478";"481"
"8";"Barcelona";"1";"Barcelona";"13";"Barcelonès";"08019";"Barcelona";"2";"6";"B";"520";"221";"379";"452";"68";"1";"0";"451";"451"
"8";"Barcelona";"1";"Barcelona";"13";"Barcelonès";"08019";"Barcelona";"2";"60";"A";"546";"189";"355";"437";"109";"1";"3";"433";"436"
"8";"Barcelona";"1";"Barcelona";"13";"Barcelonès";"08019";"Barcelona";"2";"60";"B";"649";"219";"446";"536";"113";"2";"1";"533";"534"
"8";"Barcelona";"1";"Barcelona";"13";"Barcelonès";"08019";"Barcelona";"2";"61";"U";"883";"307";"582";"698";"185";"9";"5";"684";"689"
"8";"Barcelona";"1";"Barcelona";"13";"Barcelonès";"08019";"Barcelona";"2";"62";"U";"1032";"358";"680";"866";"166";"0";"4";"862";"866"
"8";"Barcelona";"1";"Barcelona";"13";"Barcelonès";"08019";"Barcelona";"2";"63";"U";"861";"312";"590";"705";"156";"1";"3";"701";"704"
"8";"Barcelona";"1";"Barcelona";"13";"Barcelonès";"08019";"Barcelona";"2";"64";"U";"951";"367";"635";"776";"175";"0";"5";"771";"776"
"8";"Barcelona";"1";"Barcelona";"13";"Barcelonès";"08019";"Barcelona";"2";"65";"A";"642";"239";"411";"511";"131";"0";"5";"506";"511"
"8";"Barcelona";"1";"Barcelona";"13";"Barcelonès";"08019";"Barcelona";"2";"65";"B";"598";"211";"400";"484";"114";"2";"0";"482";"482"
"8";"Barcelona";"1";"Barcelona";"13";"Barcelonès";"08019";"Barcelona";"2";"66";"A";"719";"218";"473";"579";"140";"1";"3";"575";"578"
"8";"Barcelona";"1";"Barcelona";"13";"Barcelonès";"08019";"Barcelona";"2";"66";"B";"637";"216";"413";"512";"125";"0";"1";"511";"512"
"8";"Barcelona";"1";"Barcelona";"13";"Barcelonès";"08019";"Barcelona";"2";"67";"U";"1099";"360";"678";"865";"234";"0";"7";"858";"865"
"8";"Barcelona";"1";"Barcelona";"13";"Barcelonès";"08019";"Barcelona";"2";"68";"U";"1138";"355";"751";"915";"223";"0";"12";"903";"915"
"8";"Barcelona";"1";"Barcelona";"13";"Barcelonès";"08019";"Barcelona";"2";"69";"U";"956";"359";"667";"816";"140";"5";"6";"805";"811"
"8";"Barcelona";"1";"Barcelona";"13";"Barcelonès";"08019";"Barcelona";"2";"7";"U";"914";"306";"621";"746";"168";"1";"1";"744";"745"
"8";"Barcelona";"1";"Barcelona";"13";"Barcelonès";"08019";"Barcelona";"2";"70";"U";"904";"336";"618";"727";"177";"0";"1";"726";"727"
"8";"Barcelona";"1";"Barcelona";"13";"Barcelonès";"08019";"Barcelona";"2";"71";"A";"571";"204";"410";"495";"76";"0";"4";"491";"495"
"8";"Barcelona";"1";"Barcelona";"13";"Barcelonès";"08019";"Barcelona";"2";"71";"B";"638";"220";"424";"544";"94";"1";"2";"541";"543"
"8";"Barcelona";"1";"Barcelona";"13";"Barcelonès";"08019";"Barcelona";"2";"72";"U";"835";"223";"490";"668";"167";"1";"1";"666";"667"
"8";"Barcelona";"1";"Barcelona";"13";"Barcelonès";"08019";"Barcelona";"2";"73";"U";"1106";"296";"699";"869";"237";"1";"6";"862";"868"
"8";"Barcelona";"1";"Barcelona";"13";"Barcelonès";"08019";"Barcelona";"2";"74";"U";"742";"214";"466";"585";"157";"2";"2";"581";"583"
"8";"Barcelona";"1";"Barcelona";"13";"Barcelonès";"08019";"Barcelona";"2";"75";"U";"774";"250";"497";"629";"145";"2";"2";"625";"627"
"8";"Barcelona";"1";"Barcelona";"13";"Barcelonès";"08019";"Barcelona";"2";"76";"U";"1085";"257";"690";"899";"186";"0";"3";"896";"899"
"8";"Barcelona";"1";"Barcelona";"13";"Barcelonès";"08019";"Barcelona";"2";"77";"U";"940";"211";"522";"700";"240";"1";"2";"697";"699"
"8";"Barcelona";"1";"Barcelona";"13";"Barcelonès";"08019";"Barcelona";"2";"78";"U";"880";"260";"521";"687";"193";"1";"4";"682";"686"
"8";"Barcelona";"1";"Barcelona";"13";"Barcelonès";"08019";"Barcelona";"2";"79";"U";"836";"253";"500";"647";"189";"0";"2";"645";"647"
"8";"Barcelona";"1";"Barcelona";"13";"Barcelonès";"08019";"Barcelona";"2";"8";"A";"679";"262";"458";"566";"113";"2";"5";"559";"564"
"8";"Barcelona";"1";"Barcelona";"13";"Barcelonès";"08019";"Barcelona";"2";"8";"B";"624";"207";"424";"523";"101";"0";"3";"520";"523"
"8";"Barcelona";"1";"Barcelona";"13";"Barcelonès";"08019";"Barcelona";"2";"80";"U";"1018";"273";"659";"808";"210";"2";"3";"803";"806"
"8";"Barcelona";"1";"Barcelona";"13";"Barcelonès";"08019";"Barcelona";"2";"81";"A";"760";"260";"513";"623";"137";"3";"5";"615";"620"
"8";"Barcelona";"1";"Barcelona";"13";"Barcelonès";"08019";"Barcelona";"2";"81";"B";"675";"195";"453";"560";"115";"1";"1";"558";"559"
"8";"Barcelona";"1";"Barcelona";"13";"Barcelonès";"08019";"Barcelona";"2";"82";"U";"642";"209";"395";"507";"135";"0";"0";"507";"507"
"8";"Barcelona";"1";"Barcelona";"13";"Barcelonès";"08019";"Barcelona";"2";"83";"A";"557";"202";"368";"458";"99";"2";"2";"454";"456"
"8";"Barcelona";"1";"Barcelona";"13";"Barcelonès";"08019";"Barcelona";"2";"83";"B";"578";"217";"363";"466";"112";"2";"0";"464";"464"
"8";"Barcelona";"1";"Barcelona";"13";"Barcelonès";"08019";"Barcelona";"2";"84";"A";"740";"319";"535";"566";"174";"0";"2";"564";"566"
"8";"Barcelona";"1";"Barcelona";"13";"Barcelonès";"08019";"Barcelona";"2";"84";"B";"654";"205";"413";"513";"141";"1";"5";"507";"512"
"8";"Barcelona";"1";"Barcelona";"13";"Barcelonès";"08019";"Barcelona";"2";"85";"U";"955";"302";"595";"754";"201";"0";"2";"752";"754"
"8";"Barcelona";"1";"Barcelona";"13";"Barcelonès";"08019";"Barcelona";"2";"86";"U";"957";"315";"647";"781";"176";"2";"8";"771";"779"
"8";"Barcelona";"1";"Barcelona";"13";"Barcelonès";"08019";"Barcelona";"2";"87";"U";"997";"313";"690";"801";"196";"2";"7";"792";"799"
"8";"Barcelona";"1";"Barcelona";"13";"Barcelonès";"08019";"Barcelona";"2";"88";"U";"1148";"371";"639";"916";"232";"4";"4";"908";"912"
"8";"Barcelona";"1";"Barcelona";"13";"Barcelonès";"08019";"Barcelona";"2";"89";"A";"646";"223";"396";"513";"133";"1";"2";"510";"512"
"8";"Barcelona";"1";"Barcelona";"13";"Barcelonès";"08019";"Barcelona";"2";"89";"B";"643";"192";"399";"478";"165";"5";"0";"473";"473"
"8";"Barcelona";"1";"Barcelona";"13";"Barcelonès";"08019";"Barcelona";"2";"9";"A";"632";"223";"425";"522";"110";"0";"1";"521";"522"
"8";"Barcelona";"1";"Barcelona";"13";"Barcelonès";"08019";"Barcelona";"2";"9";"B";"577";"221";"407";"475";"102";"1";"1";"473";"474"
"8";"Barcelona";"1";"Barcelona";"13";"Barcelonès";"08019";"Barcelona";"2";"90";"U";"1105";"292";"653";"824";"281";"3";"4";"817";"821"
"8";"Barcelona";"1";"Barcelona";"13";"Barcelonès";"08019";"Barcelona";"2";"91";"U";"1196";"392";"748";"942";"254";"2";"5";"935";"940"
"8";"Barcelona";"1";"Barcelona";"13";"Barcelonès";"08019";"Barcelona";"2";"92";"U";"1166";"336";"725";"883";"283";"1";"6";"876";"882"
"8";"Barcelona";"1";"Barcelona";"13";"Barcelonès";"08019";"Barcelona";"2";"93";"U";"1122";"336";"688";"888";"234";"3";"4";"881";"885"
"8";"Barcelona";"1";"Barcelona";"13";"Barcelonès";"08019";"Barcelona";"2";"94";"U";"1047";"270";"664";"843";"204";"2";"2";"839";"841"
"8";"Barcelona";"1";"Barcelona";"13";"Barcelonès";"08019";"Barcelona";"2";"95";"U";"1051";"361";"686";"835";"216";"3";"2";"830";"832"
"8";"Barcelona";"1";"Barcelona";"13";"Barcelonès";"08019";"Barcelona";"2";"96";"U";"990";"314";"611";"735";"255";"2";"5";"728";"733"
"8";"Barcelona";"1";"Barcelona";"13";"Barcelonès";"08019";"Barcelona";"2";"97";"U";"728";"212";"463";"571";"157";"1";"1";"569";"570"
"8";"Barcelona";"1";"Barcelona";"13";"Barcelonès";"08019";"Barcelona";"2";"98";"U";"1058";"307";"751";"796";"262";"4";"6";"786";"792"
"8";"Barcelona";"1";"Barcelona";"13";"Barcelonès";"08019";"Barcelona";"2";"99";"U";"1062";"309";"661";"817";"245";"2";"2";"813";"815"
"8";"Barcelona";"1";"Barcelona";"13";"Barcelonès";"08019";"Barcelona";"3";"1";"U";"1193";"370";"740";"859";"334";"2";"1";"856";"857"
"8";"Barcelona";"1";"Barcelona";"13";"Barcelonès";"08019";"Barcelona";"3";"10";"U";"1085";"287";"590";"694";"391";"1";"2";"691";"693"
"8";"Barcelona";"1";"Barcelona";"13";"Barcelonès";"08019";"Barcelona";"3";"100";"U";"876";"342";"575";"671";"205";"2";"1";"668";"669"
"8";"Barcelona";"1";"Barcelona";"13";"Barcelonès";"08019";"Barcelona";"3";"101";"U";"1219";"350";"664";"802";"417";"3";"1";"798";"799"
"8";"Barcelona";"1";"Barcelona";"13";"Barcelonès";"08019";"Barcelona";"3";"102";"U";"930";"309";"598";"746";"184";"3";"0";"743";"743"
"8";"Barcelona";"1";"Barcelona";"13";"Barcelonès";"08019";"Barcelona";"3";"103";"U";"969";"357";"667";"770";"199";"1";"5";"764";"769"
"8";"Barcelona";"1";"Barcelona";"13";"Barcelonès";"08019";"Barcelona";"3";"104";"U";"933";"329";"572";"699";"234";"0";"3";"696";"699"
"8";"Barcelona";"1";"Barcelona";"13";"Barcelonès";"08019";"Barcelona";"3";"105";"U";"803";"272";"491";"583";"220";"0";"4";"579";"583"
"8";"Barcelona";"1";"Barcelona";"13";"Barcelonès";"08019";"Barcelona";"3";"106";"U";"870";"269";"496";"637";"233";"0";"8";"629";"637"
"8";"Barcelona";"1";"Barcelona";"13";"Barcelonès";"08019";"Barcelona";"3";"107";"U";"1124";"307";"675";"909";"215";"0";"0";"909";"909"
"8";"Barcelona";"1";"Barcelona";"13";"Barcelonès";"08019";"Barcelona";"3";"108";"U";"1074";"337";"690";"829";"245";"2";"3";"824";"827"
"8";"Barcelona";"1";"Barcelona";"13";"Barcelonès";"08019";"Barcelona";"3";"109";"U";"1073";"310";"700";"842";"231";"5";"5";"832";"837"
"8";"Barcelona";"1";"Barcelona";"13";"Barcelonès";"08019";"Barcelona";"3";"11";"U";"953";"259";"522";"635";"318";"5";"0";"630";"630"
"8";"Barcelona";"1";"Barcelona";"13";"Barcelonès";"08019";"Barcelona";"3";"110";"U";"1102";"354";"695";"839";"263";"0";"3";"836";"839"
"8";"Barcelona";"1";"Barcelona";"13";"Barcelonès";"08019";"Barcelona";"3";"111";"U";"933";"304";"598";"719";"214";"3";"5";"711";"716"
"8";"Barcelona";"1";"Barcelona";"13";"Barcelonès";"08019";"Barcelona";"3";"112";"A";"741";"250";"489";"594";"147";"0";"5";"589";"594"
"8";"Barcelona";"1";"Barcelona";"13";"Barcelonès";"08019";"Barcelona";"3";"112";"B";"710";"244";"476";"586";"124";"0";"4";"582";"586"
"8";"Barcelona";"1";"Barcelona";"13";"Barcelonès";"08019";"Barcelona";"3";"113";"A";"675";"243";"434";"545";"130";"3";"5";"537";"542"
"8";"Barcelona";"1";"Barcelona";"13";"Barcelonès";"08019";"Barcelona";"3";"113";"B";"559";"199";"365";"462";"97";"0";"4";"458";"462"
"8";"Barcelona";"1";"Barcelona";"13";"Barcelonès";"08019";"Barcelona";"3";"114";"U";"1133";"345";"744";"926";"207";"2";"2";"922";"924"
"8";"Barcelona";"1";"Barcelona";"13";"Barcelonès";"08019";"Barcelona";"3";"12";"A";"667";"178";"353";"448";"219";"3";"6";"439";"445"
"8";"Barcelona";"1";"Barcelona";"13";"Barcelonès";"08019";"Barcelona";"3";"12";"B";"624";"165";"336";"413";"211";"3";"2";"408";"410"
"8";"Barcelona";"1";"Barcelona";"13";"Barcelonès";"08019";"Barcelona";"3";"13";"U";"1030";"245";"521";"654";"376";"5";"1";"648";"649"
"8";"Barcelona";"1";"Barcelona";"13";"Barcelonès";"08019";"Barcelona";"3";"14";"U";"1028";"266";"527";"650";"378";"2";"2";"646";"648"
"8";"Barcelona";"1";"Barcelona";"13";"Barcelonès";"08019";"Barcelona";"3";"15";"A";"871";"267";"506";"605";"266";"3";"8";"594";"602"
"8";"Barcelona";"1";"Barcelona";"13";"Barcelonès";"08019";"Barcelona";"3";"15";"B";"840";"220";"440";"537";"303";"8";"4";"525";"529"
"8";"Barcelona";"1";"Barcelona";"13";"Barcelonès";"08019";"Barcelona";"3";"16";"U";"633";"218";"358";"427";"206";"0";"1";"426";"427"
"8";"Barcelona";"1";"Barcelona";"13";"Barcelonès";"08019";"Barcelona";"3";"17";"U";"912";"230";"423";"547";"365";"7";"2";"538";"540"
"8";"Barcelona";"1";"Barcelona";"13";"Barcelonès";"08019";"Barcelona";"3";"18";"U";"1061";"332";"567";"703";"358";"1";"4";"698";"702"
"8";"Barcelona";"1";"Barcelona";"13";"Barcelonès";"08019";"Barcelona";"3";"19";"U";"870";"272";"449";"568";"302";"4";"3";"561";"564"
"8";"Barcelona";"1";"Barcelona";"13";"Barcelonès";"08019";"Barcelona";"3";"2";"A";"647";"222";"387";"466";"181";"0";"3";"463";"466"
"8";"Barcelona";"1";"Barcelona";"13";"Barcelonès";"08019";"Barcelona";"3";"2";"B";"621";"184";"350";"433";"188";"0";"4";"429";"433"
"8";"Barcelona";"1";"Barcelona";"13";"Barcelonès";"08019";"Barcelona";"3";"20";"U";"897";"322";"558";"667";"230";"1";"1";"665";"666"
"8";"Barcelona";"1";"Barcelona";"13";"Barcelonès";"08019";"Barcelona";"3";"21";"U";"879";"260";"492";"612";"267";"4";"5";"603";"608"
"8";"Barcelona";"1";"Barcelona";"13";"Barcelonès";"08019";"Barcelona";"3";"211";"U";"1086";"309";"657";"815";"271";"0";"4";"811";"815"
"8";"Barcelona";"1";"Barcelona";"13";"Barcelonès";"08019";"Barcelona";"3";"212";"A";"952";"299";"580";"703";"249";"1";"4";"698";"702"
"8";"Barcelona";"1";"Barcelona";"13";"Barcelonès";"08019";"Barcelona";"3";"212";"B";"828";"287";"506";"612";"216";"1";"1";"610";"611"
"8";"Barcelona";"1";"Barcelona";"13";"Barcelonès";"08019";"Barcelona";"3";"213";"A";"832";"240";"427";"544";"288";"2";"3";"539";"542"
"8";"Barcelona";"1";"Barcelona";"13";"Barcelonès";"08019";"Barcelona";"3";"213";"B";"704";"193";"372";"477";"227";"5";"3";"469";"472"
"8";"Barcelona";"1";"Barcelona";"13";"Barcelonès";"08019";"Barcelona";"3";"22";"U";"923";"276";"457";"650";"273";"2";"11";"637";"648"
"8";"Barcelona";"1";"Barcelona";"13";"Barcelonès";"08019";"Barcelona";"3";"23";"U";"1169";"328";"623";"764";"405";"1";"0";"763";"763"
"8";"Barcelona";"1";"Barcelona";"13";"Barcelonès";"08019";"Barcelona";"3";"24";"U";"1186";"333";"647";"810";"376";"3";"7";"800";"807"
"8";"Barcelona";"1";"Barcelona";"13";"Barcelonès";"08019";"Barcelona";"3";"25";"U";"873";"193";"383";"478";"395";"0";"1";"477";"478"
"8";"Barcelona";"1";"Barcelona";"13";"Barcelonès";"08019";"Barcelona";"3";"26";"U";"810";"314";"511";"613";"197";"0";"1";"612";"613"
"8";"Barcelona";"1";"Barcelona";"13";"Barcelonès";"08019";"Barcelona";"3";"27";"A";"704";"270";"421";"520";"184";"3";"6";"511";"517"
"8";"Barcelona";"1";"Barcelona";"13";"Barcelonès";"08019";"Barcelona";"3";"27";"B";"617";"199";"378";"480";"137";"1";"4";"475";"479"
"8";"Barcelona";"1";"Barcelona";"13";"Barcelonès";"08019";"Barcelona";"3";"28";"A";"831";"272";"554";"678";"153";"1";"1";"676";"677"
"8";"Barcelona";"1";"Barcelona";"13";"Barcelonès";"08019";"Barcelona";"3";"28";"B";"671";"224";"422";"547";"124";"3";"6";"538";"544"
"8";"Barcelona";"1";"Barcelona";"13";"Barcelonès";"08019";"Barcelona";"3";"29";"U";"986";"307";"559";"698";"288";"5";"3";"690";"693"
"8";"Barcelona";"1";"Barcelona";"13";"Barcelonès";"08019";"Barcelona";"3";"3";"U";"962";"285";"520";"640";"322";"4";"5";"631";"636"
"8";"Barcelona";"1";"Barcelona";"13";"Barcelonès";"08019";"Barcelona";"3";"30";"U";"1195";"338";"722";"901";"294";"1";"1";"899";"900"
"8";"Barcelona";"1";"Barcelona";"13";"Barcelonès";"08019";"Barcelona";"3";"31";"A";"1000";"320";"561";"705";"295";"5";"5";"695";"700"
"8";"Barcelona";"1";"Barcelona";"13";"Barcelonès";"08019";"Barcelona";"3";"31";"B";"885";"254";"527";"664";"221";"5";"6";"653";"659"
"8";"Barcelona";"1";"Barcelona";"13";"Barcelonès";"08019";"Barcelona";"3";"32";"U";"1076";"305";"562";"688";"388";"2";"4";"682";"686"
"8";"Barcelona";"1";"Barcelona";"13";"Barcelonès";"08019";"Barcelona";"3";"33";"U";"906";"271";"455";"557";"349";"1";"1";"555";"556"
"8";"Barcelona";"1";"Barcelona";"13";"Barcelonès";"08019";"Barcelona";"3";"34";"U";"1175";"357";"689";"856";"319";"3";"6";"847";"853"
"8";"Barcelona";"1";"Barcelona";"13";"Barcelonès";"08019";"Barcelona";"3";"35";"A";"964";"293";"609";"750";"214";"2";"4";"744";"748"
"8";"Barcelona";"1";"Barcelona";"13";"Barcelonès";"08019";"Barcelona";"3";"35";"B";"809";"274";"489";"633";"176";"0";"2";"631";"633"
"8";"Barcelona";"1";"Barcelona";"13";"Barcelonès";"08019";"Barcelona";"3";"36";"A";"913";"304";"559";"720";"193";"3";"5";"712";"717"
"8";"Barcelona";"1";"Barcelona";"13";"Barcelonès";"08019";"Barcelona";"3";"36";"B";"815";"255";"476";"639";"176";"0";"1";"638";"639"
"8";"Barcelona";"1";"Barcelona";"13";"Barcelonès";"08019";"Barcelona";"3";"37";"U";"859";"291";"529";"670";"189";"1";"1";"668";"669"
"8";"Barcelona";"1";"Barcelona";"13";"Barcelonès";"08019";"Barcelona";"3";"38";"U";"815";"238";"414";"513";"302";"0";"0";"513";"513"
"8";"Barcelona";"1";"Barcelona";"13";"Barcelonès";"08019";"Barcelona";"3";"39";"A";"838";"257";"444";"532";"306";"3";"0";"529";"529"
"8";"Barcelona";"1";"Barcelona";"13";"Barcelonès";"08019";"Barcelona";"3";"39";"B";"725";"203";"384";"472";"253";"4";"4";"464";"468"
"8";"Barcelona";"1";"Barcelona";"13";"Barcelonès";"08019";"Barcelona";"3";"4";"U";"1066";"342";"675";"801";"265";"1";"3";"797";"800"
"8";"Barcelona";"1";"Barcelona";"13";"Barcelonès";"08019";"Barcelona";"3";"40";"A";"659";"201";"382";"494";"165";"0";"3";"491";"494"
"8";"Barcelona";"1";"Barcelona";"13";"Barcelonès";"08019";"Barcelona";"3";"40";"B";"557";"194";"341";"407";"150";"2";"2";"403";"405"
"8";"Barcelona";"1";"Barcelona";"13";"Barcelonès";"08019";"Barcelona";"3";"41";"U";"951";"273";"555";"688";"263";"3";"6";"679";"685"
"8";"Barcelona";"1";"Barcelona";"13";"Barcelonès";"08019";"Barcelona";"3";"42";"U";"931";"302";"592";"700";"231";"2";"1";"697";"698"
"8";"Barcelona";"1";"Barcelona";"13";"Barcelonès";"08019";"Barcelona";"3";"43";"U";"1144";"306";"682";"819";"325";"0";"6";"813";"819"
"8";"Barcelona";"1";"Barcelona";"13";"Barcelonès";"08019";"Barcelona";"3";"44";"A";"622";"184";"371";"451";"171";"0";"3";"448";"451"
"8";"Barcelona";"1";"Barcelona";"13";"Barcelonès";"08019";"Barcelona";"3";"44";"B";"609";"195";"361";"440";"169";"2";"3";"435";"438"
"8";"Barcelona";"1";"Barcelona";"13";"Barcelonès";"08019";"Barcelona";"3";"45";"U";"745";"274";"461";"549";"196";"3";"3";"543";"546"
"8";"Barcelona";"1";"Barcelona";"13";"Barcelonès";"08019";"Barcelona";"3";"46";"U";"1126";"391";"753";"920";"206";"1";"5";"914";"919"
"8";"Barcelona";"1";"Barcelona";"13";"Barcelonès";"08019";"Barcelona";"3";"47";"A";"648";"237";"379";"466";"182";"6";"2";"458";"460"
"8";"Barcelona";"1";"Barcelona";"13";"Barcelonès";"08019";"Barcelona";"3";"47";"B";"600";"253";"374";"447";"153";"4";"1";"442";"443"
"8";"Barcelona";"1";"Barcelona";"13";"Barcelonès";"08019";"Barcelona";"3";"48";"U";"1012";"332";"659";"818";"194";"4";"3";"811";"814"
"8";"Barcelona";"1";"Barcelona";"13";"Barcelonès";"08019";"Barcelona";"3";"49";"U";"1165";"341";"733";"896";"269";"5";"4";"887";"891"
"8";"Barcelona";"1";"Barcelona";"13";"Barcelonès";"08019";"Barcelona";"3";"5";"U";"848";"246";"480";"602";"246";"4";"7";"591";"598"
"8";"Barcelona";"1";"Barcelona";"13";"Barcelonès";"08019";"Barcelona";"3";"50";"U";"1129";"433";"731";"854";"275";"3";"5";"846";"851"
"8";"Barcelona";"1";"Barcelona";"13";"Barcelonès";"08019";"Barcelona";"3";"51";"U";"1150";"333";"618";"762";"388";"1";"3";"758";"761"
"8";"Barcelona";"1";"Barcelona";"13";"Barcelonès";"08019";"Barcelona";"3";"52";"U";"830";"237";"462";"568";"262";"0";"3";"565";"568"
"8";"Barcelona";"1";"Barcelona";"13";"Barcelonès";"08019";"Barcelona";"3";"53";"A";"725";"229";"394";"505";"220";"0";"4";"501";"505"
"8";"Barcelona";"1";"Barcelona";"13";"Barcelonès";"08019";"Barcelona";"3";"53";"B";"627";"195";"348";"432";"195";"2";"2";"428";"430"
"8";"Barcelona";"1";"Barcelona";"13";"Barcelonès";"08019";"Barcelona";"3";"54";"A";"724";"236";"468";"573";"151";"1";"1";"571";"572"
"8";"Barcelona";"1";"Barcelona";"13";"Barcelonès";"08019";"Barcelona";"3";"54";"B";"569";"201";"377";"460";"109";"2";"5";"453";"458"
"8";"Barcelona";"1";"Barcelona";"13";"Barcelonès";"08019";"Barcelona";"3";"55";"U";"1136";"383";"742";"878";"258";"2";"4";"872";"876"
"8";"Barcelona";"1";"Barcelona";"13";"Barcelonès";"08019";"Barcelona";"3";"56";"U";"635";"272";"427";"509";"126";"2";"0";"507";"507"
"8";"Barcelona";"1";"Barcelona";"13";"Barcelonès";"08019";"Barcelona";"3";"57";"U";"1177";"370";"773";"910";"267";"3";"1";"906";"907"
"8";"Barcelona";"1";"Barcelona";"13";"Barcelonès";"08019";"Barcelona";"3";"58";"U";"1031";"324";"625";"773";"258";"1";"4";"768";"772"
"8";"Barcelona";"1";"Barcelona";"13";"Barcelonès";"08019";"Barcelona";"3";"59";"U";"904";"248";"575";"681";"223";"3";"0";"678";"678"
"8";"Barcelona";"1";"Barcelona";"13";"Barcelonès";"08019";"Barcelona";"3";"6";"U";"845";"293";"491";"601";"244";"1";"2";"598";"600"
"8";"Barcelona";"1";"Barcelona";"13";"Barcelonès";"08019";"Barcelona";"3";"60";"U";"1059";"292";"699";"862";"197";"2";"1";"859";"860"
"8";"Barcelona";"1";"Barcelona";"13";"Barcelonès";"08019";"Barcelona";"3";"61";"U";"831";"338";"546";"631";"200";"1";"2";"628";"630"
"8";"Barcelona";"1";"Barcelona";"13";"Barcelonès";"08019";"Barcelona";"3";"62";"A";"640";"208";"406";"491";"149";"1";"2";"488";"490"
"8";"Barcelona";"1";"Barcelona";"13";"Barcelonès";"08019";"Barcelona";"3";"62";"B";"585";"211";"371";"455";"130";"4";"2";"449";"451"
"8";"Barcelona";"1";"Barcelona";"13";"Barcelonès";"08019";"Barcelona";"3";"63";"U";"858";"304";"548";"650";"208";"2";"1";"647";"648"
"8";"Barcelona";"1";"Barcelona";"13";"Barcelonès";"08019";"Barcelona";"3";"64";"U";"979";"302";"591";"764";"215";"1";"3";"760";"763"
"8";"Barcelona";"1";"Barcelona";"13";"Barcelonès";"08019";"Barcelona";"3";"65";"U";"1140";"317";"696";"899";"241";"1";"3";"895";"898"
"8";"Barcelona";"1";"Barcelona";"13";"Barcelonès";"08019";"Barcelona";"3";"66";"A";"859";"261";"558";"688";"171";"3";"3";"682";"685"
"8";"Barcelona";"1";"Barcelona";"13";"Barcelonès";"08019";"Barcelona";"3";"66";"B";"838";"237";"511";"652";"186";"2";"4";"646";"650"
"8";"Barcelona";"1";"Barcelona";"13";"Barcelonès";"08019";"Barcelona";"3";"67";"A";"673";"237";"462";"529";"144";"1";"4";"524";"528"
"8";"Barcelona";"1";"Barcelona";"13";"Barcelonès";"08019";"Barcelona";"3";"67";"B";"584";"186";"366";"455";"129";"1";"0";"454";"454"
"8";"Barcelona";"1";"Barcelona";"13";"Barcelonès";"08019";"Barcelona";"3";"68";"U";"904";"279";"585";"680";"224";"2";"3";"675";"678"
"8";"Barcelona";"1";"Barcelona";"13";"Barcelonès";"08019";"Barcelona";"3";"69";"U";"921";"272";"592";"720";"201";"3";"2";"715";"717"
"8";"Barcelona";"1";"Barcelona";"13";"Barcelonès";"08019";"Barcelona";"3";"7";"U";"1073";"367";"617";"745";"328";"4";"2";"739";"741"
"8";"Barcelona";"1";"Barcelona";"13";"Barcelonès";"08019";"Barcelona";"3";"70";"U";"951";"252";"574";"727";"224";"2";"2";"723";"725"
"8";"Barcelona";"1";"Barcelona";"13";"Barcelonès";"08019";"Barcelona";"3";"71";"U";"906";"301";"541";"653";"253";"0";"1";"652";"653"
"8";"Barcelona";"1";"Barcelona";"13";"Barcelonès";"08019";"Barcelona";"3";"72";"U";"998";"307";"589";"741";"257";"3";"0";"738";"738"
"8";"Barcelona";"1";"Barcelona";"13";"Barcelonès";"08019";"Barcelona";"3";"73";"U";"1181";"358";"729";"910";"271";"1";"4";"905";"909"
"8";"Barcelona";"1";"Barcelona";"13";"Barcelonès";"08019";"Barcelona";"3";"74";"A";"666";"205";"413";"494";"172";"2";"2";"490";"492"
"8";"Barcelona";"1";"Barcelona";"13";"Barcelonès";"08019";"Barcelona";"3";"74";"B";"639";"200";"391";"488";"151";"1";"7";"480";"487"
"8";"Barcelona";"1";"Barcelona";"13";"Barcelonès";"08019";"Barcelona";"3";"75";"A";"629";"310";"388";"476";"153";"2";"1";"473";"474"
"8";"Barcelona";"1";"Barcelona";"13";"Barcelonès";"08019";"Barcelona";"3";"75";"B";"572";"176";"349";"433";"139";"0";"0";"433";"433"
"8";"Barcelona";"1";"Barcelona";"13";"Barcelonès";"08019";"Barcelona";"3";"76";"U";"784";"261";"472";"590";"194";"3";"2";"585";"587"
"8";"Barcelona";"1";"Barcelona";"13";"Barcelonès";"08019";"Barcelona";"3";"77";"U";"977";"288";"596";"732";"245";"1";"0";"731";"731"
"8";"Barcelona";"1";"Barcelona";"13";"Barcelonès";"08019";"Barcelona";"3";"78";"U";"1184";"305";"732";"905";"279";"3";"1";"901";"902"
"8";"Barcelona";"1";"Barcelona";"13";"Barcelonès";"08019";"Barcelona";"3";"79";"A";"658";"210";"393";"472";"186";"0";"0";"472";"472"
"8";"Barcelona";"1";"Barcelona";"13";"Barcelonès";"08019";"Barcelona";"3";"79";"B";"549";"182";"312";"383";"166";"3";"4";"376";"380"
"8";"Barcelona";"1";"Barcelona";"13";"Barcelonès";"08019";"Barcelona";"3";"8";"U";"751";"237";"416";"500";"251";"1";"4";"495";"499"
"8";"Barcelona";"1";"Barcelona";"13";"Barcelonès";"08019";"Barcelona";"3";"80";"U";"1138";"411";"697";"876";"262";"2";"3";"871";"874"
"8";"Barcelona";"1";"Barcelona";"13";"Barcelonès";"08019";"Barcelona";"3";"81";"A";"722";"229";"436";"542";"180";"1";"3";"538";"541"
"8";"Barcelona";"1";"Barcelona";"13";"Barcelonès";"08019";"Barcelona";"3";"81";"B";"666";"231";"437";"532";"134";"3";"2";"527";"529"
"8";"Barcelona";"1";"Barcelona";"13";"Barcelonès";"08019";"Barcelona";"3";"82";"A";"709";"269";"471";"571";"138";"4";"3";"564";"567"
"8";"Barcelona";"1";"Barcelona";"13";"Barcelonès";"08019";"Barcelona";"3";"82";"B";"636";"222";"395";"510";"126";"2";"7";"501";"508"
"8";"Barcelona";"1";"Barcelona";"13";"Barcelonès";"08019";"Barcelona";"3";"83";"U";"1105";"350";"695";"890";"215";"1";"2";"887";"889"
"8";"Barcelona";"1";"Barcelona";"13";"Barcelonès";"08019";"Barcelona";"3";"84";"U";"1107";"346";"720";"901";"206";"1";"3";"897";"900"
"8";"Barcelona";"1";"Barcelona";"13";"Barcelonès";"08019";"Barcelona";"3";"85";"U";"899";"314";"556";"672";"227";"2";"1";"669";"670"
"8";"Barcelona";"1";"Barcelona";"13";"Barcelonès";"08019";"Barcelona";"3";"86";"U";"1044";"397";"701";"888";"156";"3";"3";"882";"885"
"8";"Barcelona";"1";"Barcelona";"13";"Barcelonès";"08019";"Barcelona";"3";"87";"U";"1114";"367";"740";"922";"192";"1";"7";"914";"921"
"8";"Barcelona";"1";"Barcelona";"13";"Barcelonès";"08019";"Barcelona";"3";"88";"U";"1087";"363";"751";"890";"197";"3";"5";"882";"887"
"8";"Barcelona";"1";"Barcelona";"13";"Barcelonès";"08019";"Barcelona";"3";"89";"U";"979";"340";"688";"819";"160";"1";"4";"814";"818"
"8";"Barcelona";"1";"Barcelona";"13";"Barcelonès";"08019";"Barcelona";"3";"9";"U";"828";"262";"492";"614";"214";"1";"3";"610";"613"
"8";"Barcelona";"1";"Barcelona";"13";"Barcelonès";"08019";"Barcelona";"3";"90";"U";"822";"319";"553";"669";"153";"5";"3";"661";"664"
"8";"Barcelona";"1";"Barcelona";"13";"Barcelonès";"08019";"Barcelona";"3";"91";"U";"1030";"363";"679";"836";"194";"2";"6";"828";"834"
"8";"Barcelona";"1";"Barcelona";"13";"Barcelonès";"08019";"Barcelona";"3";"92";"U";"893";"282";"537";"684";"209";"1";"6";"677";"683"
"8";"Barcelona";"1";"Barcelona";"13";"Barcelonès";"08019";"Barcelona";"3";"93";"A";"643";"233";"440";"523";"120";"0";"3";"520";"523"
"8";"Barcelona";"1";"Barcelona";"13";"Barcelonès";"08019";"Barcelona";"3";"93";"B";"558";"196";"320";"446";"112";"0";"4";"442";"446"
"8";"Barcelona";"1";"Barcelona";"13";"Barcelonès";"08019";"Barcelona";"3";"94";"U";"919";"278";"589";"718";"201";"1";"3";"714";"717"
"8";"Barcelona";"1";"Barcelona";"13";"Barcelonès";"08019";"Barcelona";"3";"95";"U";"1167";"352";"758";"933";"234";"8";"2";"923";"925"
"8";"Barcelona";"1";"Barcelona";"13";"Barcelonès";"08019";"Barcelona";"3";"96";"U";"982";"300";"611";"750";"232";"4";"1";"745";"746"
"8";"Barcelona";"1";"Barcelona";"13";"Barcelonès";"08019";"Barcelona";"3";"97";"U";"965";"257";"509";"624";"341";"8";"2";"614";"616"
"8";"Barcelona";"1";"Barcelona";"13";"Barcelonès";"08019";"Barcelona";"3";"98";"U";"908";"275";"536";"641";"267";"2";"4";"635";"639"
"8";"Barcelona";"1";"Barcelona";"13";"Barcelonès";"08019";"Barcelona";"3";"99";"U";"734";"280";"452";"559";"175";"0";"2";"557";"559"
"8";"Barcelona";"1";"Barcelona";"13";"Barcelonès";"08019";"Barcelona";"4";"1";"U";"870";"268";"546";"715";"155";"0";"2";"713";"715"
"8";"Barcelona";"1";"Barcelona";"13";"Barcelonès";"08019";"Barcelona";"4";"10";"U";"714";"274";"496";"609";"105";"0";"5";"604";"609"
"8";"Barcelona";"1";"Barcelona";"13";"Barcelonès";"08019";"Barcelona";"4";"11";"A";"664";"245";"455";"567";"97";"0";"4";"563";"567"
"8";"Barcelona";"1";"Barcelona";"13";"Barcelonès";"08019";"Barcelona";"4";"11";"B";"643";"268";"467";"569";"74";"2";"3";"564";"567"
"8";"Barcelona";"1";"Barcelona";"13";"Barcelonès";"08019";"Barcelona";"4";"12";"A";"587";"226";"384";"497";"90";"3";"3";"491";"494"
"8";"Barcelona";"1";"Barcelona";"13";"Barcelonès";"08019";"Barcelona";"4";"12";"B";"585";"197";"373";"483";"102";"0";"3";"480";"483"
"8";"Barcelona";"1";"Barcelona";"13";"Barcelonès";"08019";"Barcelona";"4";"13";"U";"1004";"351";"651";"852";"152";"1";"3";"848";"851"
"8";"Barcelona";"1";"Barcelona";"13";"Barcelonès";"08019";"Barcelona";"4";"14";"U";"627";"217";"394";"480";"147";"1";"2";"477";"479"
"8";"Barcelona";"1";"Barcelona";"13";"Barcelonès";"08019";"Barcelona";"4";"15";"A";"782";"225";"520";"661";"121";"1";"2";"658";"660"
"8";"Barcelona";"1";"Barcelona";"13";"Barcelonès";"08019";"Barcelona";"4";"15";"B";"727";"208";"472";"609";"118";"0";"4";"605";"609"
"8";"Barcelona";"1";"Barcelona";"13";"Barcelonès";"08019";"Barcelona";"4";"16";"U";"894";"270";"597";"761";"133";"2";"2";"757";"759"
"8";"Barcelona";"1";"Barcelona";"13";"Barcelonès";"08019";"Barcelona";"4";"17";"U";"884";"300";"607";"737";"147";"3";"4";"730";"734"
"8";"Barcelona";"1";"Barcelona";"13";"Barcelonès";"08019";"Barcelona";"4";"18";"U";"1164";"335";"777";"941";"223";"2";"5";"934";"939"
"8";"Barcelona";"1";"Barcelona";"13";"Barcelonès";"08019";"Barcelona";"4";"19";"U";"1002";"339";"680";"834";"168";"1";"1";"832";"833"
"8";"Barcelona";"1";"Barcelona";"13";"Barcelonès";"08019";"Barcelona";"4";"2";"A";"827";"310";"582";"717";"110";"2";"2";"713";"715"
"8";"Barcelona";"1";"Barcelona";"13";"Barcelonès";"08019";"Barcelona";"4";"2";"B";"643";"233";"430";"554";"89";"2";"3";"549";"552"
"8";"Barcelona";"1";"Barcelona";"13";"Barcelonès";"08019";"Barcelona";"4";"20";"U";"1073";"372";"766";"888";"185";"0";"3";"885";"888"
"8";"Barcelona";"1";"Barcelona";"13";"Barcelonès";"08019";"Barcelona";"4";"21";"U";"956";"344";"670";"808";"148";"6";"3";"799";"802"
"8";"Barcelona";"1";"Barcelona";"13";"Barcelonès";"08019";"Barcelona";"4";"22";"A";"609";"214";"405";"493";"116";"2";"2";"489";"491"
"8";"Barcelona";"1";"Barcelona";"13";"Barcelonès";"08019";"Barcelona";"4";"22";"B";"553";"200";"387";"450";"103";"1";"2";"447";"449"
"8";"Barcelona";"1";"Barcelona";"13";"Barcelonès";"08019";"Barcelona";"4";"23";"U";"808";"252";"548";"692";"116";"0";"4";"688";"692"
"8";"Barcelona";"1";"Barcelona";"13";"Barcelonès";"08019";"Barcelona";"4";"24";"U";"826";"274";"586";"728";"98";"2";"6";"720";"726"
"8";"Barcelona";"1";"Barcelona";"13";"Barcelonès";"08019";"Barcelona";"4";"25";"U";"886";"486";"632";"738";"148";"1";"1";"736";"737"
"8";"Barcelona";"1";"Barcelona";"13";"Barcelonès";"08019";"Barcelona";"4";"26";"U";"1004";"377";"694";"852";"152";"3";"2";"847";"849"
"8";"Barcelona";"1";"Barcelona";"13";"Barcelonès";"08019";"Barcelona";"4";"27";"U";"912";"315";"611";"736";"176";"1";"8";"727";"735"
"8";"Barcelona";"1";"Barcelona";"13";"Barcelonès";"08019";"Barcelona";"4";"28";"U";"1030";"362";"706";"833";"197";"1";"5";"827";"832"
"8";"Barcelona";"1";"Barcelona";"13";"Barcelonès";"08019";"Barcelona";"4";"29";"U";"980";"284";"676";"827";"153";"1";"5";"821";"826"
"8";"Barcelona";"1";"Barcelona";"13";"Barcelonès";"08019";"Barcelona";"4";"3";"U";"845";"277";"570";"717";"128";"3";"1";"713";"714"
"8";"Barcelona";"1";"Barcelona";"13";"Barcelonès";"08019";"Barcelona";"4";"30";"A";"665";"227";"462";"574";"91";"2";"5";"567";"572"
"8";"Barcelona";"1";"Barcelona";"13";"Barcelonès";"08019";"Barcelona";"4";"30";"B";"678";"261";"486";"597";"81";"1";"6";"590";"596"
"8";"Barcelona";"1";"Barcelona";"13";"Barcelonès";"08019";"Barcelona";"4";"31";"U";"1224";"374";"722";"892";"332";"3";"12";"877";"889"
"8";"Barcelona";"1";"Barcelona";"13";"Barcelonès";"08019";"Barcelona";"4";"32";"A";"665";"245";"463";"562";"103";"0";"3";"559";"562"
"8";"Barcelona";"1";"Barcelona";"13";"Barcelonès";"08019";"Barcelona";"4";"32";"B";"589";"212";"396";"496";"93";"3";"2";"491";"493"
"8";"Barcelona";"1";"Barcelona";"13";"Barcelonès";"08019";"Barcelona";"4";"33";"U";"893";"222";"562";"721";"172";"2";"6";"713";"719"
"8";"Barcelona";"1";"Barcelona";"13";"Barcelonès";"08019";"Barcelona";"4";"34";"A";"637";"285";"449";"554";"83";"0";"2";"552";"554"
"8";"Barcelona";"1";"Barcelona";"13";"Barcelonès";"08019";"Barcelona";"4";"34";"B";"582";"209";"431";"527";"55";"5";"2";"520";"522"
"8";"Barcelona";"1";"Barcelona";"13";"Barcelonès";"08019";"Barcelona";"4";"35";"U";"1127";"329";"767";"978";"149";"3";"7";"968";"975"
"8";"Barcelona";"1";"Barcelona";"13";"Barcelonès";"08019";"Barcelona";"4";"36";"A";"637";"198";"397";"492";"145";"1";"1";"490";"491"
"8";"Barcelona";"1";"Barcelona";"13";"Barcelonès";"08019";"Barcelona";"4";"36";"B";"648";"241";"438";"522";"126";"2";"4";"516";"520"
"8";"Barcelona";"1";"Barcelona";"13";"Barcelonès";"08019";"Barcelona";"4";"37";"A";"864";"317";"612";"713";"151";"0";"4";"709";"713"
"8";"Barcelona";"1";"Barcelona";"13";"Barcelonès";"08019";"Barcelona";"4";"37";"B";"768";"289";"531";"635";"133";"2";"2";"631";"633"
"8";"Barcelona";"1";"Barcelona";"13";"Barcelonès";"08019";"Barcelona";"4";"38";"U";"1042";"350";"650";"841";"201";"4";"9";"828";"837"
"8";"Barcelona";"1";"Barcelona";"13";"Barcelonès";"08019";"Barcelona";"4";"39";"U";"866";"323";"583";"701";"165";"1";"2";"698";"700"
"8";"Barcelona";"1";"Barcelona";"13";"Barcelonès";"08019";"Barcelona";"4";"4";"U";"780";"234";"511";"643";"137";"2";"3";"638";"641"
"8";"Barcelona";"1";"Barcelona";"13";"Barcelonès";"08019";"Barcelona";"4";"40";"U";"1073";"305";"632";"811";"262";"1";"4";"806";"810"
"8";"Barcelona";"1";"Barcelona";"13";"Barcelonès";"08019";"Barcelona";"4";"41";"U";"957";"304";"617";"772";"185";"1";"8";"763";"771"
"8";"Barcelona";"1";"Barcelona";"13";"Barcelonès";"08019";"Barcelona";"4";"42";"A";"648";"240";"422";"521";"127";"3";"2";"516";"518"
"8";"Barcelona";"1";"Barcelona";"13";"Barcelonès";"08019";"Barcelona";"4";"42";"B";"717";"240";"457";"565";"152";"1";"1";"563";"564"
"8";"Barcelona";"1";"Barcelona";"13";"Barcelonès";"08019";"Barcelona";"4";"43";"A";"724";"219";"454";"628";"96";"2";"1";"625";"626"
"8";"Barcelona";"1";"Barcelona";"13";"Barcelonès";"08019";"Barcelona";"4";"43";"B";"633";"184";"397";"523";"110";"0";"2";"521";"523"
"8";"Barcelona";"1";"Barcelona";"13";"Barcelonès";"08019";"Barcelona";"4";"44";"A";"627";"185";"394";"486";"141";"2";"0";"484";"484"
"8";"Barcelona";"1";"Barcelona";"13";"Barcelonès";"08019";"Barcelona";"4";"44";"B";"634";"220";"417";"500";"134";"0";"0";"500";"500"
"8";"Barcelona";"1";"Barcelona";"13";"Barcelonès";"08019";"Barcelona";"4";"45";"U";"1069";"332";"700";"850";"219";"4";"3";"843";"846"
"8";"Barcelona";"1";"Barcelona";"13";"Barcelonès";"08019";"Barcelona";"4";"46";"A";"1048";"300";"713";"898";"150";"10";"0";"888";"888"
"8";"Barcelona";"1";"Barcelona";"13";"Barcelonès";"08019";"Barcelona";"4";"46";"B";"934";"288";"644";"810";"124";"2";"3";"805";"808"
"8";"Barcelona";"1";"Barcelona";"13";"Barcelonès";"08019";"Barcelona";"4";"47";"A";"726";"272";"496";"612";"114";"1";"4";"607";"611"
"8";"Barcelona";"1";"Barcelona";"13";"Barcelonès";"08019";"Barcelona";"4";"47";"B";"624";"229";"443";"527";"97";"0";"1";"526";"527"
"8";"Barcelona";"1";"Barcelona";"13";"Barcelonès";"08019";"Barcelona";"4";"48";"A";"622";"240";"448";"538";"84";"4";"1";"533";"534"
"8";"Barcelona";"1";"Barcelona";"13";"Barcelonès";"08019";"Barcelona";"4";"48";"B";"594";"222";"435";"508";"86";"1";"3";"504";"507"
"8";"Barcelona";"1";"Barcelona";"13";"Barcelonès";"08019";"Barcelona";"4";"49";"U";"847";"276";"531";"709";"138";"1";"3";"705";"708"
"8";"Barcelona";"1";"Barcelona";"13";"Barcelonès";"08019";"Barcelona";"4";"5";"U";"962";"302";"624";"775";"187";"0";"0";"775";"775"
"8";"Barcelona";"1";"Barcelona";"13";"Barcelonès";"08019";"Barcelona";"4";"50";"A";"797";"307";"537";"683";"114";"2";"2";"679";"681"
"8";"Barcelona";"1";"Barcelona";"13";"Barcelonès";"08019";"Barcelona";"4";"50";"B";"725";"284";"475";"614";"111";"1";"6";"607";"613"
"8";"Barcelona";"1";"Barcelona";"13";"Barcelonès";"08019";"Barcelona";"4";"51";"A";"610";"134";"430";"522";"88";"0";"5";"517";"522"
"8";"Barcelona";"1";"Barcelona";"13";"Barcelonès";"08019";"Barcelona";"4";"51";"B";"587";"170";"374";"466";"121";"1";"2";"463";"465"
"8";"Barcelona";"1";"Barcelona";"13";"Barcelonès";"08019";"Barcelona";"4";"52";"A";"843";"256";"558";"740";"103";"2";"2";"736";"738"
"8";"Barcelona";"1";"Barcelona";"13";"Barcelonès";"08019";"Barcelona";"4";"52";"B";"715";"234";"489";"624";"91";"0";"4";"620";"624"
"8";"Barcelona";"1";"Barcelona";"13";"Barcelonès";"08019";"Barcelona";"4";"53";"U";"1037";"314";"621";"778";"259";"2";"2";"774";"776"
"8";"Barcelona";"1";"Barcelona";"13";"Barcelonès";"08019";"Barcelona";"4";"54";"U";"766";"264";"551";"672";"94";"1";"2";"669";"671"
"8";"Barcelona";"1";"Barcelona";"13";"Barcelonès";"08019";"Barcelona";"4";"55";"U";"1042";"243";"657";"869";"173";"1";"2";"866";"868"
"8";"Barcelona";"1";"Barcelona";"13";"Barcelonès";"08019";"Barcelona";"4";"56";"U";"1111";"318";"691";"887";"224";"0";"2";"885";"887"
"8";"Barcelona";"1";"Barcelona";"13";"Barcelonès";"08019";"Barcelona";"4";"6";"U";"906";"324";"601";"759";"147";"2";"1";"756";"757"
"8";"Barcelona";"1";"Barcelona";"13";"Barcelonès";"08019";"Barcelona";"4";"7";"U";"836";"271";"503";"605";"231";"3";"6";"596";"602"
"8";"Barcelona";"1";"Barcelona";"13";"Barcelonès";"08019";"Barcelona";"4";"8";"U";"763";"265";"501";"621";"142";"0";"1";"620";"621"
"8";"Barcelona";"1";"Barcelona";"13";"Barcelonès";"08019";"Barcelona";"4";"84";"U";"1049";"387";"721";"874";"175";"1";"3";"870";"873"
"8";"Barcelona";"1";"Barcelona";"13";"Barcelonès";"08019";"Barcelona";"4";"9";"U";"1063";"355";"682";"849";"214";"2";"2";"845";"847"
"8";"Barcelona";"1";"Barcelona";"13";"Barcelonès";"08019";"Barcelona";"5";"1";"U";"1044";"362";"658";"813";"231";"4";"7";"802";"809"
"8";"Barcelona";"1";"Barcelona";"13";"Barcelonès";"08019";"Barcelona";"5";"10";"A";"590";"242";"416";"507";"83";"1";"2";"504";"506"
"8";"Barcelona";"1";"Barcelona";"13";"Barcelonès";"08019";"Barcelona";"5";"10";"B";"579";"221";"408";"496";"83";"0";"1";"495";"496"
"8";"Barcelona";"1";"Barcelona";"13";"Barcelonès";"08019";"Barcelona";"5";"11";"U";"1038";"300";"693";"883";"155";"1";"11";"871";"882"
"8";"Barcelona";"1";"Barcelona";"13";"Barcelonès";"08019";"Barcelona";"5";"12";"U";"998";"305";"659";"837";"161";"1";"6";"830";"836"
"8";"Barcelona";"1";"Barcelona";"13";"Barcelonès";"08019";"Barcelona";"5";"13";"A";"613";"204";"391";"521";"92";"0";"1";"520";"521"
"8";"Barcelona";"1";"Barcelona";"13";"Barcelonès";"08019";"Barcelona";"5";"13";"B";"570";"213";"404";"500";"70";"3";"3";"494";"497"
"8";"Barcelona";"1";"Barcelona";"13";"Barcelonès";"08019";"Barcelona";"5";"14";"A";"574";"187";"414";"493";"81";"0";"1";"492";"493"
"8";"Barcelona";"1";"Barcelona";"13";"Barcelonès";"08019";"Barcelona";"5";"14";"B";"571";"184";"430";"499";"72";"2";"5";"492";"497"
"8";"Barcelona";"1";"Barcelona";"13";"Barcelonès";"08019";"Barcelona";"5";"15";"U";"1046";"340";"720";"889";"157";"1";"6";"882";"888"
"8";"Barcelona";"1";"Barcelona";"13";"Barcelonès";"08019";"Barcelona";"5";"16";"A";"633";"202";"404";"525";"108";"3";"5";"517";"522"
"8";"Barcelona";"1";"Barcelona";"13";"Barcelonès";"08019";"Barcelona";"5";"16";"B";"640";"192";"389";"508";"132";"0";"2";"506";"508"
"8";"Barcelona";"1";"Barcelona";"13";"Barcelonès";"08019";"Barcelona";"5";"17";"U";"1114";"273";"697";"956";"158";"3";"2";"951";"953"
"8";"Barcelona";"1";"Barcelona";"13";"Barcelonès";"08019";"Barcelona";"5";"18";"U";"917";"346";"612";"769";"148";"3";"2";"764";"766"
"8";"Barcelona";"1";"Barcelona";"13";"Barcelonès";"08019";"Barcelona";"5";"19";"A";"621";"215";"463";"550";"71";"2";"5";"543";"548"
"8";"Barcelona";"1";"Barcelona";"13";"Barcelonès";"08019";"Barcelona";"5";"19";"B";"581";"200";"396";"507";"74";"0";"2";"505";"507"
"8";"Barcelona";"1";"Barcelona";"13";"Barcelonès";"08019";"Barcelona";"5";"2";"U";"1108";"369";"693";"886";"222";"0";"6";"880";"886"
"8";"Barcelona";"1";"Barcelona";"13";"Barcelonès";"08019";"Barcelona";"5";"20";"U";"822";"272";"547";"677";"145";"2";"7";"668";"675"
"8";"Barcelona";"1";"Barcelona";"13";"Barcelonès";"08019";"Barcelona";"5";"21";"U";"840";"274";"529";"691";"149";"0";"2";"689";"691"
"8";"Barcelona";"1";"Barcelona";"13";"Barcelonès";"08019";"Barcelona";"5";"22";"A";"678";"247";"470";"567";"111";"0";"2";"565";"567"
"8";"Barcelona";"1";"Barcelona";"13";"Barcelonès";"08019";"Barcelona";"5";"22";"B";"638";"234";"462";"544";"94";"0";"1";"543";"544"
"8";"Barcelona";"1";"Barcelona";"13";"Barcelonès";"08019";"Barcelona";"5";"23";"U";"1094";"333";"723";"904";"190";"2";"4";"898";"902"
"8";"Barcelona";"1";"Barcelona";"13";"Barcelonès";"08019";"Barcelona";"5";"24";"A";"730";"209";"500";"642";"88";"2";"0";"640";"640"
"8";"Barcelona";"1";"Barcelona";"13";"Barcelonès";"08019";"Barcelona";"5";"24";"B";"662";"193";"427";"582";"80";"1";"1";"580";"581"
"8";"Barcelona";"1";"Barcelona";"13";"Barcelonès";"08019";"Barcelona";"5";"25";"U";"1005";"309";"700";"876";"129";"2";"3";"871";"874"
"8";"Barcelona";"1";"Barcelona";"13";"Barcelonès";"08019";"Barcelona";"5";"26";"U";"1016";"320";"698";"877";"139";"0";"3";"874";"877"
"8";"Barcelona";"1";"Barcelona";"13";"Barcelonès";"08019";"Barcelona";"5";"27";"U";"970";"277";"649";"832";"138";"2";"3";"827";"830"
"8";"Barcelona";"1";"Barcelona";"13";"Barcelonès";"08019";"Barcelona";"5";"28";"A";"544";"164";"347";"468";"76";"0";"1";"467";"468"
"8";"Barcelona";"1";"Barcelona";"13";"Barcelonès";"08019";"Barcelona";"5";"28";"B";"550";"183";"362";"463";"87";"1";"0";"462";"462"
"8";"Barcelona";"1";"Barcelona";"13";"Barcelonès";"08019";"Barcelona";"5";"29";"A";"566";"167";"363";"490";"76";"1";"1";"488";"489"
"8";"Barcelona";"1";"Barcelona";"13";"Barcelonès";"08019";"Barcelona";"5";"29";"B";"592";"181";"387";"507";"85";"0";"4";"503";"507"
"8";"Barcelona";"1";"Barcelona";"13";"Barcelonès";"08019";"Barcelona";"5";"3";"U";"928";"367";"645";"791";"137";"1";"1";"789";"790"
"8";"Barcelona";"1";"Barcelona";"13";"Barcelonès";"08019";"Barcelona";"5";"30";"U";"1046";"293";"703";"887";"159";"0";"4";"883";"887"
"8";"Barcelona";"1";"Barcelona";"13";"Barcelonès";"08019";"Barcelona";"5";"31";"A";"635";"187";"413";"535";"100";"1";"2";"532";"534"
"8";"Barcelona";"1";"Barcelona";"13";"Barcelonès";"08019";"Barcelona";"5";"31";"B";"520";"166";"348";"438";"82";"1";"3";"434";"437"
"8";"Barcelona";"1";"Barcelona";"13";"Barcelonès";"08019";"Barcelona";"5";"32";"A";"616";"208";"394";"474";"142";"2";"3";"469";"472"
"8";"Barcelona";"1";"Barcelona";"13";"Barcelonès";"08019";"Barcelona";"5";"32";"B";"607";"196";"373";"471";"136";"1";"3";"467";"470"
"8";"Barcelona";"1";"Barcelona";"13";"Barcelonès";"08019";"Barcelona";"5";"33";"U";"958";"296";"629";"798";"160";"4";"6";"788";"794"
"8";"Barcelona";"1";"Barcelona";"13";"Barcelonès";"08019";"Barcelona";"5";"34";"U";"845";"310";"590";"704";"141";"5";"2";"697";"699"
"8";"Barcelona";"1";"Barcelona";"13";"Barcelonès";"08019";"Barcelona";"5";"35";"U";"872";"274";"579";"739";"133";"0";"1";"738";"739"
"8";"Barcelona";"1";"Barcelona";"13";"Barcelonès";"08019";"Barcelona";"5";"36";"A";"655";"195";"444";"561";"94";"2";"1";"558";"559"
"8";"Barcelona";"1";"Barcelona";"13";"Barcelonès";"08019";"Barcelona";"5";"36";"B";"584";"280";"393";"501";"83";"3";"2";"496";"498"
"8";"Barcelona";"1";"Barcelona";"13";"Barcelonès";"08019";"Barcelona";"5";"37";"U";"998";"319";"624";"818";"180";"0";"2";"816";"818"
"8";"Barcelona";"1";"Barcelona";"13";"Barcelonès";"08019";"Barcelona";"5";"38";"U";"926";"298";"570";"735";"191";"0";"8";"727";"735"
"8";"Barcelona";"1";"Barcelona";"13";"Barcelonès";"08019";"Barcelona";"5";"39";"A";"580";"209";"416";"515";"65";"1";"2";"512";"514"
"8";"Barcelona";"1";"Barcelona";"13";"Barcelonès";"08019";"Barcelona";"5";"39";"B";"582";"216";"395";"521";"61";"2";"7";"512";"519"
"8";"Barcelona";"1";"Barcelona";"13";"Barcelonès";"08019";"Barcelona";"5";"4";"U";"812";"214";"443";"579";"233";"1";"4";"574";"578"
"8";"Barcelona";"1";"Barcelona";"13";"Barcelonès";"08019";"Barcelona";"5";"40";"U";"1021";"293";"631";"830";"191";"3";"5";"822";"827"
"8";"Barcelona";"1";"Barcelona";"13";"Barcelonès";"08019";"Barcelona";"5";"41";"A";"624";"158";"336";"461";"163";"1";"3";"457";"460"
"8";"Barcelona";"1";"Barcelona";"13";"Barcelonès";"08019";"Barcelona";"5";"41";"B";"555";"172";"352";"442";"113";"2";"0";"440";"440"
"8";"Barcelona";"1";"Barcelona";"13";"Barcelonès";"08019";"Barcelona";"5";"42";"U";"901";"315";"607";"757";"144";"2";"4";"751";"755"
"8";"Barcelona";"1";"Barcelona";"13";"Barcelonès";"08019";"Barcelona";"5";"43";"U";"1022";"321";"679";"862";"160";"1";"10";"851";"861"
"8";"Barcelona";"1";"Barcelona";"13";"Barcelonès";"08019";"Barcelona";"5";"44";"U";"932";"264";"578";"761";"171";"1";"7";"753";"760"
"8";"Barcelona";"1";"Barcelona";"13";"Barcelonès";"08019";"Barcelona";"5";"45";"A";"576";"193";"393";"489";"87";"0";"2";"487";"489"
"8";"Barcelona";"1";"Barcelona";"13";"Barcelonès";"08019";"Barcelona";"5";"45";"B";"565";"192";"373";"476";"89";"2";"3";"471";"474"
"8";"Barcelona";"1";"Barcelona";"13";"Barcelonès";"08019";"Barcelona";"5";"46";"U";"921";"306";"630";"799";"122";"1";"7";"791";"798"
"8";"Barcelona";"1";"Barcelona";"13";"Barcelonès";"08019";"Barcelona";"5";"47";"U";"941";"270";"609";"791";"150";"2";"5";"784";"789"
"8";"Barcelona";"1";"Barcelona";"13";"Barcelonès";"08019";"Barcelona";"5";"48";"U";"978";"250";"619";"812";"166";"1";"8";"803";"811"
"8";"Barcelona";"1";"Barcelona";"13";"Barcelonès";"08019";"Barcelona";"5";"49";"A";"648";"190";"429";"547";"101";"3";"3";"541";"544"
"8";"Barcelona";"1";"Barcelona";"13";"Barcelonès";"08019";"Barcelona";"5";"49";"B";"584";"168";"396";"502";"82";"3";"0";"499";"499"
"8";"Barcelona";"1";"Barcelona";"13";"Barcelonès";"08019";"Barcelona";"5";"5";"U";"716";"208";"398";"500";"216";"1";"0";"499";"499"
"8";"Barcelona";"1";"Barcelona";"13";"Barcelonès";"08019";"Barcelona";"5";"50";"U";"1205";"340";"696";"1015";"190";"5";"7";"1003";"1010"
"8";"Barcelona";"1";"Barcelona";"13";"Barcelonès";"08019";"Barcelona";"5";"51";"U";"1161";"319";"803";"1018";"143";"1";"7";"1010";"1017"
"8";"Barcelona";"1";"Barcelona";"13";"Barcelonès";"08019";"Barcelona";"5";"52";"U";"1099";"334";"733";"933";"166";"2";"4";"927";"931"
"8";"Barcelona";"1";"Barcelona";"13";"Barcelonès";"08019";"Barcelona";"5";"53";"U";"1097";"301";"719";"932";"165";"3";"1";"928";"929"
"8";"Barcelona";"1";"Barcelona";"13";"Barcelonès";"08019";"Barcelona";"5";"54";"U";"762";"218";"490";"646";"116";"0";"4";"642";"646"
"8";"Barcelona";"1";"Barcelona";"13";"Barcelonès";"08019";"Barcelona";"5";"55";"U";"1052";"326";"757";"916";"136";"3";"0";"913";"913"
"8";"Barcelona";"1";"Barcelona";"13";"Barcelonès";"08019";"Barcelona";"5";"56";"U";"896";"275";"569";"738";"158";"0";"2";"736";"738"
"8";"Barcelona";"1";"Barcelona";"13";"Barcelonès";"08019";"Barcelona";"5";"57";"A";"659";"192";"411";"551";"108";"0";"2";"549";"551"
"8";"Barcelona";"1";"Barcelona";"13";"Barcelonès";"08019";"Barcelona";"5";"57";"B";"654";"236";"445";"556";"98";"1";"0";"555";"555"
"8";"Barcelona";"1";"Barcelona";"13";"Barcelonès";"08019";"Barcelona";"5";"58";"U";"1132";"297";"747";"923";"209";"0";"9";"914";"923"
"8";"Barcelona";"1";"Barcelona";"13";"Barcelonès";"08019";"Barcelona";"5";"59";"U";"1155";"388";"780";"949";"206";"4";"6";"939";"945"
"8";"Barcelona";"1";"Barcelona";"13";"Barcelonès";"08019";"Barcelona";"5";"6";"U";"1122";"370";"796";"959";"163";"0";"4";"955";"959"
"8";"Barcelona";"1";"Barcelona";"13";"Barcelonès";"08019";"Barcelona";"5";"60";"U";"776";"220";"522";"661";"115";"0";"1";"660";"661"
"8";"Barcelona";"1";"Barcelona";"13";"Barcelonès";"08019";"Barcelona";"5";"61";"U";"1035";"268";"614";"800";"235";"1";"3";"796";"799"
"8";"Barcelona";"1";"Barcelona";"13";"Barcelonès";"08019";"Barcelona";"5";"62";"U";"1159";"381";"785";"972";"187";"1";"4";"967";"971"
"8";"Barcelona";"1";"Barcelona";"13";"Barcelonès";"08019";"Barcelona";"5";"63";"U";"1142";"337";"753";"935";"207";"0";"7";"928";"935"
"8";"Barcelona";"1";"Barcelona";"13";"Barcelonès";"08019";"Barcelona";"5";"64";"U";"1171";"336";"745";"948";"223";"1";"9";"938";"947"
"8";"Barcelona";"1";"Barcelona";"13";"Barcelonès";"08019";"Barcelona";"5";"65";"U";"1161";"324";"744";"959";"202";"0";"3";"956";"959"
"8";"Barcelona";"1";"Barcelona";"13";"Barcelonès";"08019";"Barcelona";"5";"66";"U";"907";"269";"630";"778";"129";"3";"5";"770";"775"
"8";"Barcelona";"1";"Barcelona";"13";"Barcelonès";"08019";"Barcelona";"5";"67";"U";"921";"266";"636";"787";"134";"3";"2";"782";"784"
"8";"Barcelona";"1";"Barcelona";"13";"Barcelonès";"08019";"Barcelona";"5";"68";"U";"1068";"296";"729";"906";"162";"1";"6";"899";"905"
"8";"Barcelona";"1";"Barcelona";"13";"Barcelonès";"08019";"Barcelona";"5";"69";"A";"631";"195";"392";"514";"117";"1";"2";"511";"513"
"8";"Barcelona";"1";"Barcelona";"13";"Barcelonès";"08019";"Barcelona";"5";"69";"B";"579";"185";"380";"472";"107";"2";"2";"468";"470"
"8";"Barcelona";"1";"Barcelona";"13";"Barcelonès";"08019";"Barcelona";"5";"7";"A";"586";"244";"404";"485";"101";"1";"4";"480";"484"
"8";"Barcelona";"1";"Barcelona";"13";"Barcelonès";"08019";"Barcelona";"5";"7";"B";"558";"211";"375";"451";"107";"2";"2";"447";"449"
"8";"Barcelona";"1";"Barcelona";"13";"Barcelonès";"08019";"Barcelona";"5";"70";"U";"1082";"320";"757";"923";"159";"3";"3";"917";"920"
"8";"Barcelona";"1";"Barcelona";"13";"Barcelonès";"08019";"Barcelona";"5";"71";"U";"1095";"327";"681";"877";"218";"0";"4";"873";"877"
"8";"Barcelona";"1";"Barcelona";"13";"Barcelonès";"08019";"Barcelona";"5";"72";"U";"1226";"382";"846";"1028";"198";"1";"12";"1015";"1027"
"8";"Barcelona";"1";"Barcelona";"13";"Barcelonès";"08019";"Barcelona";"5";"73";"A";"626";"222";"407";"515";"111";"1";"0";"514";"514"
"8";"Barcelona";"1";"Barcelona";"13";"Barcelonès";"08019";"Barcelona";"5";"73";"B";"591";"223";"417";"505";"86";"0";"2";"503";"505"
"8";"Barcelona";"1";"Barcelona";"13";"Barcelonès";"08019";"Barcelona";"5";"74";"A";"635";"216";"431";"541";"94";"0";"1";"540";"541"
"8";"Barcelona";"1";"Barcelona";"13";"Barcelonès";"08019";"Barcelona";"5";"74";"B";"599";"211";"411";"516";"83";"2";"2";"512";"514"
"8";"Barcelona";"1";"Barcelona";"13";"Barcelonès";"08019";"Barcelona";"5";"75";"A";"650";"222";"435";"535";"115";"0";"1";"534";"535"
"8";"Barcelona";"1";"Barcelona";"13";"Barcelonès";"08019";"Barcelona";"5";"75";"B";"636";"210";"448";"542";"94";"0";"2";"540";"542"
"8";"Barcelona";"1";"Barcelona";"13";"Barcelonès";"08019";"Barcelona";"5";"76";"U";"1001";"310";"658";"832";"169";"1";"6";"825";"831"
"8";"Barcelona";"1";"Barcelona";"13";"Barcelonès";"08019";"Barcelona";"5";"77";"U";"1039";"291";"669";"879";"160";"1";"4";"874";"878"
"8";"Barcelona";"1";"Barcelona";"13";"Barcelonès";"08019";"Barcelona";"5";"78";"A";"760";"250";"496";"644";"116";"1";"5";"638";"643"
"8";"Barcelona";"1";"Barcelona";"13";"Barcelonès";"08019";"Barcelona";"5";"78";"B";"712";"221";"451";"599";"113";"0";"4";"595";"599"
"8";"Barcelona";"1";"Barcelona";"13";"Barcelonès";"08019";"Barcelona";"5";"79";"U";"931";"286";"600";"776";"155";"0";"5";"771";"776"
"8";"Barcelona";"1";"Barcelona";"13";"Barcelonès";"08019";"Barcelona";"5";"8";"U";"1099";"366";"711";"910";"189";"0";"3";"907";"910"
"8";"Barcelona";"1";"Barcelona";"13";"Barcelonès";"08019";"Barcelona";"5";"80";"U";"977";"280";"647";"825";"152";"8";"6";"811";"817"
"8";"Barcelona";"1";"Barcelona";"13";"Barcelonès";"08019";"Barcelona";"5";"81";"U";"1105";"268";"729";"922";"183";"0";"7";"915";"922"
"8";"Barcelona";"1";"Barcelona";"13";"Barcelonès";"08019";"Barcelona";"5";"82";"A";"591";"215";"386";"492";"99";"1";"5";"486";"491"
"8";"Barcelona";"1";"Barcelona";"13";"Barcelonès";"08019";"Barcelona";"5";"82";"B";"589";"240";"396";"509";"80";"2";"1";"506";"507"
"8";"Barcelona";"1";"Barcelona";"13";"Barcelonès";"08019";"Barcelona";"5";"83";"U";"940";"331";"674";"790";"150";"9";"6";"775";"781"
"8";"Barcelona";"1";"Barcelona";"13";"Barcelonès";"08019";"Barcelona";"5";"84";"U";"986";"356";"690";"827";"159";"0";"2";"825";"827"
"8";"Barcelona";"1";"Barcelona";"13";"Barcelonès";"08019";"Barcelona";"5";"85";"U";"973";"212";"593";"743";"230";"0";"3";"740";"743"
"8";"Barcelona";"1";"Barcelona";"13";"Barcelonès";"08019";"Barcelona";"5";"86";"U";"935";"240";"590";"738";"197";"6";"2";"730";"732"
"8";"Barcelona";"1";"Barcelona";"13";"Barcelonès";"08019";"Barcelona";"5";"87";"U";"1134";"285";"729";"899";"235";"3";"5";"891";"896"
"8";"Barcelona";"1";"Barcelona";"13";"Barcelonès";"08019";"Barcelona";"5";"88";"A";"673";"233";"405";"536";"137";"3";"2";"531";"533"
"8";"Barcelona";"1";"Barcelona";"13";"Barcelonès";"08019";"Barcelona";"5";"88";"B";"603";"219";"414";"496";"107";"0";"2";"494";"496"
"8";"Barcelona";"1";"Barcelona";"13";"Barcelonès";"08019";"Barcelona";"5";"89";"A";"632";"229";"421";"515";"117";"1";"3";"511";"514"
"8";"Barcelona";"1";"Barcelona";"13";"Barcelonès";"08019";"Barcelona";"5";"89";"B";"637";"224";"437";"546";"91";"0";"2";"544";"546"
"8";"Barcelona";"1";"Barcelona";"13";"Barcelonès";"08019";"Barcelona";"5";"9";"A";"631";"218";"431";"535";"96";"2";"2";"531";"533"
"8";"Barcelona";"1";"Barcelona";"13";"Barcelonès";"08019";"Barcelona";"5";"9";"B";"583";"206";"378";"480";"103";"1";"2";"477";"479"
"8";"Barcelona";"1";"Barcelona";"13";"Barcelonès";"08019";"Barcelona";"5";"90";"A";"677";"202";"415";"540";"137";"2";"4";"534";"538"
"8";"Barcelona";"1";"Barcelona";"13";"Barcelonès";"08019";"Barcelona";"5";"90";"B";"604";"208";"391";"501";"103";"3";"1";"497";"498"
"8";"Barcelona";"1";"Barcelona";"13";"Barcelonès";"08019";"Barcelona";"5";"91";"U";"1109";"339";"746";"908";"201";"3";"6";"899";"905"
"8";"Barcelona";"1";"Barcelona";"13";"Barcelonès";"08019";"Barcelona";"5";"92";"U";"1107";"347";"718";"916";"191";"5";"3";"908";"911"
"8";"Barcelona";"1";"Barcelona";"13";"Barcelonès";"08019";"Barcelona";"5";"93";"U";"829";"251";"534";"680";"149";"0";"5";"675";"680"
"8";"Barcelona";"1";"Barcelona";"13";"Barcelonès";"08019";"Barcelona";"5";"94";"A";"952";"331";"632";"811";"141";"2";"5";"804";"809"
"8";"Barcelona";"1";"Barcelona";"13";"Barcelonès";"08019";"Barcelona";"5";"94";"B";"925";"278";"600";"785";"140";"1";"3";"781";"784"
"8";"Barcelona";"1";"Barcelona";"13";"Barcelonès";"08019";"Barcelona";"5";"95";"U";"1159";"340";"771";"963";"196";"2";"3";"958";"961"
"8";"Barcelona";"1";"Barcelona";"13";"Barcelonès";"08019";"Barcelona";"5";"96";"U";"783";"254";"500";"642";"141";"1";"4";"637";"641"
"8";"Barcelona";"1";"Barcelona";"13";"Barcelonès";"08019";"Barcelona";"5";"97";"A";"584";"199";"379";"500";"84";"0";"5";"495";"500"
"8";"Barcelona";"1";"Barcelona";"13";"Barcelonès";"08019";"Barcelona";"5";"97";"B";"525";"182";"345";"431";"94";"1";"4";"426";"430"
"8";"Barcelona";"1";"Barcelona";"13";"Barcelonès";"08019";"Barcelona";"5";"98";"U";"1063";"352";"714";"871";"192";"3";"6";"862";"868"
"8";"Barcelona";"1";"Barcelona";"13";"Barcelonès";"08019";"Barcelona";"6";"1";"U";"726";"282";"478";"572";"154";"3";"0";"569";"569"
"8";"Barcelona";"1";"Barcelona";"13";"Barcelonès";"08019";"Barcelona";"6";"10";"U";"787";"286";"564";"670";"117";"3";"4";"663";"667"
"8";"Barcelona";"1";"Barcelona";"13";"Barcelonès";"08019";"Barcelona";"6";"11";"U";"972";"249";"656";"804";"168";"4";"4";"796";"800"
"8";"Barcelona";"1";"Barcelona";"13";"Barcelonès";"08019";"Barcelona";"6";"12";"U";"832";"268";"541";"664";"168";"4";"7";"653";"660"
"8";"Barcelona";"1";"Barcelona";"13";"Barcelonès";"08019";"Barcelona";"6";"13";"A";"636";"215";"405";"497";"139";"3";"1";"493";"494"
"8";"Barcelona";"1";"Barcelona";"13";"Barcelonès";"08019";"Barcelona";"6";"13";"B";"601";"196";"381";"473";"128";"2";"4";"467";"471"
"8";"Barcelona";"1";"Barcelona";"13";"Barcelonès";"08019";"Barcelona";"6";"14";"U";"1042";"288";"681";"813";"229";"2";"4";"807";"811"
"8";"Barcelona";"1";"Barcelona";"13";"Barcelonès";"08019";"Barcelona";"6";"15";"U";"1005";"256";"565";"729";"276";"6";"3";"720";"723"
"8";"Barcelona";"1";"Barcelona";"13";"Barcelonès";"08019";"Barcelona";"6";"16";"U";"1118";"305";"667";"839";"279";"5";"3";"831";"834"
"8";"Barcelona";"1";"Barcelona";"13";"Barcelonès";"08019";"Barcelona";"6";"17";"U";"930";"266";"585";"706";"224";"1";"3";"702";"705"
"8";"Barcelona";"1";"Barcelona";"13";"Barcelonès";"08019";"Barcelona";"6";"18";"U";"912";"322";"571";"707";"205";"1";"1";"705";"706"
"8";"Barcelona";"1";"Barcelona";"13";"Barcelonès";"08019";"Barcelona";"6";"19";"U";"1103";"327";"830";"867";"236";"1";"5";"861";"866"
"8";"Barcelona";"1";"Barcelona";"13";"Barcelonès";"08019";"Barcelona";"6";"2";"U";"1045";"321";"682";"834";"211";"2";"5";"827";"832"
"8";"Barcelona";"1";"Barcelona";"13";"Barcelonès";"08019";"Barcelona";"6";"20";"U";"821";"285";"552";"661";"160";"1";"6";"654";"660"
"8";"Barcelona";"1";"Barcelona";"13";"Barcelonès";"08019";"Barcelona";"6";"21";"U";"968";"374";"645";"786";"182";"0";"4";"782";"786"
"8";"Barcelona";"1";"Barcelona";"13";"Barcelonès";"08019";"Barcelona";"6";"22";"U";"950";"275";"528";"715";"235";"5";"4";"706";"710"
"8";"Barcelona";"1";"Barcelona";"13";"Barcelonès";"08019";"Barcelona";"6";"23";"U";"1087";"317";"738";"915";"172";"1";"3";"911";"914"
"8";"Barcelona";"1";"Barcelona";"13";"Barcelonès";"08019";"Barcelona";"6";"24";"A";"624";"215";"410";"496";"128";"1";"3";"492";"495"
"8";"Barcelona";"1";"Barcelona";"13";"Barcelonès";"08019";"Barcelona";"6";"24";"B";"584";"210";"402";"484";"100";"0";"5";"479";"484"
"8";"Barcelona";"1";"Barcelona";"13";"Barcelonès";"08019";"Barcelona";"6";"25";"U";"1077";"320";"701";"880";"197";"1";"6";"873";"879"
"8";"Barcelona";"1";"Barcelona";"13";"Barcelonès";"08019";"Barcelona";"6";"26";"U";"789";"278";"477";"577";"212";"2";"5";"570";"575"
"8";"Barcelona";"1";"Barcelona";"13";"Barcelonès";"08019";"Barcelona";"6";"27";"U";"918";"301";"601";"757";"161";"2";"7";"748";"755"
"8";"Barcelona";"1";"Barcelona";"13";"Barcelonès";"08019";"Barcelona";"6";"28";"U";"952";"335";"621";"748";"204";"2";"3";"743";"746"
"8";"Barcelona";"1";"Barcelona";"13";"Barcelonès";"08019";"Barcelona";"6";"29";"U";"964";"390";"616";"766";"198";"0";"7";"759";"766"
"8";"Barcelona";"1";"Barcelona";"13";"Barcelonès";"08019";"Barcelona";"6";"3";"A";"840";"226";"531";"675";"165";"2";"2";"671";"673"
"8";"Barcelona";"1";"Barcelona";"13";"Barcelonès";"08019";"Barcelona";"6";"3";"B";"801";"203";"462";"634";"167";"1";"1";"632";"633"
"8";"Barcelona";"1";"Barcelona";"13";"Barcelonès";"08019";"Barcelona";"6";"30";"U";"976";"382";"600";"729";"247";"1";"3";"725";"728"
"8";"Barcelona";"1";"Barcelona";"13";"Barcelonès";"08019";"Barcelona";"6";"31";"U";"828";"275";"537";"663";"165";"0";"5";"658";"663"
"8";"Barcelona";"1";"Barcelona";"13";"Barcelonès";"08019";"Barcelona";"6";"32";"U";"868";"270";"555";"684";"184";"3";"2";"679";"681"
"8";"Barcelona";"1";"Barcelona";"13";"Barcelonès";"08019";"Barcelona";"6";"33";"U";"990";"340";"658";"798";"192";"0";"2";"796";"798"
"8";"Barcelona";"1";"Barcelona";"13";"Barcelonès";"08019";"Barcelona";"6";"34";"U";"935";"348";"728";"741";"194";"1";"2";"738";"740"
"8";"Barcelona";"1";"Barcelona";"13";"Barcelonès";"08019";"Barcelona";"6";"35";"U";"780";"313";"527";"662";"118";"0";"5";"657";"662"
"8";"Barcelona";"1";"Barcelona";"13";"Barcelonès";"08019";"Barcelona";"6";"36";"U";"1061";"389";"701";"850";"211";"3";"6";"841";"847"
"8";"Barcelona";"1";"Barcelona";"13";"Barcelonès";"08019";"Barcelona";"6";"37";"U";"746";"231";"458";"584";"162";"2";"8";"574";"582"
"8";"Barcelona";"1";"Barcelona";"13";"Barcelonès";"08019";"Barcelona";"6";"38";"U";"1048";"348";"658";"821";"227";"6";"3";"812";"815"
"8";"Barcelona";"1";"Barcelona";"13";"Barcelonès";"08019";"Barcelona";"6";"39";"U";"1096";"299";"685";"846";"250";"3";"3";"840";"843"
"8";"Barcelona";"1";"Barcelona";"13";"Barcelonès";"08019";"Barcelona";"6";"4";"U";"1067";"410";"671";"838";"229";"1";"5";"832";"837"
"8";"Barcelona";"1";"Barcelona";"13";"Barcelonès";"08019";"Barcelona";"6";"40";"A";"604";"223";"390";"466";"138";"0";"0";"466";"466"
"8";"Barcelona";"1";"Barcelona";"13";"Barcelonès";"08019";"Barcelona";"6";"40";"B";"588";"207";"381";"479";"109";"2";"4";"473";"477"
"8";"Barcelona";"1";"Barcelona";"13";"Barcelonès";"08019";"Barcelona";"6";"41";"A";"590";"235";"418";"503";"87";"1";"3";"499";"502"
"8";"Barcelona";"1";"Barcelona";"13";"Barcelonès";"08019";"Barcelona";"6";"41";"B";"575";"216";"376";"472";"103";"0";"1";"471";"472"
"8";"Barcelona";"1";"Barcelona";"13";"Barcelonès";"08019";"Barcelona";"6";"42";"U";"1128";"324";"731";"898";"230";"1";"7";"890";"897"
"8";"Barcelona";"1";"Barcelona";"13";"Barcelonès";"08019";"Barcelona";"6";"43";"U";"831";"244";"535";"665";"166";"2";"1";"662";"663"
"8";"Barcelona";"1";"Barcelona";"13";"Barcelonès";"08019";"Barcelona";"6";"44";"U";"1036";"363";"656";"852";"184";"1";"4";"847";"851"
"8";"Barcelona";"1";"Barcelona";"13";"Barcelonès";"08019";"Barcelona";"6";"45";"U";"843";"269";"520";"644";"199";"0";"2";"642";"644"
"8";"Barcelona";"1";"Barcelona";"13";"Barcelonès";"08019";"Barcelona";"6";"46";"U";"725";"239";"426";"545";"180";"2";"3";"540";"543"
"8";"Barcelona";"1";"Barcelona";"13";"Barcelonès";"08019";"Barcelona";"6";"47";"U";"1050";"289";"533";"655";"395";"1";"2";"652";"654"
"8";"Barcelona";"1";"Barcelona";"13";"Barcelonès";"08019";"Barcelona";"6";"48";"U";"910";"236";"535";"684";"226";"5";"6";"673";"679"
"8";"Barcelona";"1";"Barcelona";"13";"Barcelonès";"08019";"Barcelona";"6";"49";"U";"735";"291";"482";"594";"141";"1";"4";"589";"593"
"8";"Barcelona";"1";"Barcelona";"13";"Barcelonès";"08019";"Barcelona";"6";"50";"U";"831";"231";"490";"611";"220";"0";"4";"607";"611"
"8";"Barcelona";"1";"Barcelona";"13";"Barcelonès";"08019";"Barcelona";"6";"51";"U";"856";"301";"564";"689";"167";"2";"8";"679";"687"
"8";"Barcelona";"1";"Barcelona";"13";"Barcelonès";"08019";"Barcelona";"6";"52";"U";"1075";"338";"706";"869";"206";"0";"7";"862";"869"
"8";"Barcelona";"1";"Barcelona";"13";"Barcelonès";"08019";"Barcelona";"6";"53";"U";"1041";"323";"620";"778";"263";"2";"5";"771";"776"
"8";"Barcelona";"1";"Barcelona";"13";"Barcelonès";"08019";"Barcelona";"6";"54";"U";"1095";"364";"675";"855";"240";"4";"5";"846";"851"
"8";"Barcelona";"1";"Barcelona";"13";"Barcelonès";"08019";"Barcelona";"6";"55";"U";"1035";"302";"650";"777";"258";"5";"2";"770";"772"
"8";"Barcelona";"1";"Barcelona";"13";"Barcelonès";"08019";"Barcelona";"6";"56";"U";"1038";"311";"668";"778";"260";"4";"6";"768";"774"
"8";"Barcelona";"1";"Barcelona";"13";"Barcelonès";"08019";"Barcelona";"6";"57";"U";"1040";"363";"725";"799";"241";"3";"7";"789";"796"
"8";"Barcelona";"1";"Barcelona";"13";"Barcelonès";"08019";"Barcelona";"6";"58";"U";"1174";"366";"748";"898";"276";"0";"2";"896";"898"
"8";"Barcelona";"1";"Barcelona";"13";"Barcelonès";"08019";"Barcelona";"6";"59";"U";"1100";"364";"698";"876";"224";"1";"7";"868";"875"
"8";"Barcelona";"1";"Barcelona";"13";"Barcelonès";"08019";"Barcelona";"6";"6";"U";"749";"272";"502";"628";"121";"1";"4";"623";"627"
"8";"Barcelona";"1";"Barcelona";"13";"Barcelonès";"08019";"Barcelona";"6";"60";"A";"636";"215";"404";"506";"130";"4";"5";"497";"502"
"8";"Barcelona";"1";"Barcelona";"13";"Barcelonès";"08019";"Barcelona";"6";"60";"B";"624";"210";"387";"495";"129";"1";"5";"489";"494"
"8";"Barcelona";"1";"Barcelona";"13";"Barcelonès";"08019";"Barcelona";"6";"61";"U";"988";"333";"627";"773";"215";"3";"5";"765";"770"
"8";"Barcelona";"1";"Barcelona";"13";"Barcelonès";"08019";"Barcelona";"6";"62";"U";"921";"307";"727";"765";"156";"1";"5";"759";"764"
"8";"Barcelona";"1";"Barcelona";"13";"Barcelonès";"08019";"Barcelona";"6";"63";"U";"1051";"364";"697";"828";"223";"1";"3";"824";"827"
"8";"Barcelona";"1";"Barcelona";"13";"Barcelonès";"08019";"Barcelona";"6";"64";"A";"733";"267";"511";"616";"117";"2";"1";"613";"614"
"8";"Barcelona";"1";"Barcelona";"13";"Barcelonès";"08019";"Barcelona";"6";"64";"B";"674";"228";"462";"551";"123";"0";"1";"550";"551"
"8";"Barcelona";"1";"Barcelona";"13";"Barcelonès";"08019";"Barcelona";"6";"65";"U";"869";"317";"603";"737";"132";"0";"5";"732";"737"
"8";"Barcelona";"1";"Barcelona";"13";"Barcelonès";"08019";"Barcelona";"6";"66";"U";"733";"263";"481";"599";"134";"3";"2";"594";"596"
"8";"Barcelona";"1";"Barcelona";"13";"Barcelonès";"08019";"Barcelona";"6";"67";"A";"667";"228";"434";"539";"128";"1";"4";"534";"538"
"8";"Barcelona";"1";"Barcelona";"13";"Barcelonès";"08019";"Barcelona";"6";"67";"B";"608";"196";"394";"480";"128";"2";"3";"475";"478"
"8";"Barcelona";"1";"Barcelona";"13";"Barcelonès";"08019";"Barcelona";"6";"68";"U";"1101";"332";"723";"871";"230";"4";"2";"865";"867"
"8";"Barcelona";"1";"Barcelona";"13";"Barcelonès";"08019";"Barcelona";"6";"69";"U";"820";"277";"564";"666";"154";"4";"5";"657";"662"
"8";"Barcelona";"1";"Barcelona";"13";"Barcelonès";"08019";"Barcelona";"6";"7";"A";"743";"272";"484";"604";"139";"0";"4";"600";"604"
"8";"Barcelona";"1";"Barcelona";"13";"Barcelonès";"08019";"Barcelona";"6";"7";"B";"605";"207";"400";"489";"116";"2";"2";"485";"487"
"8";"Barcelona";"1";"Barcelona";"13";"Barcelonès";"08019";"Barcelona";"6";"70";"A";"696";"273";"475";"541";"155";"0";"2";"539";"541"
"8";"Barcelona";"1";"Barcelona";"13";"Barcelonès";"08019";"Barcelona";"6";"70";"B";"644";"238";"420";"498";"146";"0";"5";"493";"498"
"8";"Barcelona";"1";"Barcelona";"13";"Barcelonès";"08019";"Barcelona";"6";"71";"U";"790";"246";"522";"659";"131";"1";"4";"654";"658"
"8";"Barcelona";"1";"Barcelona";"13";"Barcelonès";"08019";"Barcelona";"6";"72";"A";"637";"238";"441";"541";"96";"1";"3";"537";"540"
"8";"Barcelona";"1";"Barcelona";"13";"Barcelonès";"08019";"Barcelona";"6";"72";"B";"618";"247";"436";"522";"96";"0";"3";"519";"522"
"8";"Barcelona";"1";"Barcelona";"13";"Barcelonès";"08019";"Barcelona";"6";"73";"U";"1064";"370";"724";"888";"176";"0";"4";"884";"888"
"8";"Barcelona";"1";"Barcelona";"13";"Barcelonès";"08019";"Barcelona";"6";"74";"U";"780";"276";"493";"606";"174";"0";"2";"604";"606"
"8";"Barcelona";"1";"Barcelona";"13";"Barcelonès";"08019";"Barcelona";"6";"75";"U";"868";"350";"617";"749";"119";"1";"2";"746";"748"
"8";"Barcelona";"1";"Barcelona";"13";"Barcelonès";"08019";"Barcelona";"6";"76";"U";"1009";"340";"668";"848";"161";"3";"1";"844";"845"
"8";"Barcelona";"1";"Barcelona";"13";"Barcelonès";"08019";"Barcelona";"6";"77";"U";"891";"291";"576";"694";"197";"2";"3";"689";"692"
"8";"Barcelona";"1";"Barcelona";"13";"Barcelonès";"08019";"Barcelona";"6";"78";"U";"925";"291";"619";"745";"180";"3";"6";"736";"742"
"8";"Barcelona";"1";"Barcelona";"13";"Barcelonès";"08019";"Barcelona";"6";"79";"U";"834";"330";"560";"675";"159";"2";"2";"671";"673"
"8";"Barcelona";"1";"Barcelona";"13";"Barcelonès";"08019";"Barcelona";"6";"8";"A";"691";"260";"463";"550";"141";"0";"8";"542";"550"
"8";"Barcelona";"1";"Barcelona";"13";"Barcelonès";"08019";"Barcelona";"6";"8";"B";"676";"228";"441";"535";"141";"2";"3";"530";"533"
"8";"Barcelona";"1";"Barcelona";"13";"Barcelonès";"08019";"Barcelona";"6";"80";"U";"894";"310";"595";"726";"168";"1";"5";"720";"725"
"8";"Barcelona";"1";"Barcelona";"13";"Barcelonès";"08019";"Barcelona";"6";"81";"U";"949";"287";"602";"754";"195";"1";"2";"751";"753"
"8";"Barcelona";"1";"Barcelona";"13";"Barcelonès";"08019";"Barcelona";"6";"82";"A";"696";"229";"436";"569";"127";"1";"3";"565";"568"
"8";"Barcelona";"1";"Barcelona";"13";"Barcelonès";"08019";"Barcelona";"6";"82";"B";"654";"243";"440";"538";"116";"2";"1";"535";"536"
"8";"Barcelona";"1";"Barcelona";"13";"Barcelonès";"08019";"Barcelona";"6";"83";"A";"689";"282";"461";"566";"123";"4";"3";"559";"562"
"8";"Barcelona";"1";"Barcelona";"13";"Barcelonès";"08019";"Barcelona";"6";"83";"B";"648";"260";"453";"556";"92";"0";"1";"555";"556"
"8";"Barcelona";"1";"Barcelona";"13";"Barcelonès";"08019";"Barcelona";"6";"84";"U";"1075";"343";"702";"858";"217";"1";"3";"854";"857"
"8";"Barcelona";"1";"Barcelona";"13";"Barcelonès";"08019";"Barcelona";"6";"85";"U";"950";"317";"655";"808";"142";"2";"4";"802";"806"
"8";"Barcelona";"1";"Barcelona";"13";"Barcelonès";"08019";"Barcelona";"6";"86";"U";"766";"243";"512";"668";"98";"0";"2";"666";"668"
"8";"Barcelona";"1";"Barcelona";"13";"Barcelonès";"08019";"Barcelona";"6";"87";"A";"790";"266";"560";"673";"117";"0";"0";"673";"673"
"8";"Barcelona";"1";"Barcelona";"13";"Barcelonès";"08019";"Barcelona";"6";"87";"B";"777";"300";"560";"680";"97";"2";"3";"675";"678"
"8";"Barcelona";"1";"Barcelona";"13";"Barcelonès";"08019";"Barcelona";"6";"88";"U";"937";"354";"670";"805";"132";"2";"4";"799";"803"
"8";"Barcelona";"1";"Barcelona";"13";"Barcelonès";"08019";"Barcelona";"6";"9";"U";"849";"304";"607";"693";"156";"1";"1";"691";"692"
"8";"Barcelona";"1";"Barcelona";"13";"Barcelonès";"08019";"Barcelona";"7";"1";"A";"656";"200";"400";"497";"159";"3";"4";"490";"494"
"8";"Barcelona";"1";"Barcelona";"13";"Barcelonès";"08019";"Barcelona";"7";"1";"B";"575";"221";"390";"454";"121";"0";"0";"454";"454"
"8";"Barcelona";"1";"Barcelona";"13";"Barcelonès";"08019";"Barcelona";"7";"10";"U";"980";"309";"616";"752";"228";"3";"3";"746";"749"
"8";"Barcelona";"1";"Barcelona";"13";"Barcelonès";"08019";"Barcelona";"7";"100";"U";"938";"338";"621";"732";"206";"2";"4";"726";"730"
"8";"Barcelona";"1";"Barcelona";"13";"Barcelonès";"08019";"Barcelona";"7";"101";"U";"1056";"352";"696";"861";"195";"2";"6";"853";"859"
"8";"Barcelona";"1";"Barcelona";"13";"Barcelonès";"08019";"Barcelona";"7";"102";"U";"399";"119";"244";"305";"94";"0";"3";"302";"305"
"8";"Barcelona";"1";"Barcelona";"13";"Barcelonès";"08019";"Barcelona";"7";"103";"U";"1008";"274";"602";"742";"266";"1";"5";"736";"741"
"8";"Barcelona";"1";"Barcelona";"13";"Barcelonès";"08019";"Barcelona";"7";"104";"A";"622";"214";"388";"474";"148";"2";"4";"468";"472"
"8";"Barcelona";"1";"Barcelona";"13";"Barcelonès";"08019";"Barcelona";"7";"104";"B";"575";"223";"356";"439";"136";"2";"1";"436";"437"
"8";"Barcelona";"1";"Barcelona";"13";"Barcelonès";"08019";"Barcelona";"7";"105";"U";"848";"263";"525";"701";"147";"4";"4";"693";"697"
"8";"Barcelona";"1";"Barcelona";"13";"Barcelonès";"08019";"Barcelona";"7";"106";"U";"927";"309";"575";"709";"218";"2";"3";"704";"707"
"8";"Barcelona";"1";"Barcelona";"13";"Barcelonès";"08019";"Barcelona";"7";"107";"U";"1014";"329";"704";"849";"165";"2";"2";"845";"847"
"8";"Barcelona";"1";"Barcelona";"13";"Barcelonès";"08019";"Barcelona";"7";"108";"U";"1011";"320";"661";"824";"187";"4";"4";"816";"820"
"8";"Barcelona";"1";"Barcelona";"13";"Barcelonès";"08019";"Barcelona";"7";"109";"A";"643";"214";"409";"506";"137";"1";"1";"504";"505"
"8";"Barcelona";"1";"Barcelona";"13";"Barcelonès";"08019";"Barcelona";"7";"109";"B";"638";"212";"398";"489";"149";"2";"2";"485";"487"
"8";"Barcelona";"1";"Barcelona";"13";"Barcelonès";"08019";"Barcelona";"7";"11";"U";"831";"250";"506";"627";"204";"1";"4";"622";"626"
"8";"Barcelona";"1";"Barcelona";"13";"Barcelonès";"08019";"Barcelona";"7";"110";"U";"836";"328";"488";"651";"185";"0";"10";"641";"651"
"8";"Barcelona";"1";"Barcelona";"13";"Barcelonès";"08019";"Barcelona";"7";"111";"U";"750";"287";"522";"628";"122";"3";"6";"619";"625"
"8";"Barcelona";"1";"Barcelona";"13";"Barcelonès";"08019";"Barcelona";"7";"112";"U";"984";"358";"658";"782";"202";"3";"5";"774";"779"
"8";"Barcelona";"1";"Barcelona";"13";"Barcelonès";"08019";"Barcelona";"7";"113";"U";"895";"310";"566";"689";"206";"1";"3";"685";"688"
"8";"Barcelona";"1";"Barcelona";"13";"Barcelonès";"08019";"Barcelona";"7";"114";"U";"931";"342";"653";"767";"164";"3";"1";"763";"764"
"8";"Barcelona";"1";"Barcelona";"13";"Barcelonès";"08019";"Barcelona";"7";"115";"U";"844";"252";"610";"728";"116";"2";"5";"721";"726"
"8";"Barcelona";"1";"Barcelona";"13";"Barcelonès";"08019";"Barcelona";"7";"116";"U";"1133";"437";"833";"911";"222";"6";"5";"900";"905"
"8";"Barcelona";"1";"Barcelona";"13";"Barcelonès";"08019";"Barcelona";"7";"117";"U";"1019";"275";"539";"669";"350";"3";"1";"665";"666"
"8";"Barcelona";"1";"Barcelona";"13";"Barcelonès";"08019";"Barcelona";"7";"118";"U";"971";"357";"636";"762";"209";"3";"10";"749";"759"
"8";"Barcelona";"1";"Barcelona";"13";"Barcelonès";"08019";"Barcelona";"7";"119";"U";"873";"303";"583";"654";"219";"2";"5";"647";"652"
"8";"Barcelona";"1";"Barcelona";"13";"Barcelonès";"08019";"Barcelona";"7";"12";"U";"1146";"371";"743";"909";"237";"2";"7";"900";"907"
"8";"Barcelona";"1";"Barcelona";"13";"Barcelonès";"08019";"Barcelona";"7";"120";"U";"954";"320";"588";"732";"222";"0";"4";"728";"732"
"8";"Barcelona";"1";"Barcelona";"13";"Barcelonès";"08019";"Barcelona";"7";"121";"U";"879";"309";"525";"631";"248";"2";"2";"627";"629"
"8";"Barcelona";"1";"Barcelona";"13";"Barcelonès";"08019";"Barcelona";"7";"122";"U";"1048";"354";"664";"780";"268";"2";"6";"772";"778"
"8";"Barcelona";"1";"Barcelona";"13";"Barcelonès";"08019";"Barcelona";"7";"123";"U";"1056";"343";"668";"823";"233";"1";"8";"814";"822"
"8";"Barcelona";"1";"Barcelona";"13";"Barcelonès";"08019";"Barcelona";"7";"13";"U";"1011";"355";"697";"840";"171";"5";"4";"831";"835"
"8";"Barcelona";"1";"Barcelona";"13";"Barcelonès";"08019";"Barcelona";"7";"14";"U";"667";"221";"400";"491";"176";"2";"1";"488";"489"
"8";"Barcelona";"1";"Barcelona";"13";"Barcelonès";"08019";"Barcelona";"7";"15";"U";"1078";"395";"702";"835";"243";"2";"1";"832";"833"
"8";"Barcelona";"1";"Barcelona";"13";"Barcelonès";"08019";"Barcelona";"7";"16";"U";"1008";"369";"690";"848";"160";"1";"4";"843";"847"
"8";"Barcelona";"1";"Barcelona";"13";"Barcelonès";"08019";"Barcelona";"7";"17";"U";"1191";"362";"772";"928";"263";"1";"0";"927";"927"
"8";"Barcelona";"1";"Barcelona";"13";"Barcelonès";"08019";"Barcelona";"7";"18";"U";"1153";"311";"686";"869";"284";"5";"4";"860";"864"
"8";"Barcelona";"1";"Barcelona";"13";"Barcelonès";"08019";"Barcelona";"7";"19";"U";"1090";"344";"729";"888";"202";"2";"5";"881";"886"
"8";"Barcelona";"1";"Barcelona";"13";"Barcelonès";"08019";"Barcelona";"7";"2";"U";"894";"314";"582";"707";"187";"2";"4";"701";"705"
"8";"Barcelona";"1";"Barcelona";"13";"Barcelonès";"08019";"Barcelona";"7";"20";"U";"1110";"342";"733";"905";"205";"6";"7";"892";"899"
"8";"Barcelona";"1";"Barcelona";"13";"Barcelonès";"08019";"Barcelona";"7";"21";"U";"825";"300";"508";"665";"160";"3";"1";"661";"662"
"8";"Barcelona";"1";"Barcelona";"13";"Barcelonès";"08019";"Barcelona";"7";"22";"U";"884";"294";"520";"647";"237";"3";"0";"644";"644"
"8";"Barcelona";"1";"Barcelona";"13";"Barcelonès";"08019";"Barcelona";"7";"23";"U";"941";"314";"546";"670";"271";"1";"4";"665";"669"
"8";"Barcelona";"1";"Barcelona";"13";"Barcelonès";"08019";"Barcelona";"7";"24";"U";"1058";"357";"626";"799";"259";"6";"6";"787";"793"
"8";"Barcelona";"1";"Barcelona";"13";"Barcelonès";"08019";"Barcelona";"7";"25";"U";"1013";"282";"595";"745";"268";"2";"4";"739";"743"
"8";"Barcelona";"1";"Barcelona";"13";"Barcelonès";"08019";"Barcelona";"7";"26";"U";"845";"307";"549";"668";"177";"5";"5";"658";"663"
"8";"Barcelona";"1";"Barcelona";"13";"Barcelonès";"08019";"Barcelona";"7";"27";"A";"707";"255";"457";"571";"136";"0";"3";"568";"571"
"8";"Barcelona";"1";"Barcelona";"13";"Barcelonès";"08019";"Barcelona";"7";"27";"B";"657";"225";"405";"509";"148";"1";"2";"506";"508"
"8";"Barcelona";"1";"Barcelona";"13";"Barcelonès";"08019";"Barcelona";"7";"28";"U";"1039";"288";"572";"774";"265";"2";"2";"770";"772"
"8";"Barcelona";"1";"Barcelona";"13";"Barcelonès";"08019";"Barcelona";"7";"29";"U";"997";"265";"604";"727";"270";"1";"2";"724";"726"
"8";"Barcelona";"1";"Barcelona";"13";"Barcelonès";"08019";"Barcelona";"7";"3";"U";"917";"322";"603";"767";"150";"1";"2";"764";"766"
"8";"Barcelona";"1";"Barcelona";"13";"Barcelonès";"08019";"Barcelona";"7";"30";"U";"985";"318";"595";"720";"265";"2";"4";"714";"718"
"8";"Barcelona";"1";"Barcelona";"13";"Barcelonès";"08019";"Barcelona";"7";"31";"U";"1143";"357";"664";"830";"313";"3";"6";"821";"827"
"8";"Barcelona";"1";"Barcelona";"13";"Barcelonès";"08019";"Barcelona";"7";"32";"U";"1006";"323";"635";"784";"222";"3";"6";"775";"781"
"8";"Barcelona";"1";"Barcelona";"13";"Barcelonès";"08019";"Barcelona";"7";"33";"U";"1079";"416";"750";"872";"207";"6";"5";"861";"866"
"8";"Barcelona";"1";"Barcelona";"13";"Barcelonès";"08019";"Barcelona";"7";"34";"A";"656";"248";"440";"533";"123";"0";"0";"533";"533"
"8";"Barcelona";"1";"Barcelona";"13";"Barcelonès";"08019";"Barcelona";"7";"34";"B";"559";"203";"383";"465";"94";"2";"2";"461";"463"
"8";"Barcelona";"1";"Barcelona";"13";"Barcelonès";"08019";"Barcelona";"7";"35";"A";"693";"246";"455";"567";"126";"2";"1";"564";"565"
"8";"Barcelona";"1";"Barcelona";"13";"Barcelonès";"08019";"Barcelona";"7";"35";"B";"624";"250";"426";"519";"105";"2";"2";"515";"517"
"8";"Barcelona";"1";"Barcelona";"13";"Barcelonès";"08019";"Barcelona";"7";"36";"U";"1053";"313";"636";"828";"225";"1";"4";"823";"827"
"8";"Barcelona";"1";"Barcelona";"13";"Barcelonès";"08019";"Barcelona";"7";"37";"U";"1105";"341";"728";"876";"229";"5";"6";"865";"871"
"8";"Barcelona";"1";"Barcelona";"13";"Barcelonès";"08019";"Barcelona";"7";"38";"U";"965";"322";"622";"760";"205";"4";"5";"751";"756"
"8";"Barcelona";"1";"Barcelona";"13";"Barcelonès";"08019";"Barcelona";"7";"39";"U";"1146";"385";"696";"873";"273";"0";"2";"871";"873"
"8";"Barcelona";"1";"Barcelona";"13";"Barcelonès";"08019";"Barcelona";"7";"4";"U";"1082";"389";"731";"862";"220";"0";"5";"857";"862"
"8";"Barcelona";"1";"Barcelona";"13";"Barcelonès";"08019";"Barcelona";"7";"40";"U";"1085";"356";"728";"866";"219";"2";"6";"858";"864"
"8";"Barcelona";"1";"Barcelona";"13";"Barcelonès";"08019";"Barcelona";"7";"41";"U";"929";"273";"552";"667";"262";"0";"0";"667";"667"
"8";"Barcelona";"1";"Barcelona";"13";"Barcelonès";"08019";"Barcelona";"7";"42";"U";"1161";"309";"730";"891";"270";"2";"4";"885";"889"
"8";"Barcelona";"1";"Barcelona";"13";"Barcelonès";"08019";"Barcelona";"7";"43";"U";"1003";"332";"675";"801";"202";"4";"4";"793";"797"
"8";"Barcelona";"1";"Barcelona";"13";"Barcelonès";"08019";"Barcelona";"7";"44";"U";"1020";"500";"722";"817";"203";"1";"5";"811";"816"
"8";"Barcelona";"1";"Barcelona";"13";"Barcelonès";"08019";"Barcelona";"7";"45";"U";"1091";"469";"722";"846";"245";"5";"4";"837";"841"
"8";"Barcelona";"1";"Barcelona";"13";"Barcelonès";"08019";"Barcelona";"7";"46";"U";"1019";"381";"618";"734";"285";"2";"6";"726";"732"
"8";"Barcelona";"1";"Barcelona";"13";"Barcelonès";"08019";"Barcelona";"7";"47";"U";"1052";"336";"633";"785";"267";"0";"5";"780";"785"
"8";"Barcelona";"1";"Barcelona";"13";"Barcelonès";"08019";"Barcelona";"7";"48";"U";"907";"286";"588";"728";"179";"0";"8";"720";"728"
"8";"Barcelona";"1";"Barcelona";"13";"Barcelonès";"08019";"Barcelona";"7";"49";"U";"932";"319";"642";"755";"177";"5";"1";"749";"750"
"8";"Barcelona";"1";"Barcelona";"13";"Barcelonès";"08019";"Barcelona";"7";"5";"U";"1120";"413";"723";"868";"252";"5";"11";"852";"863"
"8";"Barcelona";"1";"Barcelona";"13";"Barcelonès";"08019";"Barcelona";"7";"50";"U";"820";"285";"525";"643";"177";"0";"0";"643";"643"
"8";"Barcelona";"1";"Barcelona";"13";"Barcelonès";"08019";"Barcelona";"7";"51";"A";"680";"234";"401";"504";"176";"1";"3";"500";"503"
"8";"Barcelona";"1";"Barcelona";"13";"Barcelonès";"08019";"Barcelona";"7";"51";"B";"583";"195";"332";"421";"162";"2";"5";"414";"419"
"8";"Barcelona";"1";"Barcelona";"13";"Barcelonès";"08019";"Barcelona";"7";"52";"U";"1014";"310";"657";"808";"206";"4";"5";"799";"804"
"8";"Barcelona";"1";"Barcelona";"13";"Barcelonès";"08019";"Barcelona";"7";"53";"U";"1140";"319";"725";"922";"218";"0";"5";"917";"922"
"8";"Barcelona";"1";"Barcelona";"13";"Barcelonès";"08019";"Barcelona";"7";"54";"A";"633";"265";"451";"541";"92";"2";"2";"537";"539"
"8";"Barcelona";"1";"Barcelona";"13";"Barcelonès";"08019";"Barcelona";"7";"54";"B";"542";"200";"383";"465";"77";"0";"1";"464";"465"
"8";"Barcelona";"1";"Barcelona";"13";"Barcelonès";"08019";"Barcelona";"7";"55";"U";"945";"323";"683";"817";"128";"2";"1";"814";"815"
"8";"Barcelona";"1";"Barcelona";"13";"Barcelonès";"08019";"Barcelona";"7";"56";"U";"911";"308";"586";"709";"202";"0";"0";"709";"709"
"8";"Barcelona";"1";"Barcelona";"13";"Barcelonès";"08019";"Barcelona";"7";"57";"U";"1115";"404";"725";"909";"206";"2";"4";"903";"907"
"8";"Barcelona";"1";"Barcelona";"13";"Barcelonès";"08019";"Barcelona";"7";"58";"U";"1079";"413";"700";"975";"104";"1";"5";"969";"974"
"8";"Barcelona";"1";"Barcelona";"13";"Barcelonès";"08019";"Barcelona";"7";"59";"U";"987";"331";"540";"665";"322";"1";"7";"657";"664"
"8";"Barcelona";"1";"Barcelona";"13";"Barcelonès";"08019";"Barcelona";"7";"6";"U";"771";"272";"530";"636";"135";"1";"4";"631";"635"
"8";"Barcelona";"1";"Barcelona";"13";"Barcelonès";"08019";"Barcelona";"7";"60";"A";"752";"303";"420";"515";"237";"1";"2";"512";"514"
"8";"Barcelona";"1";"Barcelona";"13";"Barcelonès";"08019";"Barcelona";"7";"60";"B";"622";"228";"361";"427";"195";"0";"0";"427";"427"
"8";"Barcelona";"1";"Barcelona";"13";"Barcelonès";"08019";"Barcelona";"7";"61";"U";"965";"378";"587";"747";"218";"1";"3";"743";"746"
"8";"Barcelona";"1";"Barcelona";"13";"Barcelonès";"08019";"Barcelona";"7";"62";"U";"927";"290";"568";"716";"211";"4";"4";"708";"712"
"8";"Barcelona";"1";"Barcelona";"13";"Barcelonès";"08019";"Barcelona";"7";"63";"U";"1102";"302";"574";"744";"358";"10";"6";"728";"734"
"8";"Barcelona";"1";"Barcelona";"13";"Barcelonès";"08019";"Barcelona";"7";"64";"A";"643";"210";"374";"450";"193";"2";"2";"446";"448"
"8";"Barcelona";"1";"Barcelona";"13";"Barcelonès";"08019";"Barcelona";"7";"64";"B";"573";"193";"312";"390";"183";"1";"0";"389";"389"
"8";"Barcelona";"1";"Barcelona";"13";"Barcelonès";"08019";"Barcelona";"7";"65";"A";"576";"192";"308";"383";"193";"0";"0";"383";"383"
"8";"Barcelona";"1";"Barcelona";"13";"Barcelonès";"08019";"Barcelona";"7";"65";"B";"596";"189";"330";"401";"195";"5";"5";"391";"396"
"8";"Barcelona";"1";"Barcelona";"13";"Barcelonès";"08019";"Barcelona";"7";"66";"A";"648";"234";"379";"460";"188";"0";"1";"459";"460"
"8";"Barcelona";"1";"Barcelona";"13";"Barcelonès";"08019";"Barcelona";"7";"66";"B";"617";"206";"339";"430";"187";"1";"1";"428";"429"
"8";"Barcelona";"1";"Barcelona";"13";"Barcelonès";"08019";"Barcelona";"7";"67";"U";"1058";"387";"614";"743";"315";"2";"7";"734";"741"
"8";"Barcelona";"1";"Barcelona";"13";"Barcelonès";"08019";"Barcelona";"7";"68";"U";"868";"270";"498";"615";"253";"4";"3";"608";"611"
"8";"Barcelona";"1";"Barcelona";"13";"Barcelonès";"08019";"Barcelona";"7";"69";"U";"1051";"330";"655";"760";"291";"5";"6";"749";"755"
"8";"Barcelona";"1";"Barcelona";"13";"Barcelonès";"08019";"Barcelona";"7";"7";"U";"1109";"380";"643";"803";"306";"2";"4";"797";"801"
"8";"Barcelona";"1";"Barcelona";"13";"Barcelonès";"08019";"Barcelona";"7";"70";"U";"1008";"268";"608";"739";"269";"0";"5";"734";"739"
"8";"Barcelona";"1";"Barcelona";"13";"Barcelonès";"08019";"Barcelona";"7";"71";"U";"1073";"334";"669";"831";"242";"4";"6";"821";"827"
"8";"Barcelona";"1";"Barcelona";"13";"Barcelonès";"08019";"Barcelona";"7";"72";"U";"1032";"308";"579";"748";"284";"1";"5";"742";"747"
"8";"Barcelona";"1";"Barcelona";"13";"Barcelonès";"08019";"Barcelona";"7";"73";"U";"813";"223";"473";"619";"194";"3";"0";"616";"616"
"8";"Barcelona";"1";"Barcelona";"13";"Barcelonès";"08019";"Barcelona";"7";"74";"A";"671";"194";"382";"496";"175";"1";"0";"495";"495"
"8";"Barcelona";"1";"Barcelona";"13";"Barcelonès";"08019";"Barcelona";"7";"74";"B";"600";"172";"321";"435";"165";"0";"3";"432";"435"
"8";"Barcelona";"1";"Barcelona";"13";"Barcelonès";"08019";"Barcelona";"7";"75";"U";"923";"271";"566";"668";"255";"1";"1";"666";"667"
"8";"Barcelona";"1";"Barcelona";"13";"Barcelonès";"08019";"Barcelona";"7";"76";"U";"983";"314";"599";"735";"248";"2";"7";"726";"733"
"8";"Barcelona";"1";"Barcelona";"13";"Barcelonès";"08019";"Barcelona";"7";"77";"U";"942";"273";"539";"652";"290";"3";"0";"649";"649"
"8";"Barcelona";"1";"Barcelona";"13";"Barcelonès";"08019";"Barcelona";"7";"78";"U";"957";"291";"560";"702";"255";"4";"3";"695";"698"
"8";"Barcelona";"1";"Barcelona";"13";"Barcelonès";"08019";"Barcelona";"7";"79";"U";"1085";"300";"638";"792";"293";"2";"3";"787";"790"
"8";"Barcelona";"1";"Barcelona";"13";"Barcelonès";"08019";"Barcelona";"7";"8";"U";"1112";"374";"735";"907";"205";"2";"7";"898";"905"
"8";"Barcelona";"1";"Barcelona";"13";"Barcelonès";"08019";"Barcelona";"7";"80";"A";"672";"196";"414";"512";"160";"3";"3";"506";"509"
"8";"Barcelona";"1";"Barcelona";"13";"Barcelonès";"08019";"Barcelona";"7";"80";"B";"621";"175";"367";"463";"158";"4";"1";"458";"459"
"8";"Barcelona";"1";"Barcelona";"13";"Barcelonès";"08019";"Barcelona";"7";"81";"A";"784";"238";"462";"611";"173";"0";"0";"611";"611"
"8";"Barcelona";"1";"Barcelona";"13";"Barcelonès";"08019";"Barcelona";"7";"81";"B";"747";"224";"454";"568";"179";"1";"3";"564";"567"
"8";"Barcelona";"1";"Barcelona";"13";"Barcelonès";"08019";"Barcelona";"7";"82";"U";"962";"295";"538";"672";"290";"4";"1";"667";"668"
"8";"Barcelona";"1";"Barcelona";"13";"Barcelonès";"08019";"Barcelona";"7";"83";"U";"966";"347";"584";"708";"258";"2";"2";"704";"706"
"8";"Barcelona";"1";"Barcelona";"13";"Barcelonès";"08019";"Barcelona";"7";"84";"U";"961";"287";"522";"667";"294";"4";"0";"663";"663"
"8";"Barcelona";"1";"Barcelona";"13";"Barcelonès";"08019";"Barcelona";"7";"85";"U";"984";"264";"580";"710";"274";"3";"6";"701";"707"
"8";"Barcelona";"1";"Barcelona";"13";"Barcelonès";"08019";"Barcelona";"7";"86";"U";"1058";"275";"602";"755";"303";"3";"0";"752";"752"
"8";"Barcelona";"1";"Barcelona";"13";"Barcelonès";"08019";"Barcelona";"7";"87";"U";"1172";"376";"696";"874";"298";"2";"3";"869";"872"
"8";"Barcelona";"1";"Barcelona";"13";"Barcelonès";"08019";"Barcelona";"7";"88";"U";"871";"285";"533";"653";"218";"1";"4";"648";"652"
"8";"Barcelona";"1";"Barcelona";"13";"Barcelonès";"08019";"Barcelona";"7";"89";"U";"983";"328";"611";"775";"208";"1";"3";"771";"774"
"8";"Barcelona";"1";"Barcelona";"13";"Barcelonès";"08019";"Barcelona";"7";"9";"U";"889";"295";"582";"688";"201";"4";"3";"681";"684"
"8";"Barcelona";"1";"Barcelona";"13";"Barcelonès";"08019";"Barcelona";"7";"90";"U";"1117";"306";"607";"761";"356";"1";"5";"755";"760"
"8";"Barcelona";"1";"Barcelona";"13";"Barcelonès";"08019";"Barcelona";"7";"91";"U";"843";"273";"497";"610";"233";"0";"2";"608";"610"
"8";"Barcelona";"1";"Barcelona";"13";"Barcelonès";"08019";"Barcelona";"7";"92";"U";"992";"304";"560";"666";"326";"1";"2";"663";"665"
"8";"Barcelona";"1";"Barcelona";"13";"Barcelonès";"08019";"Barcelona";"7";"93";"A";"627";"190";"374";"468";"159";"0";"5";"463";"468"
"8";"Barcelona";"1";"Barcelona";"13";"Barcelonès";"08019";"Barcelona";"7";"93";"B";"598";"190";"379";"455";"143";"5";"5";"445";"450"
"8";"Barcelona";"1";"Barcelona";"13";"Barcelonès";"08019";"Barcelona";"7";"94";"U";"954";"255";"639";"669";"285";"3";"5";"661";"666"
"8";"Barcelona";"1";"Barcelona";"13";"Barcelonès";"08019";"Barcelona";"7";"95";"U";"1186";"304";"704";"924";"262";"4";"8";"912";"920"
"8";"Barcelona";"1";"Barcelona";"13";"Barcelonès";"08019";"Barcelona";"7";"96";"U";"1052";"315";"642";"802";"250";"4";"1";"797";"798"
"8";"Barcelona";"1";"Barcelona";"13";"Barcelonès";"08019";"Barcelona";"7";"97";"U";"741";"211";"381";"465";"276";"7";"2";"456";"458"
"8";"Barcelona";"1";"Barcelona";"13";"Barcelonès";"08019";"Barcelona";"7";"98";"A";"794";"280";"520";"657";"137";"0";"1";"656";"657"
"8";"Barcelona";"1";"Barcelona";"13";"Barcelonès";"08019";"Barcelona";"7";"98";"B";"705";"257";"485";"600";"105";"1";"3";"596";"599"
"8";"Barcelona";"1";"Barcelona";"13";"Barcelonès";"08019";"Barcelona";"7";"99";"U";"893";"336";"623";"766";"127";"2";"8";"756";"764"
"8";"Barcelona";"1";"Barcelona";"13";"Barcelonès";"08019";"Barcelona";"8";"1";"U";"1027";"331";"616";"784";"243";"3";"2";"779";"781"
"8";"Barcelona";"1";"Barcelona";"13";"Barcelonès";"08019";"Barcelona";"8";"10";"U";"871";"305";"576";"691";"180";"2";"1";"688";"689"
"8";"Barcelona";"1";"Barcelona";"13";"Barcelonès";"08019";"Barcelona";"8";"100";"U";"911";"284";"543";"682";"229";"3";"5";"674";"679"
"8";"Barcelona";"1";"Barcelona";"13";"Barcelonès";"08019";"Barcelona";"8";"101";"A";"680";"257";"434";"532";"148";"3";"2";"527";"529"
"8";"Barcelona";"1";"Barcelona";"13";"Barcelonès";"08019";"Barcelona";"8";"101";"B";"616";"199";"346";"451";"165";"0";"3";"448";"451"
"8";"Barcelona";"1";"Barcelona";"13";"Barcelonès";"08019";"Barcelona";"8";"102";"U";"1009";"345";"622";"719";"290";"0";"5";"714";"719"
"8";"Barcelona";"1";"Barcelona";"13";"Barcelonès";"08019";"Barcelona";"8";"103";"U";"946";"221";"413";"527";"419";"0";"4";"523";"527"
"8";"Barcelona";"1";"Barcelona";"13";"Barcelonès";"08019";"Barcelona";"8";"104";"U";"876";"243";"414";"519";"357";"2";"3";"514";"517"
"8";"Barcelona";"1";"Barcelona";"13";"Barcelonès";"08019";"Barcelona";"8";"105";"U";"1110";"314";"602";"732";"378";"2";"3";"727";"730"
"8";"Barcelona";"1";"Barcelona";"13";"Barcelonès";"08019";"Barcelona";"8";"106";"U";"797";"268";"428";"488";"309";"1";"1";"486";"487"
"8";"Barcelona";"1";"Barcelona";"13";"Barcelonès";"08019";"Barcelona";"8";"107";"A";"684";"204";"345";"398";"286";"2";"1";"395";"396"
"8";"Barcelona";"1";"Barcelona";"13";"Barcelonès";"08019";"Barcelona";"8";"107";"B";"649";"203";"304";"369";"280";"1";"1";"367";"368"
"8";"Barcelona";"1";"Barcelona";"13";"Barcelonès";"08019";"Barcelona";"8";"108";"U";"1079";"309";"545";"642";"437";"0";"5";"637";"642"
"8";"Barcelona";"1";"Barcelona";"13";"Barcelonès";"08019";"Barcelona";"8";"109";"U";"735";"234";"373";"425";"310";"0";"2";"423";"425"
"8";"Barcelona";"1";"Barcelona";"13";"Barcelonès";"08019";"Barcelona";"8";"11";"U";"913";"335";"615";"751";"162";"5";"1";"745";"746"
"8";"Barcelona";"1";"Barcelona";"13";"Barcelonès";"08019";"Barcelona";"8";"110";"U";"1033";"237";"441";"579";"454";"5";"3";"571";"574"
"8";"Barcelona";"1";"Barcelona";"13";"Barcelonès";"08019";"Barcelona";"8";"111";"U";"953";"238";"464";"609";"344";"6";"6";"597";"603"
"8";"Barcelona";"1";"Barcelona";"13";"Barcelonès";"08019";"Barcelona";"8";"112";"U";"918";"281";"493";"594";"324";"4";"6";"584";"590"
"8";"Barcelona";"1";"Barcelona";"13";"Barcelonès";"08019";"Barcelona";"8";"113";"U";"1015";"190";"488";"648";"367";"7";"2";"639";"641"
"8";"Barcelona";"1";"Barcelona";"13";"Barcelonès";"08019";"Barcelona";"8";"114";"U";"1176";"307";"620";"781";"395";"4";"13";"764";"777"
"8";"Barcelona";"1";"Barcelona";"13";"Barcelonès";"08019";"Barcelona";"8";"115";"U";"952";"304";"530";"640";"312";"3";"0";"637";"637"
"8";"Barcelona";"1";"Barcelona";"13";"Barcelonès";"08019";"Barcelona";"8";"116";"U";"915";"266";"470";"552";"363";"1";"7";"544";"551"
"8";"Barcelona";"1";"Barcelona";"13";"Barcelonès";"08019";"Barcelona";"8";"12";"U";"988";"340";"610";"746";"242";"2";"3";"741";"744"
"8";"Barcelona";"1";"Barcelona";"13";"Barcelonès";"08019";"Barcelona";"8";"13";"U";"884";"325";"608";"727";"157";"7";"1";"719";"720"
"8";"Barcelona";"1";"Barcelona";"13";"Barcelonès";"08019";"Barcelona";"8";"14";"U";"876";"250";"565";"691";"185";"1";"0";"690";"690"
"8";"Barcelona";"1";"Barcelona";"13";"Barcelonès";"08019";"Barcelona";"8";"15";"U";"979";"277";"581";"723";"256";"2";"2";"719";"721"
"8";"Barcelona";"1";"Barcelona";"13";"Barcelonès";"08019";"Barcelona";"8";"16";"U";"876";"267";"538";"661";"215";"0";"4";"657";"661"
"8";"Barcelona";"1";"Barcelona";"13";"Barcelonès";"08019";"Barcelona";"8";"17";"U";"1089";"305";"685";"851";"238";"3";"0";"848";"848"
"8";"Barcelona";"1";"Barcelona";"13";"Barcelonès";"08019";"Barcelona";"8";"18";"U";"1185";"340";"740";"902";"283";"1";"7";"894";"901"
"8";"Barcelona";"1";"Barcelona";"13";"Barcelonès";"08019";"Barcelona";"8";"19";"A";"641";"210";"376";"489";"152";"1";"3";"485";"488"
"8";"Barcelona";"1";"Barcelona";"13";"Barcelonès";"08019";"Barcelona";"8";"19";"B";"607";"192";"350";"439";"168";"1";"1";"437";"438"
"8";"Barcelona";"1";"Barcelona";"13";"Barcelonès";"08019";"Barcelona";"8";"2";"U";"986";"355";"654";"774";"212";"1";"2";"771";"773"
"8";"Barcelona";"1";"Barcelona";"13";"Barcelonès";"08019";"Barcelona";"8";"20";"U";"970";"253";"592";"737";"233";"3";"3";"731";"734"
"8";"Barcelona";"1";"Barcelona";"13";"Barcelonès";"08019";"Barcelona";"8";"21";"U";"1066";"370";"671";"825";"241";"0";"4";"821";"825"
"8";"Barcelona";"1";"Barcelona";"13";"Barcelonès";"08019";"Barcelona";"8";"215";"U";"1052";"296";"638";"779";"273";"1";"0";"778";"778"
"8";"Barcelona";"1";"Barcelona";"13";"Barcelonès";"08019";"Barcelona";"8";"22";"U";"982";"339";"603";"788";"194";"2";"3";"783";"786"
"8";"Barcelona";"1";"Barcelona";"13";"Barcelonès";"08019";"Barcelona";"8";"23";"U";"997";"277";"608";"735";"262";"3";"4";"728";"732"
"8";"Barcelona";"1";"Barcelona";"13";"Barcelonès";"08019";"Barcelona";"8";"24";"U";"1028";"275";"626";"781";"247";"0";"3";"778";"781"
"8";"Barcelona";"1";"Barcelona";"13";"Barcelonès";"08019";"Barcelona";"8";"25";"U";"837";"283";"635";"642";"195";"4";"0";"638";"638"
"8";"Barcelona";"1";"Barcelona";"13";"Barcelonès";"08019";"Barcelona";"8";"26";"U";"993";"296";"613";"746";"247";"2";"6";"738";"744"
"8";"Barcelona";"1";"Barcelona";"13";"Barcelonès";"08019";"Barcelona";"8";"27";"U";"1015";"299";"629";"797";"218";"1";"3";"793";"796"
"8";"Barcelona";"1";"Barcelona";"13";"Barcelonès";"08019";"Barcelona";"8";"28";"U";"883";"311";"601";"656";"227";"1";"1";"654";"655"
"8";"Barcelona";"1";"Barcelona";"13";"Barcelonès";"08019";"Barcelona";"8";"29";"U";"1123";"297";"652";"769";"354";"1";"1";"767";"768"
"8";"Barcelona";"1";"Barcelona";"13";"Barcelonès";"08019";"Barcelona";"8";"3";"U";"977";"320";"631";"782";"195";"1";"8";"773";"781"
"8";"Barcelona";"1";"Barcelona";"13";"Barcelonès";"08019";"Barcelona";"8";"30";"U";"1019";"283";"627";"784";"235";"2";"3";"779";"782"
"8";"Barcelona";"1";"Barcelona";"13";"Barcelonès";"08019";"Barcelona";"8";"31";"U";"996";"382";"696";"789";"207";"5";"1";"783";"784"
"8";"Barcelona";"1";"Barcelona";"13";"Barcelonès";"08019";"Barcelona";"8";"32";"U";"1013";"303";"703";"799";"214";"3";"5";"791";"796"
"8";"Barcelona";"1";"Barcelona";"13";"Barcelonès";"08019";"Barcelona";"8";"33";"U";"1029";"332";"599";"721";"308";"3";"3";"715";"718"
"8";"Barcelona";"1";"Barcelona";"13";"Barcelonès";"08019";"Barcelona";"8";"34";"U";"874";"306";"500";"591";"283";"4";"5";"582";"587"
"8";"Barcelona";"1";"Barcelona";"13";"Barcelonès";"08019";"Barcelona";"8";"35";"U";"1209";"384";"660";"811";"398";"2";"0";"809";"809"
"8";"Barcelona";"1";"Barcelona";"13";"Barcelonès";"08019";"Barcelona";"8";"36";"U";"1054";"324";"586";"710";"344";"1";"6";"703";"709"
"8";"Barcelona";"1";"Barcelona";"13";"Barcelonès";"08019";"Barcelona";"8";"37";"U";"1092";"350";"670";"820";"272";"8";"4";"808";"812"
"8";"Barcelona";"1";"Barcelona";"13";"Barcelonès";"08019";"Barcelona";"8";"38";"U";"1032";"402";"664";"723";"309";"0";"0";"723";"723"
"8";"Barcelona";"1";"Barcelona";"13";"Barcelonès";"08019";"Barcelona";"8";"39";"U";"1050";"302";"670";"786";"264";"4";"4";"778";"782"
"8";"Barcelona";"1";"Barcelona";"13";"Barcelonès";"08019";"Barcelona";"8";"4";"U";"1043";"330";"657";"814";"229";"1";"1";"812";"813"
"8";"Barcelona";"1";"Barcelona";"13";"Barcelonès";"08019";"Barcelona";"8";"40";"U";"1132";"324";"581";"715";"417";"1";"3";"711";"714"
"8";"Barcelona";"1";"Barcelona";"13";"Barcelonès";"08019";"Barcelona";"8";"41";"U";"1326";"357";"633";"767";"559";"6";"2";"759";"761"
"8";"Barcelona";"1";"Barcelona";"13";"Barcelonès";"08019";"Barcelona";"8";"42";"U";"1006";"273";"652";"811";"195";"2";"3";"806";"809"
"8";"Barcelona";"1";"Barcelona";"13";"Barcelonès";"08019";"Barcelona";"8";"43";"U";"931";"297";"551";"659";"272";"3";"4";"652";"656"
"8";"Barcelona";"1";"Barcelona";"13";"Barcelonès";"08019";"Barcelona";"8";"44";"U";"947";"290";"529";"625";"322";"1";"6";"618";"624"
"8";"Barcelona";"1";"Barcelona";"13";"Barcelonès";"08019";"Barcelona";"8";"45";"U";"1115";"278";"602";"718";"397";"1";"2";"715";"717"
"8";"Barcelona";"1";"Barcelona";"13";"Barcelonès";"08019";"Barcelona";"8";"46";"U";"1010";"270";"550";"666";"344";"1";"5";"660";"665"
"8";"Barcelona";"1";"Barcelona";"13";"Barcelonès";"08019";"Barcelona";"8";"47";"U";"959";"250";"481";"602";"357";"2";"0";"600";"600"
"8";"Barcelona";"1";"Barcelona";"13";"Barcelonès";"08019";"Barcelona";"8";"48";"U";"813";"217";"385";"468";"345";"2";"0";"466";"466"
"8";"Barcelona";"1";"Barcelona";"13";"Barcelonès";"08019";"Barcelona";"8";"49";"U";"957";"278";"522";"637";"320";"3";"0";"634";"634"
"8";"Barcelona";"1";"Barcelona";"13";"Barcelonès";"08019";"Barcelona";"8";"5";"U";"891";"301";"570";"699";"192";"0";"0";"699";"699"
"8";"Barcelona";"1";"Barcelona";"13";"Barcelonès";"08019";"Barcelona";"8";"50";"U";"1188";"365";"755";"944";"244";"4";"3";"937";"940"
"8";"Barcelona";"1";"Barcelona";"13";"Barcelonès";"08019";"Barcelona";"8";"51";"U";"988";"254";"593";"782";"206";"10";"3";"769";"772"
"8";"Barcelona";"1";"Barcelona";"13";"Barcelonès";"08019";"Barcelona";"8";"52";"U";"717";"239";"473";"576";"141";"4";"3";"569";"572"
"8";"Barcelona";"1";"Barcelona";"13";"Barcelonès";"08019";"Barcelona";"8";"53";"U";"875";"319";"562";"714";"161";"3";"4";"707";"711"
"8";"Barcelona";"1";"Barcelona";"13";"Barcelonès";"08019";"Barcelona";"8";"54";"A";"700";"273";"492";"570";"130";"2";"1";"567";"568"
"8";"Barcelona";"1";"Barcelona";"13";"Barcelonès";"08019";"Barcelona";"8";"54";"B";"652";"233";"435";"514";"138";"4";"4";"506";"510"
"8";"Barcelona";"1";"Barcelona";"13";"Barcelonès";"08019";"Barcelona";"8";"55";"A";"797";"298";"531";"672";"125";"2";"3";"667";"670"
"8";"Barcelona";"1";"Barcelona";"13";"Barcelonès";"08019";"Barcelona";"8";"55";"B";"752";"278";"517";"637";"115";"0";"4";"633";"637"
"8";"Barcelona";"1";"Barcelona";"13";"Barcelonès";"08019";"Barcelona";"8";"56";"U";"1157";"365";"734";"896";"261";"5";"4";"887";"891"
"8";"Barcelona";"1";"Barcelona";"13";"Barcelonès";"08019";"Barcelona";"8";"57";"U";"1039";"250";"624";"758";"281";"3";"2";"753";"755"
"8";"Barcelona";"1";"Barcelona";"13";"Barcelonès";"08019";"Barcelona";"8";"58";"A";"707";"116";"444";"525";"182";"1";"4";"520";"524"
"8";"Barcelona";"1";"Barcelona";"13";"Barcelonès";"08019";"Barcelona";"8";"58";"B";"549";"180";"340";"410";"139";"2";"1";"407";"408"
"8";"Barcelona";"1";"Barcelona";"13";"Barcelonès";"08019";"Barcelona";"8";"59";"U";"798";"245";"492";"594";"204";"0";"5";"589";"594"
"8";"Barcelona";"1";"Barcelona";"13";"Barcelonès";"08019";"Barcelona";"8";"6";"U";"1070";"339";"715";"863";"207";"1";"5";"857";"862"
"8";"Barcelona";"1";"Barcelona";"13";"Barcelonès";"08019";"Barcelona";"8";"60";"U";"1015";"317";"625";"791";"224";"1";"5";"785";"790"
"8";"Barcelona";"1";"Barcelona";"13";"Barcelonès";"08019";"Barcelona";"8";"61";"A";"712";"259";"455";"545";"167";"2";"3";"540";"543"
"8";"Barcelona";"1";"Barcelona";"13";"Barcelonès";"08019";"Barcelona";"8";"61";"B";"616";"236";"415";"490";"126";"0";"2";"488";"490"
"8";"Barcelona";"1";"Barcelona";"13";"Barcelonès";"08019";"Barcelona";"8";"62";"U";"1026";"337";"690";"852";"174";"1";"10";"841";"851"
"8";"Barcelona";"1";"Barcelona";"13";"Barcelonès";"08019";"Barcelona";"8";"63";"U";"972";"304";"650";"804";"168";"1";"0";"803";"803"
"8";"Barcelona";"1";"Barcelona";"13";"Barcelonès";"08019";"Barcelona";"8";"64";"A";"739";"209";"419";"521";"218";"3";"2";"516";"518"
"8";"Barcelona";"1";"Barcelona";"13";"Barcelonès";"08019";"Barcelona";"8";"64";"B";"647";"221";"432";"493";"154";"4";"3";"486";"489"
"8";"Barcelona";"1";"Barcelona";"13";"Barcelonès";"08019";"Barcelona";"8";"65";"U";"1126";"312";"587";"707";"419";"2";"3";"702";"705"
"8";"Barcelona";"1";"Barcelona";"13";"Barcelonès";"08019";"Barcelona";"8";"66";"U";"1017";"291";"513";"647";"370";"6";"3";"638";"641"
"8";"Barcelona";"1";"Barcelona";"13";"Barcelonès";"08019";"Barcelona";"8";"67";"U";"1131";"283";"618";"819";"312";"4";"11";"804";"815"
"8";"Barcelona";"1";"Barcelona";"13";"Barcelonès";"08019";"Barcelona";"8";"68";"U";"1219";"355";"646";"805";"414";"3";"4";"798";"802"
"8";"Barcelona";"1";"Barcelona";"13";"Barcelonès";"08019";"Barcelona";"8";"69";"U";"1001";"272";"510";"670";"331";"1";"3";"666";"669"
"8";"Barcelona";"1";"Barcelona";"13";"Barcelonès";"08019";"Barcelona";"8";"7";"U";"972";"369";"653";"784";"188";"6";"4";"774";"778"
"8";"Barcelona";"1";"Barcelona";"13";"Barcelonès";"08019";"Barcelona";"8";"70";"U";"898";"257";"510";"603";"295";"2";"4";"597";"601"
"8";"Barcelona";"1";"Barcelona";"13";"Barcelonès";"08019";"Barcelona";"8";"71";"U";"1132";"320";"610";"777";"355";"4";"1";"772";"773"
"8";"Barcelona";"1";"Barcelona";"13";"Barcelonès";"08019";"Barcelona";"8";"72";"U";"836";"297";"533";"652";"184";"3";"3";"646";"649"
"8";"Barcelona";"1";"Barcelona";"13";"Barcelonès";"08019";"Barcelona";"8";"73";"U";"1102";"259";"504";"629";"473";"4";"4";"621";"625"
"8";"Barcelona";"1";"Barcelona";"13";"Barcelonès";"08019";"Barcelona";"8";"74";"U";"903";"269";"476";"595";"308";"2";"1";"592";"593"
"8";"Barcelona";"1";"Barcelona";"13";"Barcelonès";"08019";"Barcelona";"8";"75";"A";"691";"213";"408";"503";"188";"3";"2";"498";"500"
"8";"Barcelona";"1";"Barcelona";"13";"Barcelonès";"08019";"Barcelona";"8";"75";"B";"606";"229";"382";"458";"148";"1";"3";"454";"457"
"8";"Barcelona";"1";"Barcelona";"13";"Barcelonès";"08019";"Barcelona";"8";"76";"U";"1145";"293";"691";"852";"293";"1";"5";"846";"851"
"8";"Barcelona";"1";"Barcelona";"13";"Barcelonès";"08019";"Barcelona";"8";"77";"U";"1084";"247";"503";"622";"462";"1";"3";"618";"621"
"8";"Barcelona";"1";"Barcelona";"13";"Barcelonès";"08019";"Barcelona";"8";"78";"U";"1062";"303";"590";"710";"352";"0";"3";"707";"710"
"8";"Barcelona";"1";"Barcelona";"13";"Barcelonès";"08019";"Barcelona";"8";"79";"U";"913";"320";"487";"588";"325";"1";"0";"587";"587"
"8";"Barcelona";"1";"Barcelona";"13";"Barcelonès";"08019";"Barcelona";"8";"8";"A";"677";"231";"428";"545";"132";"2";"1";"542";"543"
"8";"Barcelona";"1";"Barcelona";"13";"Barcelonès";"08019";"Barcelona";"8";"8";"B";"537";"197";"343";"410";"127";"0";"0";"410";"410"
"8";"Barcelona";"1";"Barcelona";"13";"Barcelonès";"08019";"Barcelona";"8";"80";"U";"1051";"250";"576";"749";"302";"2";"5";"742";"747"
"8";"Barcelona";"1";"Barcelona";"13";"Barcelonès";"08019";"Barcelona";"8";"81";"U";"965";"270";"531";"680";"285";"3";"5";"672";"677"
"8";"Barcelona";"1";"Barcelona";"13";"Barcelonès";"08019";"Barcelona";"8";"82";"U";"1131";"332";"655";"829";"302";"9";"7";"813";"820"
"8";"Barcelona";"1";"Barcelona";"13";"Barcelonès";"08019";"Barcelona";"8";"83";"U";"890";"367";"638";"658";"232";"2";"3";"653";"656"
"8";"Barcelona";"1";"Barcelona";"13";"Barcelonès";"08019";"Barcelona";"8";"84";"U";"850";"276";"505";"626";"224";"2";"4";"620";"624"
"8";"Barcelona";"1";"Barcelona";"13";"Barcelonès";"08019";"Barcelona";"8";"85";"U";"1002";"310";"583";"748";"254";"4";"7";"737";"744"
"8";"Barcelona";"1";"Barcelona";"13";"Barcelonès";"08019";"Barcelona";"8";"86";"U";"1182";"325";"673";"858";"324";"2";"4";"852";"856"
"8";"Barcelona";"1";"Barcelona";"13";"Barcelonès";"08019";"Barcelona";"8";"87";"U";"936";"339";"558";"683";"253";"0";"3";"680";"683"
"8";"Barcelona";"1";"Barcelona";"13";"Barcelonès";"08019";"Barcelona";"8";"88";"U";"908";"299";"540";"648";"260";"2";"3";"643";"646"
"8";"Barcelona";"1";"Barcelona";"13";"Barcelonès";"08019";"Barcelona";"8";"89";"U";"909";"304";"560";"636";"273";"1";"4";"631";"635"
"8";"Barcelona";"1";"Barcelona";"13";"Barcelonès";"08019";"Barcelona";"8";"9";"A";"630";"211";"390";"479";"151";"3";"4";"472";"476"
"8";"Barcelona";"1";"Barcelona";"13";"Barcelonès";"08019";"Barcelona";"8";"9";"B";"590";"173";"348";"432";"158";"2";"2";"428";"430"
"8";"Barcelona";"1";"Barcelona";"13";"Barcelonès";"08019";"Barcelona";"8";"90";"U";"915";"246";"546";"681";"234";"3";"1";"677";"678"
"8";"Barcelona";"1";"Barcelona";"13";"Barcelonès";"08019";"Barcelona";"8";"91";"U";"909";"338";"590";"705";"204";"3";"5";"697";"702"
"8";"Barcelona";"1";"Barcelona";"13";"Barcelonès";"08019";"Barcelona";"8";"92";"U";"789";"302";"525";"657";"132";"2";"3";"652";"655"
"8";"Barcelona";"1";"Barcelona";"13";"Barcelonès";"08019";"Barcelona";"8";"93";"U";"942";"382";"615";"697";"245";"0";"2";"695";"697"
"8";"Barcelona";"1";"Barcelona";"13";"Barcelonès";"08019";"Barcelona";"8";"94";"U";"1202";"301";"732";"941";"261";"5";"2";"934";"936"
"8";"Barcelona";"1";"Barcelona";"13";"Barcelonès";"08019";"Barcelona";"8";"95";"U";"874";"255";"539";"703";"171";"7";"4";"692";"696"
"8";"Barcelona";"1";"Barcelona";"13";"Barcelonès";"08019";"Barcelona";"8";"96";"U";"1056";"315";"605";"770";"286";"3";"5";"762";"767"
"8";"Barcelona";"1";"Barcelona";"13";"Barcelonès";"08019";"Barcelona";"8";"97";"U";"972";"243";"557";"705";"267";"1";"1";"703";"704"
"8";"Barcelona";"1";"Barcelona";"13";"Barcelonès";"08019";"Barcelona";"8";"98";"U";"885";"263";"505";"632";"253";"2";"2";"628";"630"
"8";"Barcelona";"1";"Barcelona";"13";"Barcelonès";"08019";"Barcelona";"8";"99";"U";"977";"277";"539";"703";"274";"10";"5";"688";"693"
"8";"Barcelona";"1";"Barcelona";"13";"Barcelonès";"08019";"Barcelona";"9";"1";"A";"702";"180";"330";"421";"281";"3";"1";"417";"418"
"8";"Barcelona";"1";"Barcelona";"13";"Barcelonès";"08019";"Barcelona";"9";"1";"B";"585";"143";"276";"353";"232";"0";"1";"352";"353"
"8";"Barcelona";"1";"Barcelona";"13";"Barcelonès";"08019";"Barcelona";"9";"10";"A";"790";"271";"477";"592";"198";"1";"4";"587";"591"
"8";"Barcelona";"1";"Barcelona";"13";"Barcelonès";"08019";"Barcelona";"9";"10";"B";"684";"269";"449";"541";"143";"0";"0";"541";"541"
"8";"Barcelona";"1";"Barcelona";"13";"Barcelonès";"08019";"Barcelona";"9";"11";"A";"710";"205";"366";"456";"254";"2";"0";"454";"454"
"8";"Barcelona";"1";"Barcelona";"13";"Barcelonès";"08019";"Barcelona";"9";"11";"B";"622";"203";"341";"411";"211";"3";"0";"408";"408"
"8";"Barcelona";"1";"Barcelona";"13";"Barcelonès";"08019";"Barcelona";"9";"13";"A";"615";"174";"283";"354";"261";"2";"2";"350";"352"
"8";"Barcelona";"1";"Barcelona";"13";"Barcelonès";"08019";"Barcelona";"9";"13";"B";"600";"199";"318";"400";"200";"3";"3";"394";"397"
"8";"Barcelona";"1";"Barcelona";"13";"Barcelonès";"08019";"Barcelona";"9";"14";"U";"1244";"327";"624";"746";"498";"0";"2";"744";"746"
"8";"Barcelona";"1";"Barcelona";"13";"Barcelonès";"08019";"Barcelona";"9";"15";"A";"673";"197";"385";"471";"202";"3";"2";"466";"468"
"8";"Barcelona";"1";"Barcelona";"13";"Barcelonès";"08019";"Barcelona";"9";"15";"B";"570";"196";"357";"414";"156";"2";"6";"406";"412"
"8";"Barcelona";"1";"Barcelona";"13";"Barcelonès";"08019";"Barcelona";"9";"156";"U";"1000";"298";"653";"799";"201";"2";"3";"794";"797"
"8";"Barcelona";"1";"Barcelona";"13";"Barcelonès";"08019";"Barcelona";"9";"16";"A";"591";"240";"416";"483";"108";"0";"6";"477";"483"
"8";"Barcelona";"1";"Barcelona";"13";"Barcelonès";"08019";"Barcelona";"9";"16";"B";"605";"232";"424";"518";"87";"1";"2";"515";"517"
"8";"Barcelona";"1";"Barcelona";"13";"Barcelonès";"08019";"Barcelona";"9";"17";"U";"1114";"356";"692";"898";"216";"3";"1";"894";"895"
"8";"Barcelona";"1";"Barcelona";"13";"Barcelonès";"08019";"Barcelona";"9";"18";"U";"1183";"438";"767";"949";"234";"3";"4";"942";"946"
"8";"Barcelona";"1";"Barcelona";"13";"Barcelonès";"08019";"Barcelona";"9";"19";"A";"951";"360";"636";"806";"145";"0";"5";"801";"806"
"8";"Barcelona";"1";"Barcelona";"13";"Barcelonès";"08019";"Barcelona";"9";"19";"B";"927";"348";"598";"772";"155";"1";"2";"769";"771"
"8";"Barcelona";"1";"Barcelona";"13";"Barcelonès";"08019";"Barcelona";"9";"2";"U";"1180";"288";"587";"749";"431";"2";"0";"747";"747"
"8";"Barcelona";"1";"Barcelona";"13";"Barcelonès";"08019";"Barcelona";"9";"20";"U";"937";"398";"724";"799";"138";"2";"2";"795";"797"
"8";"Barcelona";"1";"Barcelona";"13";"Barcelonès";"08019";"Barcelona";"9";"21";"U";"1109";"390";"770";"946";"163";"0";"5";"941";"946"
"8";"Barcelona";"1";"Barcelona";"13";"Barcelonès";"08019";"Barcelona";"9";"22";"U";"955";"331";"646";"807";"148";"4";"0";"803";"803"
"8";"Barcelona";"1";"Barcelona";"13";"Barcelonès";"08019";"Barcelona";"9";"23";"U";"946";"284";"660";"810";"136";"1";"5";"804";"809"
"8";"Barcelona";"1";"Barcelona";"13";"Barcelonès";"08019";"Barcelona";"9";"24";"U";"926";"310";"594";"762";"164";"1";"3";"758";"761"
"8";"Barcelona";"1";"Barcelona";"13";"Barcelonès";"08019";"Barcelona";"9";"25";"U";"902";"348";"614";"720";"182";"2";"5";"713";"718"
"8";"Barcelona";"1";"Barcelona";"13";"Barcelonès";"08019";"Barcelona";"9";"26";"A";"642";"218";"428";"533";"109";"0";"3";"530";"533"
"8";"Barcelona";"1";"Barcelona";"13";"Barcelonès";"08019";"Barcelona";"9";"26";"B";"567";"226";"377";"449";"118";"1";"0";"448";"448"
"8";"Barcelona";"1";"Barcelona";"13";"Barcelonès";"08019";"Barcelona";"9";"27";"U";"1168";"329";"763";"967";"201";"3";"2";"962";"964"
"8";"Barcelona";"1";"Barcelona";"13";"Barcelonès";"08019";"Barcelona";"9";"28";"A";"583";"222";"426";"500";"83";"1";"3";"496";"499"
"8";"Barcelona";"1";"Barcelona";"13";"Barcelonès";"08019";"Barcelona";"9";"28";"B";"569";"219";"418";"507";"62";"0";"2";"505";"507"
"8";"Barcelona";"1";"Barcelona";"13";"Barcelonès";"08019";"Barcelona";"9";"29";"U";"921";"288";"634";"766";"155";"0";"2";"764";"766"
"8";"Barcelona";"1";"Barcelona";"13";"Barcelonès";"08019";"Barcelona";"9";"3";"A";"682";"183";"345";"431";"251";"1";"1";"429";"430"
"8";"Barcelona";"1";"Barcelona";"13";"Barcelonès";"08019";"Barcelona";"9";"3";"B";"610";"180";"309";"391";"219";"0";"0";"391";"391"
"8";"Barcelona";"1";"Barcelona";"13";"Barcelonès";"08019";"Barcelona";"9";"30";"U";"1102";"293";"736";"908";"194";"3";"2";"903";"905"
"8";"Barcelona";"1";"Barcelona";"13";"Barcelonès";"08019";"Barcelona";"9";"31";"U";"858";"271";"588";"725";"133";"0";"3";"722";"725"
"8";"Barcelona";"1";"Barcelona";"13";"Barcelonès";"08019";"Barcelona";"9";"32";"A";"734";"204";"428";"534";"200";"2";"4";"528";"532"
"8";"Barcelona";"1";"Barcelona";"13";"Barcelonès";"08019";"Barcelona";"9";"32";"B";"637";"175";"372";"468";"169";"0";"3";"465";"468"
"8";"Barcelona";"1";"Barcelona";"13";"Barcelonès";"08019";"Barcelona";"9";"33";"A";"724";"222";"431";"562";"162";"1";"3";"558";"561"
"8";"Barcelona";"1";"Barcelona";"13";"Barcelonès";"08019";"Barcelona";"9";"33";"B";"958";"328";"601";"752";"206";"3";"2";"747";"749"
"8";"Barcelona";"1";"Barcelona";"13";"Barcelonès";"08019";"Barcelona";"9";"33";"C";"767";"255";"491";"592";"175";"1";"3";"588";"591"
"8";"Barcelona";"1";"Barcelona";"13";"Barcelonès";"08019";"Barcelona";"9";"34";"U";"1109";"370";"707";"901";"208";"4";"2";"895";"897"
"8";"Barcelona";"1";"Barcelona";"13";"Barcelonès";"08019";"Barcelona";"9";"35";"A";"622";"217";"396";"478";"144";"1";"7";"470";"477"
"8";"Barcelona";"1";"Barcelona";"13";"Barcelonès";"08019";"Barcelona";"9";"35";"B";"588";"202";"379";"472";"116";"0";"2";"470";"472"
"8";"Barcelona";"1";"Barcelona";"13";"Barcelonès";"08019";"Barcelona";"9";"36";"U";"1169";"318";"721";"958";"211";"2";"5";"951";"956"
"8";"Barcelona";"1";"Barcelona";"13";"Barcelonès";"08019";"Barcelona";"9";"37";"U";"1101";"315";"763";"830";"271";"1";"5";"824";"829"
"8";"Barcelona";"1";"Barcelona";"13";"Barcelonès";"08019";"Barcelona";"9";"38";"A";"615";"230";"416";"513";"102";"3";"0";"510";"510"
"8";"Barcelona";"1";"Barcelona";"13";"Barcelonès";"08019";"Barcelona";"9";"38";"B";"609";"238";"431";"501";"108";"3";"2";"496";"498"
"8";"Barcelona";"1";"Barcelona";"13";"Barcelonès";"08019";"Barcelona";"9";"39";"A";"639";"242";"433";"530";"109";"0";"2";"528";"530"
"8";"Barcelona";"1";"Barcelona";"13";"Barcelonès";"08019";"Barcelona";"9";"39";"B";"609";"250";"419";"481";"128";"4";"1";"476";"477"
"8";"Barcelona";"1";"Barcelona";"13";"Barcelonès";"08019";"Barcelona";"9";"4";"U";"1042";"313";"562";"696";"346";"3";"3";"690";"693"
"8";"Barcelona";"1";"Barcelona";"13";"Barcelonès";"08019";"Barcelona";"9";"40";"U";"1139";"383";"727";"888";"251";"3";"5";"880";"885"
"8";"Barcelona";"1";"Barcelona";"13";"Barcelonès";"08019";"Barcelona";"9";"41";"U";"1090";"398";"754";"899";"191";"2";"3";"894";"897"
"8";"Barcelona";"1";"Barcelona";"13";"Barcelonès";"08019";"Barcelona";"9";"42";"U";"978";"300";"663";"774";"204";"3";"5";"766";"771"
"8";"Barcelona";"1";"Barcelona";"13";"Barcelonès";"08019";"Barcelona";"9";"43";"U";"1030";"293";"664";"832";"198";"2";"2";"828";"830"
"8";"Barcelona";"1";"Barcelona";"13";"Barcelonès";"08019";"Barcelona";"9";"44";"U";"1159";"392";"791";"951";"208";"8";"7";"936";"943"
"8";"Barcelona";"1";"Barcelona";"13";"Barcelonès";"08019";"Barcelona";"9";"45";"U";"1120";"331";"731";"908";"212";"2";"3";"903";"906"
"8";"Barcelona";"1";"Barcelona";"13";"Barcelonès";"08019";"Barcelona";"9";"46";"U";"1026";"280";"672";"838";"188";"1";"4";"833";"837"
"8";"Barcelona";"1";"Barcelona";"13";"Barcelonès";"08019";"Barcelona";"9";"47";"U";"1165";"363";"770";"948";"217";"3";"5";"940";"945"
"8";"Barcelona";"1";"Barcelona";"13";"Barcelonès";"08019";"Barcelona";"9";"48";"U";"1087";"308";"659";"904";"183";"3";"8";"893";"901"
"8";"Barcelona";"1";"Barcelona";"13";"Barcelonès";"08019";"Barcelona";"9";"49";"U";"978";"312";"642";"778";"200";"1";"5";"772";"777"
"8";"Barcelona";"1";"Barcelona";"13";"Barcelonès";"08019";"Barcelona";"9";"5";"U";"1104";"332";"661";"843";"261";"4";"1";"838";"839"
"8";"Barcelona";"1";"Barcelona";"13";"Barcelonès";"08019";"Barcelona";"9";"50";"A";"644";"200";"440";"528";"116";"0";"1";"527";"528"
"8";"Barcelona";"1";"Barcelona";"13";"Barcelonès";"08019";"Barcelona";"9";"50";"B";"584";"204";"399";"476";"108";"1";"3";"472";"475"
"8";"Barcelona";"1";"Barcelona";"13";"Barcelonès";"08019";"Barcelona";"9";"51";"U";"962";"308";"596";"752";"210";"2";"3";"747";"750"
"8";"Barcelona";"1";"Barcelona";"13";"Barcelonès";"08019";"Barcelona";"9";"52";"U";"930";"380";"654";"765";"165";"3";"2";"760";"762"
"8";"Barcelona";"1";"Barcelona";"13";"Barcelonès";"08019";"Barcelona";"9";"53";"A";"604";"219";"409";"490";"114";"3";"3";"484";"487"
"8";"Barcelona";"1";"Barcelona";"13";"Barcelonès";"08019";"Barcelona";"9";"53";"B";"612";"242";"441";"520";"92";"1";"3";"516";"519"
"8";"Barcelona";"1";"Barcelona";"13";"Barcelonès";"08019";"Barcelona";"9";"54";"U";"908";"300";"584";"723";"185";"3";"6";"714";"720"
"8";"Barcelona";"1";"Barcelona";"13";"Barcelonès";"08019";"Barcelona";"9";"55";"A";"642";"249";"417";"488";"154";"1";"2";"485";"487"
"8";"Barcelona";"1";"Barcelona";"13";"Barcelonès";"08019";"Barcelona";"9";"55";"B";"614";"241";"405";"483";"131";"0";"3";"480";"483"
"8";"Barcelona";"1";"Barcelona";"13";"Barcelonès";"08019";"Barcelona";"9";"56";"U";"963";"312";"592";"756";"207";"1";"3";"752";"755"
"8";"Barcelona";"1";"Barcelona";"13";"Barcelonès";"08019";"Barcelona";"9";"57";"U";"1157";"332";"802";"905";"252";"6";"6";"893";"899"
"8";"Barcelona";"1";"Barcelona";"13";"Barcelonès";"08019";"Barcelona";"9";"58";"U";"1026";"361";"695";"834";"192";"2";"5";"827";"832"
"8";"Barcelona";"1";"Barcelona";"13";"Barcelonès";"08019";"Barcelona";"9";"59";"U";"1042";"360";"713";"841";"201";"3";"4";"834";"838"
"8";"Barcelona";"1";"Barcelona";"13";"Barcelonès";"08019";"Barcelona";"9";"6";"U";"899";"236";"441";"542";"357";"1";"2";"539";"541"
"8";"Barcelona";"1";"Barcelona";"13";"Barcelonès";"08019";"Barcelona";"9";"60";"U";"1042";"341";"666";"839";"203";"5";"3";"831";"834"
"8";"Barcelona";"1";"Barcelona";"13";"Barcelonès";"08019";"Barcelona";"9";"61";"A";"641";"225";"427";"528";"113";"4";"1";"523";"524"
"8";"Barcelona";"1";"Barcelona";"13";"Barcelonès";"08019";"Barcelona";"9";"61";"B";"576";"195";"391";"469";"107";"0";"1";"468";"469"
"8";"Barcelona";"1";"Barcelona";"13";"Barcelonès";"08019";"Barcelona";"9";"62";"U";"796";"271";"507";"610";"186";"4";"5";"601";"606"
"8";"Barcelona";"1";"Barcelona";"13";"Barcelonès";"08019";"Barcelona";"9";"63";"U";"880";"342";"587";"718";"162";"5";"2";"711";"713"
"8";"Barcelona";"1";"Barcelona";"13";"Barcelonès";"08019";"Barcelona";"9";"64";"U";"992";"314";"619";"786";"206";"3";"5";"778";"783"
"8";"Barcelona";"1";"Barcelona";"13";"Barcelonès";"08019";"Barcelona";"9";"65";"A";"822";"276";"552";"675";"147";"1";"4";"670";"674"
"8";"Barcelona";"1";"Barcelona";"13";"Barcelonès";"08019";"Barcelona";"9";"65";"B";"757";"298";"494";"617";"140";"1";"0";"616";"616"
"8";"Barcelona";"1";"Barcelona";"13";"Barcelonès";"08019";"Barcelona";"9";"66";"U";"1093";"410";"742";"891";"202";"5";"2";"884";"886"
"8";"Barcelona";"1";"Barcelona";"13";"Barcelonès";"08019";"Barcelona";"9";"67";"U";"1056";"398";"708";"839";"217";"1";"2";"836";"838"
"8";"Barcelona";"1";"Barcelona";"13";"Barcelonès";"08019";"Barcelona";"9";"68";"A";"625";"230";"442";"524";"101";"0";"1";"523";"524"
"8";"Barcelona";"1";"Barcelona";"13";"Barcelonès";"08019";"Barcelona";"9";"68";"B";"596";"197";"389";"489";"107";"3";"3";"483";"486"
"8";"Barcelona";"1";"Barcelona";"13";"Barcelonès";"08019";"Barcelona";"9";"69";"U";"717";"276";"447";"561";"156";"0";"1";"560";"561"
"8";"Barcelona";"1";"Barcelona";"13";"Barcelonès";"08019";"Barcelona";"9";"7";"U";"866";"250";"431";"543";"323";"1";"7";"535";"542"
"8";"Barcelona";"1";"Barcelona";"13";"Barcelonès";"08019";"Barcelona";"9";"70";"A";"602";"183";"338";"429";"173";"3";"8";"418";"426"
"8";"Barcelona";"1";"Barcelona";"13";"Barcelonès";"08019";"Barcelona";"9";"70";"B";"648";"196";"377";"467";"181";"2";"3";"462";"465"
"8";"Barcelona";"1";"Barcelona";"13";"Barcelonès";"08019";"Barcelona";"9";"71";"A";"721";"240";"474";"568";"153";"1";"2";"565";"567"
"8";"Barcelona";"1";"Barcelona";"13";"Barcelonès";"08019";"Barcelona";"9";"71";"B";"664";"181";"382";"492";"172";"0";"2";"490";"492"
"8";"Barcelona";"1";"Barcelona";"13";"Barcelonès";"08019";"Barcelona";"9";"72";"U";"1030";"318";"595";"728";"302";"2";"2";"724";"726"
"8";"Barcelona";"1";"Barcelona";"13";"Barcelonès";"08019";"Barcelona";"9";"73";"A";"621";"218";"429";"507";"114";"0";"1";"506";"507"
"8";"Barcelona";"1";"Barcelona";"13";"Barcelonès";"08019";"Barcelona";"9";"73";"B";"621";"199";"416";"522";"99";"2";"3";"517";"520"
"8";"Barcelona";"1";"Barcelona";"13";"Barcelonès";"08019";"Barcelona";"9";"74";"A";"654";"203";"432";"516";"138";"3";"5";"508";"513"
"8";"Barcelona";"1";"Barcelona";"13";"Barcelonès";"08019";"Barcelona";"9";"74";"B";"569";"204";"376";"449";"120";"3";"1";"445";"446"
"8";"Barcelona";"1";"Barcelona";"13";"Barcelonès";"08019";"Barcelona";"9";"75";"U";"1080";"315";"674";"838";"242";"3";"9";"826";"835"
"8";"Barcelona";"1";"Barcelona";"13";"Barcelonès";"08019";"Barcelona";"9";"76";"U";"1074";"293";"660";"818";"256";"1";"3";"814";"817"
"8";"Barcelona";"1";"Barcelona";"13";"Barcelonès";"08019";"Barcelona";"9";"77";"U";"1180";"245";"707";"920";"260";"4";"3";"913";"916"
"8";"Barcelona";"1";"Barcelona";"13";"Barcelonès";"08019";"Barcelona";"9";"78";"U";"1046";"341";"701";"838";"208";"6";"4";"828";"832"
"8";"Barcelona";"1";"Barcelona";"13";"Barcelonès";"08019";"Barcelona";"9";"79";"A";"611";"236";"428";"506";"105";"2";"2";"502";"504"
"8";"Barcelona";"1";"Barcelona";"13";"Barcelonès";"08019";"Barcelona";"9";"79";"B";"611";"230";"405";"481";"130";"0";"1";"480";"481"
"8";"Barcelona";"1";"Barcelona";"13";"Barcelonès";"08019";"Barcelona";"9";"8";"A";"635";"213";"426";"545";"90";"0";"2";"543";"545"
"8";"Barcelona";"1";"Barcelona";"13";"Barcelonès";"08019";"Barcelona";"9";"8";"B";"544";"218";"380";"493";"51";"2";"4";"487";"491"
"8";"Barcelona";"1";"Barcelona";"13";"Barcelonès";"08019";"Barcelona";"9";"80";"U";"1017";"346";"666";"812";"205";"0";"7";"805";"812"
"8";"Barcelona";"1";"Barcelona";"13";"Barcelonès";"08019";"Barcelona";"9";"81";"A";"680";"224";"424";"523";"157";"1";"2";"520";"522"
"8";"Barcelona";"1";"Barcelona";"13";"Barcelonès";"08019";"Barcelona";"9";"81";"B";"607";"216";"385";"453";"154";"0";"3";"450";"453"
"8";"Barcelona";"1";"Barcelona";"13";"Barcelonès";"08019";"Barcelona";"9";"82";"A";"680";"251";"416";"511";"169";"1";"2";"508";"510"
"8";"Barcelona";"1";"Barcelona";"13";"Barcelonès";"08019";"Barcelona";"9";"82";"B";"665";"247";"403";"494";"171";"3";"2";"489";"491"
"8";"Barcelona";"1";"Barcelona";"13";"Barcelonès";"08019";"Barcelona";"9";"83";"A";"631";"231";"412";"501";"130";"1";"0";"500";"500"
"8";"Barcelona";"1";"Barcelona";"13";"Barcelonès";"08019";"Barcelona";"9";"83";"B";"581";"190";"382";"450";"131";"2";"3";"445";"448"
"8";"Barcelona";"1";"Barcelona";"13";"Barcelonès";"08019";"Barcelona";"9";"84";"A";"658";"238";"418";"518";"140";"1";"0";"517";"517"
"8";"Barcelona";"1";"Barcelona";"13";"Barcelonès";"08019";"Barcelona";"9";"84";"B";"604";"235";"397";"490";"114";"1";"0";"489";"489"
"8";"Barcelona";"1";"Barcelona";"13";"Barcelonès";"08019";"Barcelona";"9";"85";"A";"631";"201";"409";"489";"142";"2";"2";"485";"487"
"8";"Barcelona";"1";"Barcelona";"13";"Barcelonès";"08019";"Barcelona";"9";"85";"B";"592";"190";"368";"457";"135";"8";"1";"448";"449"
"8";"Barcelona";"1";"Barcelona";"13";"Barcelonès";"08019";"Barcelona";"9";"86";"U";"1009";"324";"645";"775";"234";"4";"3";"768";"771"
"8";"Barcelona";"1";"Barcelona";"13";"Barcelonès";"08019";"Barcelona";"9";"87";"U";"994";"347";"721";"851";"143";"0";"2";"849";"851"
"8";"Barcelona";"1";"Barcelona";"13";"Barcelonès";"08019";"Barcelona";"9";"88";"A";"733";"313";"504";"574";"159";"3";"2";"569";"571"
"8";"Barcelona";"1";"Barcelona";"13";"Barcelonès";"08019";"Barcelona";"9";"88";"B";"691";"281";"469";"549";"142";"2";"2";"545";"547"
"8";"Barcelona";"1";"Barcelona";"13";"Barcelonès";"08019";"Barcelona";"9";"89";"U";"1102";"359";"750";"870";"232";"1";"4";"865";"869"
"8";"Barcelona";"1";"Barcelona";"13";"Barcelonès";"08019";"Barcelona";"9";"9";"U";"1044";"331";"477";"785";"259";"2";"1";"782";"783"
"8";"Barcelona";"1";"Barcelona";"13";"Barcelonès";"08019";"Barcelona";"9";"90";"U";"1179";"375";"761";"918";"261";"5";"1";"912";"913"
"8";"Barcelona";"1";"Barcelona";"13";"Barcelonès";"08019";"Barcelona";"9";"91";"A";"743";"300";"480";"580";"163";"1";"0";"579";"579"
"8";"Barcelona";"1";"Barcelona";"13";"Barcelonès";"08019";"Barcelona";"9";"91";"B";"676";"247";"442";"535";"141";"2";"1";"532";"533"
"8";"Barcelona";"1";"Barcelona";"13";"Barcelonès";"08019";"Barcelona";"9";"92";"A";"833";"257";"534";"661";"172";"2";"2";"657";"659"
"8";"Barcelona";"1";"Barcelona";"13";"Barcelonès";"08019";"Barcelona";"9";"92";"B";"692";"203";"440";"554";"138";"4";"5";"545";"550"
"8";"Barcelona";"1";"Barcelona";"13";"Barcelonès";"08019";"Barcelona";"9";"93";"U";"1053";"346";"756";"928";"125";"5";"4";"919";"923"
"8";"Barcelona";"1";"Barcelona";"13";"Barcelonès";"08019";"Barcelona";"9";"94";"A";"775";"254";"496";"615";"160";"1";"6";"608";"614"
"8";"Barcelona";"1";"Barcelona";"13";"Barcelonès";"08019";"Barcelona";"9";"94";"B";"710";"229";"456";"559";"151";"1";"4";"554";"558"
"8";"Barcelona";"1";"Barcelona";"13";"Barcelonès";"08019";"Barcelona";"9";"95";"A";"825";"304";"541";"668";"157";"2";"2";"664";"666"
"8";"Barcelona";"1";"Barcelona";"13";"Barcelonès";"08019";"Barcelona";"9";"95";"B";"743";"256";"481";"589";"154";"1";"3";"585";"588"
"8";"Barcelona";"1";"Barcelona";"11";"Baix Llobregat";"08020";"Begues";"1";"1";"A";"468";"183";"308";"379";"89";"1";"2";"376";"378"
"8";"Barcelona";"1";"Barcelona";"11";"Baix Llobregat";"08020";"Begues";"1";"1";"B";"637";"243";"429";"536";"101";"2";"1";"533";"534"
"8";"Barcelona";"1";"Barcelona";"11";"Baix Llobregat";"08020";"Begues";"1";"1";"C";"587";"219";"400";"504";"83";"1";"5";"498";"503"
"8";"Barcelona";"1";"Barcelona";"11";"Baix Llobregat";"08020";"Begues";"1";"2";"A";"707";"233";"493";"596";"111";"2";"2";"592";"594"
"8";"Barcelona";"1";"Barcelona";"11";"Baix Llobregat";"08020";"Begues";"1";"2";"B";"705";"237";"503";"606";"99";"0";"2";"604";"606"
"8";"Barcelona";"1";"Barcelona";"11";"Baix Llobregat";"08020";"Begues";"1";"3";"A";"520";"182";"338";"423";"97";"0";"0";"423";"423"
"8";"Barcelona";"1";"Barcelona";"11";"Baix Llobregat";"08020";"Begues";"1";"3";"B";"640";"229";"448";"541";"99";"1";"4";"536";"540"
"8";"Barcelona";"1";"Barcelona";"11";"Baix Llobregat";"08020";"Begues";"1";"3";"C";"599";"199";"409";"509";"90";"0";"2";"507";"509"
"8";"Barcelona";"1";"Barcelona";"41";"Vallès Oriental";"08023";"Bigues i Riells";"1";"1";"A";"704";"285";"457";"568";"136";"0";"7";"561";"568"
"8";"Barcelona";"1";"Barcelona";"41";"Vallès Oriental";"08023";"Bigues i Riells";"1";"1";"B";"732";"299";"486";"579";"153";"2";"3";"574";"577"
"8";"Barcelona";"1";"Barcelona";"41";"Vallès Oriental";"08023";"Bigues i Riells";"1";"2";"A";"704";"225";"420";"530";"174";"3";"6";"521";"527"
"8";"Barcelona";"1";"Barcelona";"41";"Vallès Oriental";"08023";"Bigues i Riells";"1";"2";"B";"736";"247";"490";"575";"161";"2";"6";"567";"573"
"8";"Barcelona";"1";"Barcelona";"41";"Vallès Oriental";"08023";"Bigues i Riells";"1";"3";"A";"703";"264";"431";"537";"166";"1";"8";"528";"536"
"8";"Barcelona";"1";"Barcelona";"41";"Vallès Oriental";"08023";"Bigues i Riells";"1";"3";"B";"910";"362";"591";"714";"196";"2";"6";"706";"712"
"8";"Barcelona";"1";"Barcelona";"41";"Vallès Oriental";"08023";"Bigues i Riells";"1";"4";"A";"672";"283";"457";"550";"122";"2";"3";"545";"548"
"8";"Barcelona";"1";"Barcelona";"41";"Vallès Oriental";"08023";"Bigues i Riells";"1";"4";"B";"805";"291";"497";"633";"172";"5";"3";"625";"628"
"8";"Barcelona";"1";"Barcelona";"41";"Vallès Oriental";"08023";"Bigues i Riells";"1";"5";"U";"697";"279";"467";"569";"128";"5";"2";"562";"564"
"8";"Barcelona";"1";"Barcelona";"3";"Alt Penedès";"08027";"Cabanyes, les";"1";"1";"U";"690";"262";"498";"591";"99";"4";"3";"584";"587"
"8";"Barcelona";"1";"Barcelona";"21";"Maresme";"08029";"Cabrera de Mar";"1";"1";"A";"608";"253";"448";"530";"78";"2";"3";"525";"528"
"8";"Barcelona";"1";"Barcelona";"21";"Maresme";"08029";"Cabrera de Mar";"1";"1";"B";"539";"183";"367";"452";"87";"0";"0";"452";"452"
"8";"Barcelona";"1";"Barcelona";"21";"Maresme";"08029";"Cabrera de Mar";"1";"1";"C";"654";"236";"451";"563";"91";"1";"4";"558";"562"
"8";"Barcelona";"1";"Barcelona";"21";"Maresme";"08029";"Cabrera de Mar";"1";"2";"A";"622";"196";"461";"548";"74";"2";"4";"542";"546"
"8";"Barcelona";"1";"Barcelona";"21";"Maresme";"08029";"Cabrera de Mar";"1";"2";"B";"540";"232";"398";"479";"61";"2";"3";"474";"477"
"8";"Barcelona";"1";"Barcelona";"21";"Maresme";"08029";"Cabrera de Mar";"1";"2";"C";"468";"204";"353";"408";"60";"2";"4";"402";"406"
"8";"Barcelona";"1";"Barcelona";"21";"Maresme";"08030";"Cabrils";"1";"1";"A";"901";"314";"652";"764";"137";"2";"4";"758";"762"
"8";"Barcelona";"1";"Barcelona";"21";"Maresme";"08030";"Cabrils";"1";"1";"B";"789";"284";"529";"679";"110";"0";"2";"677";"679"
"8";"Barcelona";"1";"Barcelona";"21";"Maresme";"08030";"Cabrils";"1";"1";"C";"803";"286";"555";"678";"125";"2";"5";"671";"676"
"8";"Barcelona";"1";"Barcelona";"21";"Maresme";"08030";"Cabrils";"1";"2";"A";"897";"314";"624";"760";"137";"0";"3";"757";"760"
"8";"Barcelona";"1";"Barcelona";"21";"Maresme";"08030";"Cabrils";"1";"2";"B";"880";"297";"612";"745";"135";"1";"4";"740";"744"
"8";"Barcelona";"1";"Barcelona";"21";"Maresme";"08030";"Cabrils";"1";"2";"C";"822";"271";"569";"691";"131";"1";"4";"686";"690"
"8";"Barcelona";"1";"Barcelona";"21";"Maresme";"08032";"Caldes d'Estrac";"1";"1";"A";"952";"350";"629";"752";"200";"2";"0";"750";"750"
"8";"Barcelona";"1";"Barcelona";"21";"Maresme";"08032";"Caldes d'Estrac";"1";"1";"B";"1038";"310";"646";"805";"233";"4";"6";"795";"801"
"8";"Barcelona";"1";"Barcelona";"41";"Vallès Oriental";"08033";"Caldes de Montbui";"1";"1";"A";"526";"216";"367";"438";"88";"1";"2";"435";"437"
"8";"Barcelona";"1";"Barcelona";"41";"Vallès Oriental";"08033";"Caldes de Montbui";"1";"1";"B";"697";"300";"486";"570";"127";"0";"0";"570";"570"
"8";"Barcelona";"1";"Barcelona";"41";"Vallès Oriental";"08033";"Caldes de Montbui";"1";"2";"A";"586";"223";"373";"450";"136";"0";"9";"441";"450"
"8";"Barcelona";"1";"Barcelona";"41";"Vallès Oriental";"08033";"Caldes de Montbui";"1";"2";"B";"662";"263";"416";"507";"155";"2";"4";"501";"505"
"8";"Barcelona";"1";"Barcelona";"41";"Vallès Oriental";"08033";"Caldes de Montbui";"1";"2";"C";"568";"208";"355";"422";"146";"1";"2";"419";"421"
"8";"Barcelona";"1";"Barcelona";"41";"Vallès Oriental";"08033";"Caldes de Montbui";"1";"3";"U";"713";"266";"478";"561";"152";"0";"1";"560";"561"
"8";"Barcelona";"1";"Barcelona";"41";"Vallès Oriental";"08033";"Caldes de Montbui";"2";"1";"A";"571";"219";"414";"471";"100";"3";"3";"465";"468"
"8";"Barcelona";"1";"Barcelona";"41";"Vallès Oriental";"08033";"Caldes de Montbui";"2";"1";"B";"581";"210";"375";"467";"114";"3";"6";"458";"464"
"8";"Barcelona";"1";"Barcelona";"41";"Vallès Oriental";"08033";"Caldes de Montbui";"2";"1";"C";"560";"201";"362";"443";"117";"2";"2";"439";"441"
"8";"Barcelona";"1";"Barcelona";"41";"Vallès Oriental";"08033";"Caldes de Montbui";"3";"1";"A";"625";"265";"418";"519";"106";"2";"5";"512";"517"
"8";"Barcelona";"1";"Barcelona";"41";"Vallès Oriental";"08033";"Caldes de Montbui";"3";"1";"B";"784";"303";"496";"605";"179";"0";"5";"600";"605"
"8";"Barcelona";"1";"Barcelona";"41";"Vallès Oriental";"08033";"Caldes de Montbui";"3";"2";"U";"661";"248";"404";"492";"169";"2";"3";"487";"490"
"8";"Barcelona";"1";"Barcelona";"41";"Vallès Oriental";"08033";"Caldes de Montbui";"3";"3";"A";"491";"183";"300";"370";"121";"1";"2";"367";"369"
"8";"Barcelona";"1";"Barcelona";"41";"Vallès Oriental";"08033";"Caldes de Montbui";"3";"3";"B";"624";"230";"389";"491";"133";"3";"5";"483";"488"
"8";"Barcelona";"1";"Barcelona";"41";"Vallès Oriental";"08033";"Caldes de Montbui";"3";"3";"C";"572";"224";"360";"445";"127";"1";"3";"441";"444"
"8";"Barcelona";"1";"Barcelona";"41";"Vallès Oriental";"08033";"Caldes de Montbui";"3";"4";"A";"655";"275";"453";"563";"92";"5";"3";"555";"558"
"8";"Barcelona";"1";"Barcelona";"41";"Vallès Oriental";"08033";"Caldes de Montbui";"3";"4";"B";"682";"258";"474";"568";"114";"3";"2";"563";"565"
"8";"Barcelona";"1";"Barcelona";"41";"Vallès Oriental";"08033";"Caldes de Montbui";"3";"4";"C";"676";"237";"460";"554";"122";"1";"2";"551";"553"
"8";"Barcelona";"1";"Barcelona";"41";"Vallès Oriental";"08033";"Caldes de Montbui";"3";"5";"A";"692";"252";"457";"553";"139";"2";"2";"549";"551"
"8";"Barcelona";"1";"Barcelona";"41";"Vallès Oriental";"08033";"Caldes de Montbui";"3";"5";"B";"855";"315";"538";"680";"175";"0";"3";"677";"680"
"8";"Barcelona";"1";"Barcelona";"21";"Maresme";"08035";"Calella";"1";"1";"A";"547";"205";"338";"381";"166";"1";"1";"379";"380"
"8";"Barcelona";"1";"Barcelona";"21";"Maresme";"08035";"Calella";"1";"1";"B";"641";"243";"413";"479";"162";"2";"3";"474";"477"
"8";"Barcelona";"1";"Barcelona";"21";"Maresme";"08035";"Calella";"1";"2";"U";"807";"361";"572";"675";"132";"0";"2";"673";"675"
"8";"Barcelona";"1";"Barcelona";"21";"Maresme";"08035";"Calella";"1";"3";"A";"682";"258";"399";"484";"198";"0";"0";"484";"484"
"8";"Barcelona";"1";"Barcelona";"21";"Maresme";"08035";"Calella";"1";"3";"B";"814";"277";"457";"566";"248";"1";"0";"565";"565"
"8";"Barcelona";"1";"Barcelona";"21";"Maresme";"08035";"Calella";"2";"1";"U";"709";"218";"453";"548";"161";"1";"1";"546";"547"
"8";"Barcelona";"1";"Barcelona";"21";"Maresme";"08035";"Calella";"2";"2";"A";"671";"223";"413";"527";"144";"0";"3";"524";"527"
"8";"Barcelona";"1";"Barcelona";"21";"Maresme";"08035";"Calella";"2";"2";"B";"876";"228";"560";"679";"197";"2";"2";"675";"677"
"8";"Barcelona";"1";"Barcelona";"21";"Maresme";"08035";"Calella";"3";"1";"A";"562";"214";"335";"413";"149";"0";"1";"412";"413"
"8";"Barcelona";"1";"Barcelona";"21";"Maresme";"08035";"Calella";"3";"1";"B";"603";"217";"386";"458";"145";"2";"1";"455";"456"
"8";"Barcelona";"1";"Barcelona";"21";"Maresme";"08035";"Calella";"3";"1";"C";"606";"236";"414";"494";"112";"0";"2";"492";"494"
"8";"Barcelona";"1";"Barcelona";"21";"Maresme";"08035";"Calella";"3";"2";"A";"555";"203";"344";"408";"147";"0";"1";"407";"408"
"8";"Barcelona";"1";"Barcelona";"21";"Maresme";"08035";"Calella";"3";"2";"B";"605";"208";"362";"448";"157";"0";"5";"443";"448"
"8";"Barcelona";"1";"Barcelona";"21";"Maresme";"08035";"Calella";"3";"2";"C";"601";"241";"381";"441";"160";"0";"7";"434";"441"
"8";"Barcelona";"1";"Barcelona";"21";"Maresme";"08035";"Calella";"3";"3";"A";"677";"309";"477";"549";"128";"0";"3";"546";"549"
"8";"Barcelona";"1";"Barcelona";"21";"Maresme";"08035";"Calella";"3";"3";"B";"808";"364";"552";"634";"174";"0";"2";"632";"634"
"8";"Barcelona";"1";"Barcelona";"21";"Maresme";"08035";"Calella";"3";"4";"A";"504";"161";"292";"358";"146";"0";"1";"357";"358"
"8";"Barcelona";"1";"Barcelona";"21";"Maresme";"08035";"Calella";"3";"4";"B";"624";"187";"342";"429";"195";"1";"1";"427";"428"
"8";"Barcelona";"1";"Barcelona";"21";"Maresme";"08035";"Calella";"3";"4";"C";"533";"191";"325";"393";"140";"2";"5";"386";"391"
"8";"Barcelona";"1";"Barcelona";"41";"Vallès Oriental";"08039";"Campins";"1";"1";"U";"359";"161";"258";"302";"57";"2";"1";"299";"300"
"8";"Barcelona";"1";"Barcelona";"21";"Maresme";"08040";"Canet de Mar";"1";"1";"A";"694";"265";"492";"570";"124";"0";"2";"568";"570"
"8";"Barcelona";"1";"Barcelona";"21";"Maresme";"08040";"Canet de Mar";"1";"1";"B";"790";"330";"545";"625";"165";"2";"1";"622";"623"
"8";"Barcelona";"1";"Barcelona";"21";"Maresme";"08040";"Canet de Mar";"1";"2";"A";"682";"246";"466";"538";"144";"4";"4";"530";"534"
"8";"Barcelona";"1";"Barcelona";"21";"Maresme";"08040";"Canet de Mar";"1";"2";"B";"733";"250";"480";"574";"159";"3";"3";"568";"571"
"8";"Barcelona";"1";"Barcelona";"21";"Maresme";"08040";"Canet de Mar";"1";"3";"A";"454";"154";"265";"321";"133";"2";"0";"319";"319"
"8";"Barcelona";"1";"Barcelona";"21";"Maresme";"08040";"Canet de Mar";"1";"3";"B";"510";"182";"321";"389";"121";"1";"1";"387";"388"
"8";"Barcelona";"1";"Barcelona";"21";"Maresme";"08040";"Canet de Mar";"1";"4";"A";"912";"293";"597";"735";"177";"3";"6";"726";"732"
"8";"Barcelona";"1";"Barcelona";"21";"Maresme";"08040";"Canet de Mar";"1";"4";"B";"1000";"320";"642";"793";"207";"1";"4";"788";"792"
"8";"Barcelona";"1";"Barcelona";"21";"Maresme";"08040";"Canet de Mar";"1";"5";"A";"501";"206";"315";"384";"117";"1";"1";"382";"383"
"8";"Barcelona";"1";"Barcelona";"21";"Maresme";"08040";"Canet de Mar";"1";"5";"B";"539";"230";"356";"422";"117";"0";"2";"420";"422"
"8";"Barcelona";"1";"Barcelona";"21";"Maresme";"08040";"Canet de Mar";"1";"6";"U";"1047";"245";"517";"640";"407";"4";"0";"636";"636"
"8";"Barcelona";"1";"Barcelona";"21";"Maresme";"08040";"Canet de Mar";"1";"7";"A";"882";"273";"570";"724";"158";"2";"3";"719";"722"
"8";"Barcelona";"1";"Barcelona";"21";"Maresme";"08040";"Canet de Mar";"1";"7";"B";"1071";"356";"690";"899";"172";"4";"4";"891";"895"
"8";"Barcelona";"1";"Barcelona";"21";"Maresme";"08040";"Canet de Mar";"1";"8";"A";"391";"115";"244";"317";"74";"2";"1";"314";"315"
"8";"Barcelona";"1";"Barcelona";"21";"Maresme";"08040";"Canet de Mar";"1";"8";"B";"510";"167";"307";"391";"119";"1";"0";"390";"390"
"8";"Barcelona";"1";"Barcelona";"41";"Vallès Oriental";"08041";"Canovelles";"1";"1";"A";"686";"215";"418";"541";"145";"3";"3";"535";"538"
"8";"Barcelona";"1";"Barcelona";"41";"Vallès Oriental";"08041";"Canovelles";"1";"1";"B";"875";"344";"589";"721";"154";"3";"9";"709";"718"
"8";"Barcelona";"1";"Barcelona";"41";"Vallès Oriental";"08041";"Canovelles";"1";"2";"A";"525";"184";"285";"347";"178";"3";"1";"343";"344"
"8";"Barcelona";"1";"Barcelona";"41";"Vallès Oriental";"08041";"Canovelles";"1";"2";"B";"647";"233";"379";"433";"214";"1";"1";"431";"432"
"8";"Barcelona";"1";"Barcelona";"41";"Vallès Oriental";"08041";"Canovelles";"1";"3";"A";"581";"160";"255";"310";"271";"1";"2";"307";"309"
"8";"Barcelona";"1";"Barcelona";"41";"Vallès Oriental";"08041";"Canovelles";"1";"3";"B";"591";"179";"288";"374";"217";"3";"4";"367";"371"
"8";"Barcelona";"1";"Barcelona";"41";"Vallès Oriental";"08041";"Canovelles";"1";"4";"U";"1159";"316";"587";"761";"398";"3";"7";"751";"758"
"8";"Barcelona";"1";"Barcelona";"41";"Vallès Oriental";"08041";"Canovelles";"1";"5";"A";"383";"138";"202";"242";"141";"0";"1";"241";"242"
"8";"Barcelona";"1";"Barcelona";"41";"Vallès Oriental";"08041";"Canovelles";"1";"5";"B";"510";"187";"291";"344";"166";"0";"1";"343";"344"
"8";"Barcelona";"1";"Barcelona";"41";"Vallès Oriental";"08041";"Canovelles";"1";"6";"A";"566";"257";"385";"464";"102";"3";"2";"459";"461"
"8";"Barcelona";"1";"Barcelona";"41";"Vallès Oriental";"08041";"Canovelles";"1";"6";"B";"765";"332";"533";"652";"113";"1";"3";"648";"651"
"8";"Barcelona";"1";"Barcelona";"41";"Vallès Oriental";"08041";"Canovelles";"1";"7";"A";"631";"269";"438";"511";"120";"2";"4";"505";"509"
"8";"Barcelona";"1";"Barcelona";"41";"Vallès Oriental";"08041";"Canovelles";"1";"7";"B";"806";"325";"556";"650";"156";"5";"2";"643";"645"
"8";"Barcelona";"1";"Barcelona";"41";"Vallès Oriental";"08041";"Canovelles";"1";"8";"A";"678";"259";"449";"556";"122";"2";"1";"553";"554"
"8";"Barcelona";"1";"Barcelona";"41";"Vallès Oriental";"08041";"Canovelles";"1";"8";"B";"912";"313";"601";"739";"173";"7";"2";"730";"732"
"8";"Barcelona";"1";"Barcelona";"17";"Garraf";"08043";"Canyelles";"1";"1";"A";"807";"256";"488";"596";"211";"1";"4";"591";"595"
"8";"Barcelona";"1";"Barcelona";"17";"Garraf";"08043";"Canyelles";"1";"1";"B";"941";"297";"596";"730";"211";"5";"3";"722";"725"
"8";"Barcelona";"1";"Barcelona";"17";"Garraf";"08043";"Canyelles";"1";"2";"A";"657";"248";"461";"507";"150";"1";"1";"505";"506"
"8";"Barcelona";"1";"Barcelona";"17";"Garraf";"08043";"Canyelles";"1";"2";"B";"787";"272";"426";"567";"220";"5";"1";"561";"562"
"8";"Barcelona";"1";"Barcelona";"41";"Vallès Oriental";"08046";"Cardedeu";"1";"1";"A";"558";"188";"383";"460";"98";"1";"2";"457";"459"
"8";"Barcelona";"1";"Barcelona";"41";"Vallès Oriental";"08046";"Cardedeu";"1";"1";"B";"500";"196";"333";"413";"87";"1";"2";"410";"412"
"8";"Barcelona";"1";"Barcelona";"41";"Vallès Oriental";"08046";"Cardedeu";"1";"2";"A";"735";"272";"502";"619";"116";"0";"2";"617";"619"
"8";"Barcelona";"1";"Barcelona";"41";"Vallès Oriental";"08046";"Cardedeu";"1";"2";"B";"759";"276";"522";"635";"124";"9";"2";"624";"626"
"8";"Barcelona";"1";"Barcelona";"41";"Vallès Oriental";"08046";"Cardedeu";"1";"3";"A";"574";"212";"374";"461";"113";"1";"1";"459";"460"
"8";"Barcelona";"1";"Barcelona";"41";"Vallès Oriental";"08046";"Cardedeu";"1";"3";"B";"553";"212";"379";"451";"102";"1";"2";"448";"450"
"8";"Barcelona";"1";"Barcelona";"41";"Vallès Oriental";"08046";"Cardedeu";"2";"1";"A";"590";"207";"363";"448";"142";"3";"5";"440";"445"
"8";"Barcelona";"1";"Barcelona";"41";"Vallès Oriental";"08046";"Cardedeu";"2";"1";"B";"669";"258";"444";"541";"128";"2";"4";"535";"539"
"8";"Barcelona";"1";"Barcelona";"41";"Vallès Oriental";"08046";"Cardedeu";"2";"1";"C";"650";"249";"423";"519";"131";"0";"4";"515";"519"
"8";"Barcelona";"1";"Barcelona";"41";"Vallès Oriental";"08046";"Cardedeu";"2";"2";"A";"712";"270";"484";"580";"132";"3";"6";"571";"577"
"8";"Barcelona";"1";"Barcelona";"41";"Vallès Oriental";"08046";"Cardedeu";"2";"2";"B";"650";"257";"434";"543";"107";"2";"3";"538";"541"
"8";"Barcelona";"1";"Barcelona";"41";"Vallès Oriental";"08046";"Cardedeu";"2";"3";"A";"718";"270";"515";"609";"109";"2";"2";"605";"607"
"8";"Barcelona";"1";"Barcelona";"41";"Vallès Oriental";"08046";"Cardedeu";"2";"3";"B";"610";"257";"430";"516";"94";"1";"0";"515";"515"
"8";"Barcelona";"1";"Barcelona";"41";"Vallès Oriental";"08046";"Cardedeu";"2";"4";"A";"734";"313";"534";"619";"115";"1";"3";"615";"618"
"8";"Barcelona";"1";"Barcelona";"41";"Vallès Oriental";"08046";"Cardedeu";"2";"4";"B";"787";"297";"528";"646";"141";"3";"7";"636";"643"
"8";"Barcelona";"1";"Barcelona";"41";"Vallès Oriental";"08046";"Cardedeu";"2";"4";"C";"768";"262";"524";"639";"129";"2";"5";"632";"637"
"8";"Barcelona";"1";"Barcelona";"41";"Vallès Oriental";"08046";"Cardedeu";"3";"1";"A";"654";"218";"395";"511";"143";"2";"3";"506";"509"
"8";"Barcelona";"1";"Barcelona";"41";"Vallès Oriental";"08046";"Cardedeu";"3";"1";"B";"679";"246";"438";"539";"140";"0";"4";"535";"539"
"8";"Barcelona";"1";"Barcelona";"41";"Vallès Oriental";"08046";"Cardedeu";"3";"1";"C";"648";"219";"406";"521";"127";"1";"4";"516";"520"
"8";"Barcelona";"1";"Barcelona";"41";"Vallès Oriental";"08046";"Cardedeu";"3";"1";"D";"652";"230";"414";"425";"227";"5";"3";"417";"420"
"8";"Barcelona";"1";"Barcelona";"40";"Vallès Occidental";"08051";"Castellar del Vallès";"1";"1";"U";"901";"367";"585";"716";"185";"1";"1";"714";"715"
"8";"Barcelona";"1";"Barcelona";"40";"Vallès Occidental";"08051";"Castellar del Vallès";"1";"10";"A";"501";"214";"355";"434";"67";"0";"1";"433";"434"
"8";"Barcelona";"1";"Barcelona";"40";"Vallès Occidental";"08051";"Castellar del Vallès";"1";"10";"B";"598";"235";"416";"524";"74";"1";"2";"521";"523"
"8";"Barcelona";"1";"Barcelona";"40";"Vallès Occidental";"08051";"Castellar del Vallès";"1";"11";"U";"809";"291";"554";"686";"123";"1";"0";"685";"685"
"8";"Barcelona";"1";"Barcelona";"40";"Vallès Occidental";"08051";"Castellar del Vallès";"1";"12";"U";"745";"254";"444";"570";"175";"3";"2";"565";"567"
"8";"Barcelona";"1";"Barcelona";"40";"Vallès Occidental";"08051";"Castellar del Vallès";"1";"13";"A";"637";"198";"405";"520";"117";"1";"5";"514";"519"
"8";"Barcelona";"1";"Barcelona";"40";"Vallès Occidental";"08051";"Castellar del Vallès";"1";"13";"B";"771";"219";"481";"635";"136";"0";"5";"630";"635"
"8";"Barcelona";"1";"Barcelona";"40";"Vallès Occidental";"08051";"Castellar del Vallès";"1";"14";"A";"454";"158";"289";"376";"78";"1";"3";"372";"375"
"8";"Barcelona";"1";"Barcelona";"40";"Vallès Occidental";"08051";"Castellar del Vallès";"1";"14";"B";"659";"220";"426";"552";"107";"3";"5";"544";"549"
"8";"Barcelona";"1";"Barcelona";"40";"Vallès Occidental";"08051";"Castellar del Vallès";"1";"2";"A";"474";"174";"312";"402";"72";"0";"2";"400";"402"
"8";"Barcelona";"1";"Barcelona";"40";"Vallès Occidental";"08051";"Castellar del Vallès";"1";"2";"B";"641";"242";"442";"541";"100";"2";"3";"536";"539"
"8";"Barcelona";"1";"Barcelona";"40";"Vallès Occidental";"08051";"Castellar del Vallès";"1";"3";"A";"638";"217";"397";"488";"150";"3";"5";"480";"485"
"8";"Barcelona";"1";"Barcelona";"40";"Vallès Occidental";"08051";"Castellar del Vallès";"1";"3";"B";"742";"268";"471";"571";"171";"6";"5";"560";"565"
"8";"Barcelona";"1";"Barcelona";"40";"Vallès Occidental";"08051";"Castellar del Vallès";"1";"4";"A";"720";"281";"490";"582";"138";"1";"1";"580";"581"
"8";"Barcelona";"1";"Barcelona";"40";"Vallès Occidental";"08051";"Castellar del Vallès";"1";"4";"B";"848";"338";"560";"673";"175";"2";"0";"671";"671"
"8";"Barcelona";"1";"Barcelona";"40";"Vallès Occidental";"08051";"Castellar del Vallès";"1";"5";"A";"615";"272";"448";"535";"80";"0";"3";"532";"535"
"8";"Barcelona";"1";"Barcelona";"40";"Vallès Occidental";"08051";"Castellar del Vallès";"1";"5";"B";"764";"315";"529";"647";"117";"3";"4";"640";"644"
"8";"Barcelona";"1";"Barcelona";"40";"Vallès Occidental";"08051";"Castellar del Vallès";"1";"6";"A";"618";"227";"387";"481";"137";"1";"3";"477";"480"
"8";"Barcelona";"1";"Barcelona";"40";"Vallès Occidental";"08051";"Castellar del Vallès";"1";"6";"B";"646";"216";"379";"482";"164";"0";"3";"479";"482"
"8";"Barcelona";"1";"Barcelona";"40";"Vallès Occidental";"08051";"Castellar del Vallès";"1";"7";"A";"809";"292";"521";"638";"171";"1";"2";"635";"637"
"8";"Barcelona";"1";"Barcelona";"40";"Vallès Occidental";"08051";"Castellar del Vallès";"1";"7";"B";"893";"300";"546";"692";"201";"4";"4";"684";"688"
"8";"Barcelona";"1";"Barcelona";"40";"Vallès Occidental";"08051";"Castellar del Vallès";"1";"8";"A";"708";"253";"436";"559";"149";"1";"4";"554";"558"
"8";"Barcelona";"1";"Barcelona";"40";"Vallès Occidental";"08051";"Castellar del Vallès";"1";"8";"B";"861";"310";"532";"683";"178";"3";"3";"677";"680"
"8";"Barcelona";"1";"Barcelona";"40";"Vallès Occidental";"08051";"Castellar del Vallès";"1";"9";"A";"866";"290";"594";"737";"129";"2";"6";"729";"735"
"8";"Barcelona";"1";"Barcelona";"40";"Vallès Occidental";"08051";"Castellar del Vallès";"1";"9";"B";"921";"334";"624";"782";"139";"3";"4";"775";"779"
"8";"Barcelona";"1";"Barcelona";"40";"Vallès Occidental";"08054";"Castellbisbal";"1";"1";"A";"564";"212";"383";"465";"99";"2";"1";"462";"463"
"8";"Barcelona";"1";"Barcelona";"40";"Vallès Occidental";"08054";"Castellbisbal";"1";"1";"B";"631";"210";"427";"510";"121";"2";"4";"504";"508"
"8";"Barcelona";"1";"Barcelona";"40";"Vallès Occidental";"08054";"Castellbisbal";"1";"1";"C";"691";"257";"486";"578";"113";"1";"2";"575";"577"
"8";"Barcelona";"1";"Barcelona";"40";"Vallès Occidental";"08054";"Castellbisbal";"1";"2";"U";"828";"313";"574";"676";"152";"1";"4";"671";"675"
"8";"Barcelona";"1";"Barcelona";"40";"Vallès Occidental";"08054";"Castellbisbal";"1";"3";"A";"730";"234";"515";"627";"103";"2";"1";"624";"625"
"8";"Barcelona";"1";"Barcelona";"40";"Vallès Occidental";"08054";"Castellbisbal";"1";"3";"B";"712";"282";"487";"595";"117";"0";"1";"594";"595"
"8";"Barcelona";"1";"Barcelona";"40";"Vallès Occidental";"08054";"Castellbisbal";"1";"4";"A";"854";"196";"529";"707";"147";"4";"3";"700";"703"
"8";"Barcelona";"1";"Barcelona";"40";"Vallès Occidental";"08054";"Castellbisbal";"1";"4";"B";"871";"286";"561";"718";"153";"8";"2";"708";"710"
"8";"Barcelona";"1";"Barcelona";"40";"Vallès Occidental";"08054";"Castellbisbal";"1";"5";"A";"890";"253";"563";"707";"183";"3";"1";"703";"704"
"8";"Barcelona";"1";"Barcelona";"40";"Vallès Occidental";"08054";"Castellbisbal";"1";"5";"B";"843";"283";"528";"664";"179";"1";"0";"663";"663"
"8";"Barcelona";"1";"Barcelona";"40";"Vallès Occidental";"08054";"Castellbisbal";"1";"6";"A";"709";"255";"431";"530";"179";"4";"1";"525";"526"
"8";"Barcelona";"1";"Barcelona";"40";"Vallès Occidental";"08054";"Castellbisbal";"1";"6";"B";"663";"241";"390";"501";"162";"2";"0";"499";"499"
"8";"Barcelona";"1";"Barcelona";"11";"Baix Llobregat";"08056";"Castelldefels";"1";"1";"U";"697";"213";"396";"508";"189";"3";"1";"504";"505"
"8";"Barcelona";"1";"Barcelona";"11";"Baix Llobregat";"08056";"Castelldefels";"1";"2";"A";"710";"225";"424";"516";"194";"1";"1";"514";"515"
"8";"Barcelona";"1";"Barcelona";"11";"Baix Llobregat";"08056";"Castelldefels";"1";"2";"B";"730";"238";"456";"549";"181";"5";"2";"542";"544"
"8";"Barcelona";"1";"Barcelona";"11";"Baix Llobregat";"08056";"Castelldefels";"1";"3";"A";"617";"196";"390";"482";"135";"1";"4";"477";"481"
"8";"Barcelona";"1";"Barcelona";"11";"Baix Llobregat";"08056";"Castelldefels";"1";"3";"B";"856";"302";"560";"661";"195";"2";"2";"657";"659"
"8";"Barcelona";"1";"Barcelona";"11";"Baix Llobregat";"08056";"Castelldefels";"1";"3";"C";"722";"267";"450";"568";"154";"3";"3";"562";"565"
"8";"Barcelona";"1";"Barcelona";"11";"Baix Llobregat";"08056";"Castelldefels";"1";"4";"A";"773";"205";"451";"565";"208";"0";"6";"559";"565"
"8";"Barcelona";"1";"Barcelona";"11";"Baix Llobregat";"08056";"Castelldefels";"1";"4";"B";"805";"232";"456";"590";"215";"0";"2";"588";"590"
"8";"Barcelona";"1";"Barcelona";"11";"Baix Llobregat";"08056";"Castelldefels";"1";"5";"A";"621";"238";"381";"458";"163";"2";"1";"455";"456"
"8";"Barcelona";"1";"Barcelona";"11";"Baix Llobregat";"08056";"Castelldefels";"1";"5";"B";"731";"254";"378";"519";"212";"1";"2";"516";"518"
"8";"Barcelona";"1";"Barcelona";"11";"Baix Llobregat";"08056";"Castelldefels";"1";"6";"A";"586";"194";"348";"436";"150";"1";"3";"432";"435"
"8";"Barcelona";"1";"Barcelona";"11";"Baix Llobregat";"08056";"Castelldefels";"1";"6";"B";"745";"263";"463";"573";"172";"3";"3";"567";"570"
"8";"Barcelona";"1";"Barcelona";"11";"Baix Llobregat";"08056";"Castelldefels";"1";"6";"C";"634";"212";"390";"476";"158";"3";"2";"471";"473"
"8";"Barcelona";"1";"Barcelona";"11";"Baix Llobregat";"08056";"Castelldefels";"1";"7";"A";"752";"263";"484";"601";"151";"6";"3";"592";"595"
"8";"Barcelona";"1";"Barcelona";"11";"Baix Llobregat";"08056";"Castelldefels";"1";"7";"B";"961";"311";"641";"784";"177";"4";"4";"776";"780"
"8";"Barcelona";"1";"Barcelona";"11";"Baix Llobregat";"08056";"Castelldefels";"1";"7";"C";"798";"272";"529";"640";"158";"2";"6";"632";"638"
"8";"Barcelona";"1";"Barcelona";"11";"Baix Llobregat";"08056";"Castelldefels";"2";"1";"A";"631";"230";"390";"485";"146";"2";"1";"482";"483"
"8";"Barcelona";"1";"Barcelona";"11";"Baix Llobregat";"08056";"Castelldefels";"2";"1";"B";"649";"233";"410";"494";"155";"1";"2";"491";"493"
"8";"Barcelona";"1";"Barcelona";"11";"Baix Llobregat";"08056";"Castelldefels";"2";"2";"A";"545";"186";"326";"434";"111";"0";"2";"432";"434"
"8";"Barcelona";"1";"Barcelona";"11";"Baix Llobregat";"08056";"Castelldefels";"2";"2";"B";"668";"236";"443";"534";"134";"0";"2";"532";"534"
"8";"Barcelona";"1";"Barcelona";"11";"Baix Llobregat";"08056";"Castelldefels";"2";"3";"A";"603";"220";"403";"462";"141";"5";"1";"456";"457"
"8";"Barcelona";"1";"Barcelona";"11";"Baix Llobregat";"08056";"Castelldefels";"2";"3";"B";"643";"210";"381";"468";"175";"1";"2";"465";"467"
"8";"Barcelona";"1";"Barcelona";"11";"Baix Llobregat";"08056";"Castelldefels";"2";"4";"A";"926";"313";"588";"704";"222";"8";"3";"693";"696"
"8";"Barcelona";"1";"Barcelona";"11";"Baix Llobregat";"08056";"Castelldefels";"2";"4";"B";"981";"317";"584";"721";"260";"0";"7";"714";"721"
"8";"Barcelona";"1";"Barcelona";"11";"Baix Llobregat";"08056";"Castelldefels";"2";"5";"A";"618";"219";"391";"486";"132";"6";"3";"477";"480"
"8";"Barcelona";"1";"Barcelona";"11";"Baix Llobregat";"08056";"Castelldefels";"2";"5";"B";"652";"240";"439";"542";"110";"4";"4";"534";"538"
"8";"Barcelona";"1";"Barcelona";"11";"Baix Llobregat";"08056";"Castelldefels";"2";"6";"A";"493";"159";"312";"363";"130";"2";"1";"360";"361"
"8";"Barcelona";"1";"Barcelona";"11";"Baix Llobregat";"08056";"Castelldefels";"2";"6";"B";"618";"223";"392";"478";"140";"0";"4";"474";"478"
"8";"Barcelona";"1";"Barcelona";"11";"Baix Llobregat";"08056";"Castelldefels";"3";"1";"U";"772";"264";"473";"592";"180";"3";"4";"585";"589"
"8";"Barcelona";"1";"Barcelona";"11";"Baix Llobregat";"08056";"Castelldefels";"3";"2";"A";"675";"260";"472";"572";"103";"2";"0";"570";"570"
"8";"Barcelona";"1";"Barcelona";"11";"Baix Llobregat";"08056";"Castelldefels";"3";"2";"B";"701";"241";"475";"586";"115";"3";"3";"580";"583"
"8";"Barcelona";"1";"Barcelona";"11";"Baix Llobregat";"08056";"Castelldefels";"3";"3";"A";"575";"191";"357";"442";"133";"1";"2";"439";"441"
"8";"Barcelona";"1";"Barcelona";"11";"Baix Llobregat";"08056";"Castelldefels";"3";"3";"B";"728";"235";"421";"556";"172";"0";"4";"552";"556"
"8";"Barcelona";"1";"Barcelona";"11";"Baix Llobregat";"08056";"Castelldefels";"3";"3";"C";"642";"201";"394";"501";"141";"0";"1";"500";"501"
"8";"Barcelona";"1";"Barcelona";"11";"Baix Llobregat";"08056";"Castelldefels";"3";"4";"A";"809";"280";"576";"685";"124";"2";"2";"681";"683"
"8";"Barcelona";"1";"Barcelona";"11";"Baix Llobregat";"08056";"Castelldefels";"3";"4";"B";"899";"356";"637";"772";"127";"3";"10";"759";"769"
"8";"Barcelona";"1";"Barcelona";"11";"Baix Llobregat";"08056";"Castelldefels";"3";"5";"U";"848";"356";"562";"725";"123";"0";"5";"720";"725"
"8";"Barcelona";"1";"Barcelona";"11";"Baix Llobregat";"08056";"Castelldefels";"4";"1";"A";"783";"274";"501";"605";"178";"2";"3";"600";"603"
"8";"Barcelona";"1";"Barcelona";"11";"Baix Llobregat";"08056";"Castelldefels";"4";"1";"B";"836";"295";"562";"685";"151";"3";"3";"679";"682"
"8";"Barcelona";"1";"Barcelona";"11";"Baix Llobregat";"08056";"Castelldefels";"4";"1";"C";"747";"259";"523";"630";"117";"0";"2";"628";"630"
"8";"Barcelona";"1";"Barcelona";"11";"Baix Llobregat";"08056";"Castelldefels";"4";"2";"A";"678";"204";"403";"500";"178";"2";"1";"497";"498"
"8";"Barcelona";"1";"Barcelona";"11";"Baix Llobregat";"08056";"Castelldefels";"4";"2";"B";"791";"207";"463";"614";"177";"0";"6";"608";"614"
"8";"Barcelona";"1";"Barcelona";"11";"Baix Llobregat";"08056";"Castelldefels";"4";"3";"A";"828";"229";"458";"583";"245";"0";"4";"579";"583"
"8";"Barcelona";"1";"Barcelona";"11";"Baix Llobregat";"08056";"Castelldefels";"4";"3";"B";"897";"249";"479";"612";"285";"1";"2";"609";"611"
"8";"Barcelona";"1";"Barcelona";"11";"Baix Llobregat";"08056";"Castelldefels";"4";"4";"A";"992";"285";"570";"673";"319";"1";"2";"670";"672"
"8";"Barcelona";"1";"Barcelona";"11";"Baix Llobregat";"08056";"Castelldefels";"4";"4";"B";"1109";"335";"601";"734";"375";"3";"2";"729";"731"
"8";"Barcelona";"1";"Barcelona";"11";"Baix Llobregat";"08056";"Castelldefels";"5";"1";"A";"669";"225";"426";"522";"147";"1";"1";"520";"521"
"8";"Barcelona";"1";"Barcelona";"11";"Baix Llobregat";"08056";"Castelldefels";"5";"1";"B";"786";"237";"479";"605";"181";"4";"4";"597";"601"
"8";"Barcelona";"1";"Barcelona";"11";"Baix Llobregat";"08056";"Castelldefels";"5";"1";"C";"671";"227";"419";"520";"151";"2";"2";"516";"518"
"8";"Barcelona";"1";"Barcelona";"11";"Baix Llobregat";"08056";"Castelldefels";"5";"2";"A";"986";"281";"572";"705";"281";"2";"2";"701";"703"
"8";"Barcelona";"1";"Barcelona";"11";"Baix Llobregat";"08056";"Castelldefels";"5";"2";"B";"1036";"317";"616";"780";"256";"1";"2";"777";"779"
"8";"Barcelona";"1";"Barcelona";"11";"Baix Llobregat";"08056";"Castelldefels";"5";"3";"A";"881";"260";"472";"578";"303";"3";"7";"568";"575"
"8";"Barcelona";"1";"Barcelona";"11";"Baix Llobregat";"08056";"Castelldefels";"5";"3";"B";"942";"283";"531";"647";"295";"2";"5";"640";"645"
"8";"Barcelona";"1";"Barcelona";"11";"Baix Llobregat";"08056";"Castelldefels";"5";"4";"A";"863";"311";"564";"697";"166";"2";"9";"686";"695"
"8";"Barcelona";"1";"Barcelona";"11";"Baix Llobregat";"08056";"Castelldefels";"5";"4";"B";"955";"260";"628";"779";"176";"1";"3";"775";"778"
"8";"Barcelona";"1";"Barcelona";"3";"Alt Penedès";"08058";"Castellet i la Gornal";"1";"1";"A";"462";"172";"315";"382";"80";"1";"0";"381";"381"
"8";"Barcelona";"1";"Barcelona";"3";"Alt Penedès";"08058";"Castellet i la Gornal";"1";"1";"B";"635";"224";"370";"458";"177";"4";"3";"451";"454"
"8";"Barcelona";"1";"Barcelona";"3";"Alt Penedès";"08058";"Castellet i la Gornal";"1";"1";"C";"648";"208";"389";"484";"164";"7";"1";"476";"477"
"8";"Barcelona";"1";"Barcelona";"11";"Baix Llobregat";"08066";"Castellví de Rosanes";"1";"1";"A";"491";"160";"325";"399";"92";"0";"1";"398";"399"
"8";"Barcelona";"1";"Barcelona";"11";"Baix Llobregat";"08066";"Castellví de Rosanes";"1";"1";"B";"549";"199";"350";"427";"122";"1";"1";"425";"426"
"8";"Barcelona";"1";"Barcelona";"11";"Baix Llobregat";"08066";"Castellví de Rosanes";"1";"1";"C";"315";"136";"223";"263";"52";"0";"3";"260";"263"
"8";"Barcelona";"1";"Barcelona";"3";"Alt Penedès";"08065";"Castellví de la Marca";"1";"1";"A";"534";"210";"364";"454";"80";"3";"7";"444";"451"
"8";"Barcelona";"1";"Barcelona";"3";"Alt Penedès";"08065";"Castellví de la Marca";"1";"1";"B";"640";"273";"448";"534";"106";"5";"11";"518";"529"
"8";"Barcelona";"1";"Barcelona";"40";"Vallès Occidental";"08266";"Cerdanyola del Vallès";"1";"1";"A";"548";"191";"361";"412";"136";"1";"4";"407";"411"
"8";"Barcelona";"1";"Barcelona";"40";"Vallès Occidental";"08266";"Cerdanyola del Vallès";"1";"1";"B";"609";"236";"405";"496";"113";"1";"2";"493";"495"
"8";"Barcelona";"1";"Barcelona";"40";"Vallès Occidental";"08266";"Cerdanyola del Vallès";"1";"1";"C";"663";"232";"414";"522";"141";"1";"1";"520";"521"
"8";"Barcelona";"1";"Barcelona";"40";"Vallès Occidental";"08266";"Cerdanyola del Vallès";"1";"10";"A";"824";"274";"515";"677";"147";"2";"2";"673";"675"
"8";"Barcelona";"1";"Barcelona";"40";"Vallès Occidental";"08266";"Cerdanyola del Vallès";"1";"10";"B";"810";"261";"530";"641";"169";"1";"1";"639";"640"
"8";"Barcelona";"1";"Barcelona";"40";"Vallès Occidental";"08266";"Cerdanyola del Vallès";"1";"11";"A";"544";"140";"292";"365";"179";"2";"1";"362";"363"
"8";"Barcelona";"1";"Barcelona";"40";"Vallès Occidental";"08266";"Cerdanyola del Vallès";"1";"11";"B";"611";"163";"324";"388";"223";"1";"3";"384";"387"
"8";"Barcelona";"1";"Barcelona";"40";"Vallès Occidental";"08266";"Cerdanyola del Vallès";"1";"12";"A";"525";"186";"332";"397";"128";"2";"1";"394";"395"
"8";"Barcelona";"1";"Barcelona";"40";"Vallès Occidental";"08266";"Cerdanyola del Vallès";"1";"12";"B";"702";"212";"458";"570";"132";"4";"3";"563";"566"
"8";"Barcelona";"1";"Barcelona";"40";"Vallès Occidental";"08266";"Cerdanyola del Vallès";"1";"12";"C";"577";"212";"381";"465";"112";"2";"4";"459";"463"
"8";"Barcelona";"1";"Barcelona";"40";"Vallès Occidental";"08266";"Cerdanyola del Vallès";"1";"13";"U";"851";"253";"540";"705";"146";"4";"3";"698";"701"
"8";"Barcelona";"1";"Barcelona";"40";"Vallès Occidental";"08266";"Cerdanyola del Vallès";"1";"14";"A";"800";"229";"513";"663";"137";"2";"2";"659";"661"
"8";"Barcelona";"1";"Barcelona";"40";"Vallès Occidental";"08266";"Cerdanyola del Vallès";"1";"14";"B";"806";"258";"549";"693";"113";"1";"4";"688";"692"
"8";"Barcelona";"1";"Barcelona";"40";"Vallès Occidental";"08266";"Cerdanyola del Vallès";"1";"15";"A";"740";"213";"466";"603";"137";"2";"0";"601";"601"
"8";"Barcelona";"1";"Barcelona";"40";"Vallès Occidental";"08266";"Cerdanyola del Vallès";"1";"15";"B";"824";"249";"495";"653";"171";"3";"1";"649";"650"
"8";"Barcelona";"1";"Barcelona";"40";"Vallès Occidental";"08266";"Cerdanyola del Vallès";"1";"16";"A";"615";"218";"393";"489";"126";"2";"4";"483";"487"
"8";"Barcelona";"1";"Barcelona";"40";"Vallès Occidental";"08266";"Cerdanyola del Vallès";"1";"16";"B";"655";"246";"422";"526";"129";"2";"0";"524";"524"
"8";"Barcelona";"1";"Barcelona";"40";"Vallès Occidental";"08266";"Cerdanyola del Vallès";"1";"17";"A";"727";"266";"471";"558";"169";"0";"2";"556";"558"
"8";"Barcelona";"1";"Barcelona";"40";"Vallès Occidental";"08266";"Cerdanyola del Vallès";"1";"17";"B";"857";"287";"520";"643";"214";"1";"1";"641";"642"
"8";"Barcelona";"1";"Barcelona";"40";"Vallès Occidental";"08266";"Cerdanyola del Vallès";"1";"18";"A";"619";"205";"388";"503";"116";"4";"2";"497";"499"
"8";"Barcelona";"1";"Barcelona";"40";"Vallès Occidental";"08266";"Cerdanyola del Vallès";"1";"18";"B";"733";"221";"465";"585";"148";"2";"1";"582";"583"
"8";"Barcelona";"1";"Barcelona";"40";"Vallès Occidental";"08266";"Cerdanyola del Vallès";"1";"18";"C";"645";"216";"416";"527";"118";"0";"2";"525";"527"
"8";"Barcelona";"1";"Barcelona";"40";"Vallès Occidental";"08266";"Cerdanyola del Vallès";"1";"19";"A";"524";"187";"332";"414";"110";"0";"4";"410";"414"
"8";"Barcelona";"1";"Barcelona";"40";"Vallès Occidental";"08266";"Cerdanyola del Vallès";"1";"19";"B";"645";"243";"417";"512";"133";"1";"1";"510";"511"
"8";"Barcelona";"1";"Barcelona";"40";"Vallès Occidental";"08266";"Cerdanyola del Vallès";"1";"19";"C";"536";"209";"368";"435";"101";"2";"3";"430";"433"
"8";"Barcelona";"1";"Barcelona";"40";"Vallès Occidental";"08266";"Cerdanyola del Vallès";"1";"2";"A";"436";"155";"290";"347";"89";"4";"2";"341";"343"
"8";"Barcelona";"1";"Barcelona";"40";"Vallès Occidental";"08266";"Cerdanyola del Vallès";"1";"2";"B";"544";"194";"352";"432";"112";"1";"1";"430";"431"
"8";"Barcelona";"1";"Barcelona";"40";"Vallès Occidental";"08266";"Cerdanyola del Vallès";"1";"2";"C";"606";"196";"390";"478";"128";"0";"3";"475";"478"
"8";"Barcelona";"1";"Barcelona";"40";"Vallès Occidental";"08266";"Cerdanyola del Vallès";"1";"20";"A";"692";"250";"514";"623";"69";"1";"5";"617";"622"
"8";"Barcelona";"1";"Barcelona";"40";"Vallès Occidental";"08266";"Cerdanyola del Vallès";"1";"20";"B";"524";"173";"371";"445";"79";"0";"1";"444";"445"
"8";"Barcelona";"1";"Barcelona";"40";"Vallès Occidental";"08266";"Cerdanyola del Vallès";"1";"20";"C";"775";"274";"568";"678";"97";"1";"6";"671";"677"
"8";"Barcelona";"1";"Barcelona";"40";"Vallès Occidental";"08266";"Cerdanyola del Vallès";"1";"27";"A";"652";"200";"362";"453";"199";"3";"1";"449";"450"
"8";"Barcelona";"1";"Barcelona";"40";"Vallès Occidental";"08266";"Cerdanyola del Vallès";"1";"27";"B";"649";"207";"386";"463";"186";"2";"1";"460";"461"
"8";"Barcelona";"1";"Barcelona";"40";"Vallès Occidental";"08266";"Cerdanyola del Vallès";"1";"28";"A";"582";"216";"396";"501";"81";"4";"2";"495";"497"
"8";"Barcelona";"1";"Barcelona";"40";"Vallès Occidental";"08266";"Cerdanyola del Vallès";"1";"28";"B";"766";"260";"531";"660";"106";"0";"3";"657";"660"
"8";"Barcelona";"1";"Barcelona";"40";"Vallès Occidental";"08266";"Cerdanyola del Vallès";"1";"29";"A";"734";"242";"490";"616";"118";"2";"7";"607";"614"
"8";"Barcelona";"1";"Barcelona";"40";"Vallès Occidental";"08266";"Cerdanyola del Vallès";"1";"29";"B";"800";"274";"527";"677";"123";"2";"0";"675";"675"
"8";"Barcelona";"1";"Barcelona";"40";"Vallès Occidental";"08266";"Cerdanyola del Vallès";"1";"3";"A";"556";"216";"366";"428";"128";"2";"2";"424";"426"
"8";"Barcelona";"1";"Barcelona";"40";"Vallès Occidental";"08266";"Cerdanyola del Vallès";"1";"3";"B";"671";"248";"434";"514";"157";"2";"2";"510";"512"
"8";"Barcelona";"1";"Barcelona";"40";"Vallès Occidental";"08266";"Cerdanyola del Vallès";"1";"30";"A";"531";"201";"377";"457";"74";"2";"3";"452";"455"
"8";"Barcelona";"1";"Barcelona";"40";"Vallès Occidental";"08266";"Cerdanyola del Vallès";"1";"30";"B";"661";"208";"446";"565";"96";"0";"3";"562";"565"
"8";"Barcelona";"1";"Barcelona";"40";"Vallès Occidental";"08266";"Cerdanyola del Vallès";"1";"30";"C";"705";"262";"477";"581";"124";"1";"4";"576";"580"
"8";"Barcelona";"1";"Barcelona";"40";"Vallès Occidental";"08266";"Cerdanyola del Vallès";"1";"31";"A";"417";"134";"264";"334";"83";"1";"1";"332";"333"
"8";"Barcelona";"1";"Barcelona";"40";"Vallès Occidental";"08266";"Cerdanyola del Vallès";"1";"31";"B";"482";"198";"345";"426";"56";"0";"0";"426";"426"
"8";"Barcelona";"1";"Barcelona";"40";"Vallès Occidental";"08266";"Cerdanyola del Vallès";"1";"32";"U";"634";"212";"434";"533";"101";"0";"0";"533";"533"
"8";"Barcelona";"1";"Barcelona";"40";"Vallès Occidental";"08266";"Cerdanyola del Vallès";"1";"33";"A";"529";"181";"338";"425";"104";"4";"3";"418";"421"
"8";"Barcelona";"1";"Barcelona";"40";"Vallès Occidental";"08266";"Cerdanyola del Vallès";"1";"33";"B";"613";"197";"384";"485";"128";"4";"4";"477";"481"
"8";"Barcelona";"1";"Barcelona";"40";"Vallès Occidental";"08266";"Cerdanyola del Vallès";"1";"34";"A";"696";"222";"451";"566";"130";"2";"1";"563";"564"
"8";"Barcelona";"1";"Barcelona";"40";"Vallès Occidental";"08266";"Cerdanyola del Vallès";"1";"34";"B";"775";"250";"465";"599";"176";"0";"0";"599";"599"
"8";"Barcelona";"1";"Barcelona";"40";"Vallès Occidental";"08266";"Cerdanyola del Vallès";"1";"35";"A";"750";"207";"451";"619";"131";"1";"4";"614";"618"
"8";"Barcelona";"1";"Barcelona";"40";"Vallès Occidental";"08266";"Cerdanyola del Vallès";"1";"35";"B";"832";"245";"511";"662";"170";"2";"6";"654";"660"
"8";"Barcelona";"1";"Barcelona";"40";"Vallès Occidental";"08266";"Cerdanyola del Vallès";"1";"36";"A";"497";"162";"350";"424";"73";"1";"2";"421";"423"
"8";"Barcelona";"1";"Barcelona";"40";"Vallès Occidental";"08266";"Cerdanyola del Vallès";"1";"36";"B";"587";"200";"395";"493";"94";"1";"2";"490";"492"
"8";"Barcelona";"1";"Barcelona";"40";"Vallès Occidental";"08266";"Cerdanyola del Vallès";"1";"37";"A";"458";"145";"281";"374";"84";"0";"1";"373";"374"
"8";"Barcelona";"1";"Barcelona";"40";"Vallès Occidental";"08266";"Cerdanyola del Vallès";"1";"37";"B";"492";"135";"283";"383";"109";"0";"0";"383";"383"
"8";"Barcelona";"1";"Barcelona";"40";"Vallès Occidental";"08266";"Cerdanyola del Vallès";"1";"38";"U";"846";"239";"530";"699";"147";"2";"4";"693";"697"
"8";"Barcelona";"1";"Barcelona";"40";"Vallès Occidental";"08266";"Cerdanyola del Vallès";"1";"4";"A";"552";"177";"323";"402";"150";"1";"1";"400";"401"
"8";"Barcelona";"1";"Barcelona";"40";"Vallès Occidental";"08266";"Cerdanyola del Vallès";"1";"4";"B";"665";"216";"403";"508";"157";"1";"6";"501";"507"
"8";"Barcelona";"1";"Barcelona";"40";"Vallès Occidental";"08266";"Cerdanyola del Vallès";"1";"5";"U";"776";"226";"464";"592";"184";"1";"3";"588";"591"
"8";"Barcelona";"1";"Barcelona";"40";"Vallès Occidental";"08266";"Cerdanyola del Vallès";"1";"6";"A";"658";"247";"424";"550";"108";"1";"3";"546";"549"
"8";"Barcelona";"1";"Barcelona";"40";"Vallès Occidental";"08266";"Cerdanyola del Vallès";"1";"6";"B";"730";"257";"509";"609";"121";"3";"4";"602";"606"
"8";"Barcelona";"1";"Barcelona";"40";"Vallès Occidental";"08266";"Cerdanyola del Vallès";"1";"7";"U";"625";"219";"425";"518";"107";"0";"4";"514";"518"
"8";"Barcelona";"1";"Barcelona";"40";"Vallès Occidental";"08266";"Cerdanyola del Vallès";"1";"8";"A";"566";"187";"339";"434";"132";"0";"2";"432";"434"
"8";"Barcelona";"1";"Barcelona";"40";"Vallès Occidental";"08266";"Cerdanyola del Vallès";"1";"8";"B";"702";"246";"433";"555";"147";"1";"1";"553";"554"
"8";"Barcelona";"1";"Barcelona";"40";"Vallès Occidental";"08266";"Cerdanyola del Vallès";"1";"9";"A";"609";"201";"399";"500";"109";"2";"3";"495";"498"
"8";"Barcelona";"1";"Barcelona";"40";"Vallès Occidental";"08266";"Cerdanyola del Vallès";"1";"9";"B";"722";"227";"446";"564";"158";"0";"0";"564";"564"
"8";"Barcelona";"1";"Barcelona";"11";"Baix Llobregat";"08068";"Cervelló";"1";"1";"A";"637";"227";"413";"496";"141";"2";"2";"492";"494"
"8";"Barcelona";"1";"Barcelona";"11";"Baix Llobregat";"08068";"Cervelló";"1";"1";"B";"638";"220";"387";"483";"155";"3";"2";"478";"480"
"8";"Barcelona";"1";"Barcelona";"11";"Baix Llobregat";"08068";"Cervelló";"1";"1";"C";"639";"254";"417";"499";"140";"1";"1";"497";"498"
"8";"Barcelona";"1";"Barcelona";"11";"Baix Llobregat";"08068";"Cervelló";"1";"2";"A";"733";"238";"470";"536";"197";"0";"2";"534";"536"
"8";"Barcelona";"1";"Barcelona";"11";"Baix Llobregat";"08068";"Cervelló";"1";"2";"B";"837";"252";"523";"617";"220";"1";"3";"613";"616"
"8";"Barcelona";"1";"Barcelona";"11";"Baix Llobregat";"08068";"Cervelló";"1";"3";"U";"781";"281";"533";"629";"152";"1";"1";"627";"628"
"8";"Barcelona";"1";"Barcelona";"11";"Baix Llobregat";"08068";"Cervelló";"1";"4";"A";"596";"212";"400";"480";"116";"1";"1";"478";"479"
"8";"Barcelona";"1";"Barcelona";"11";"Baix Llobregat";"08068";"Cervelló";"1";"4";"B";"658";"220";"418";"511";"147";"1";"5";"505";"510"
"8";"Barcelona";"1";"Barcelona";"11";"Baix Llobregat";"08068";"Cervelló";"1";"4";"C";"593";"235";"395";"479";"114";"0";"1";"478";"479"
"8";"Barcelona";"1";"Barcelona";"11";"Baix Llobregat";"08068";"Cervelló";"1";"5";"U";"632";"237";"375";"480";"152";"0";"3";"477";"480"
"8";"Barcelona";"1";"Barcelona";"11";"Baix Llobregat";"08069";"Collbató";"1";"1";"A";"591";"235";"410";"508";"83";"2";"6";"500";"506"
"8";"Barcelona";"1";"Barcelona";"11";"Baix Llobregat";"08069";"Collbató";"1";"1";"B";"609";"218";"417";"520";"89";"0";"3";"517";"520"
"8";"Barcelona";"1";"Barcelona";"11";"Baix Llobregat";"08069";"Collbató";"1";"1";"C";"564";"211";"375";"482";"82";"2";"1";"479";"480"
"8";"Barcelona";"1";"Barcelona";"11";"Baix Llobregat";"08069";"Collbató";"1";"3";"A";"615";"268";"408";"505";"110";"1";"3";"501";"504"
"8";"Barcelona";"1";"Barcelona";"11";"Baix Llobregat";"08069";"Collbató";"1";"3";"B";"791";"315";"517";"629";"162";"4";"7";"618";"625"
"8";"Barcelona";"1";"Barcelona";"11";"Baix Llobregat";"08072";"Corbera de Llobregat";"1";"1";"U";"893";"311";"560";"690";"203";"6";"4";"680";"684"
"8";"Barcelona";"1";"Barcelona";"11";"Baix Llobregat";"08072";"Corbera de Llobregat";"1";"10";"A";"559";"216";"348";"417";"142";"0";"4";"413";"417"
"8";"Barcelona";"1";"Barcelona";"11";"Baix Llobregat";"08072";"Corbera de Llobregat";"1";"10";"B";"531";"194";"320";"388";"143";"2";"4";"382";"386"
"8";"Barcelona";"1";"Barcelona";"11";"Baix Llobregat";"08072";"Corbera de Llobregat";"1";"11";"U";"846";"299";"543";"669";"177";"1";"1";"667";"668"
"8";"Barcelona";"1";"Barcelona";"11";"Baix Llobregat";"08072";"Corbera de Llobregat";"1";"2";"A";"592";"196";"377";"472";"120";"2";"2";"468";"470"
"8";"Barcelona";"1";"Barcelona";"11";"Baix Llobregat";"08072";"Corbera de Llobregat";"1";"2";"B";"636";"220";"395";"485";"151";"0";"1";"484";"485"
"8";"Barcelona";"1";"Barcelona";"11";"Baix Llobregat";"08072";"Corbera de Llobregat";"1";"2";"C";"584";"206";"388";"472";"112";"2";"3";"467";"470"
"8";"Barcelona";"1";"Barcelona";"11";"Baix Llobregat";"08072";"Corbera de Llobregat";"1";"3";"A";"522";"157";"281";"352";"170";"2";"0";"350";"350"
"8";"Barcelona";"1";"Barcelona";"11";"Baix Llobregat";"08072";"Corbera de Llobregat";"1";"3";"B";"562";"206";"341";"413";"149";"1";"5";"407";"412"
"8";"Barcelona";"1";"Barcelona";"11";"Baix Llobregat";"08072";"Corbera de Llobregat";"1";"4";"U";"640";"225";"416";"519";"121";"0";"1";"518";"519"
"8";"Barcelona";"1";"Barcelona";"11";"Baix Llobregat";"08072";"Corbera de Llobregat";"1";"5";"U";"757";"266";"471";"574";"183";"2";"3";"569";"572"
"8";"Barcelona";"1";"Barcelona";"11";"Baix Llobregat";"08072";"Corbera de Llobregat";"1";"6";"U";"884";"277";"536";"673";"211";"1";"4";"668";"672"
"8";"Barcelona";"1";"Barcelona";"11";"Baix Llobregat";"08072";"Corbera de Llobregat";"1";"7";"U";"792";"286";"503";"595";"197";"0";"5";"590";"595"
"8";"Barcelona";"1";"Barcelona";"11";"Baix Llobregat";"08072";"Corbera de Llobregat";"1";"8";"U";"880";"307";"587";"694";"186";"1";"0";"693";"693"
"8";"Barcelona";"1";"Barcelona";"11";"Baix Llobregat";"08072";"Corbera de Llobregat";"1";"9";"U";"575";"179";"344";"420";"155";"6";"1";"413";"414"
"8";"Barcelona";"1";"Barcelona";"11";"Baix Llobregat";"08073";"Cornellà de Llobregat";"1";"1";"A";"841";"283";"522";"653";"188";"7";"5";"641";"646"
"8";"Barcelona";"1";"Barcelona";"11";"Baix Llobregat";"08073";"Cornellà de Llobregat";"1";"1";"B";"936";"316";"639";"756";"180";"4";"3";"749";"752"
"8";"Barcelona";"1";"Barcelona";"11";"Baix Llobregat";"08073";"Cornellà de Llobregat";"1";"10";"A";"472";"182";"304";"386";"86";"1";"3";"382";"385"
"8";"Barcelona";"1";"Barcelona";"11";"Baix Llobregat";"08073";"Cornellà de Llobregat";"1";"10";"B";"575";"207";"351";"458";"117";"0";"2";"456";"458"
"8";"Barcelona";"1";"Barcelona";"11";"Baix Llobregat";"08073";"Cornellà de Llobregat";"1";"11";"A";"391";"120";"217";"292";"99";"0";"1";"291";"292"
"8";"Barcelona";"1";"Barcelona";"11";"Baix Llobregat";"08073";"Cornellà de Llobregat";"1";"11";"B";"423";"136";"234";"322";"101";"0";"0";"322";"322"
"8";"Barcelona";"1";"Barcelona";"11";"Baix Llobregat";"08073";"Cornellà de Llobregat";"1";"12";"U";"724";"233";"431";"543";"181";"0";"3";"540";"543"
"8";"Barcelona";"1";"Barcelona";"11";"Baix Llobregat";"08073";"Cornellà de Llobregat";"1";"13";"A";"529";"188";"339";"428";"101";"1";"2";"425";"427"
"8";"Barcelona";"1";"Barcelona";"11";"Baix Llobregat";"08073";"Cornellà de Llobregat";"1";"13";"B";"542";"178";"304";"412";"130";"1";"1";"410";"411"
"8";"Barcelona";"1";"Barcelona";"11";"Baix Llobregat";"08073";"Cornellà de Llobregat";"1";"14";"U";"1025";"367";"676";"837";"188";"3";"0";"834";"834"
"8";"Barcelona";"1";"Barcelona";"11";"Baix Llobregat";"08073";"Cornellà de Llobregat";"1";"2";"A";"640";"231";"430";"522";"118";"1";"4";"517";"521"
"8";"Barcelona";"1";"Barcelona";"11";"Baix Llobregat";"08073";"Cornellà de Llobregat";"1";"2";"B";"718";"233";"468";"570";"148";"6";"1";"563";"564"
"8";"Barcelona";"1";"Barcelona";"11";"Baix Llobregat";"08073";"Cornellà de Llobregat";"1";"3";"A";"513";"171";"274";"382";"131";"2";"2";"378";"380"
"8";"Barcelona";"1";"Barcelona";"11";"Baix Llobregat";"08073";"Cornellà de Llobregat";"1";"3";"B";"570";"189";"324";"428";"142";"1";"2";"425";"427"
"8";"Barcelona";"1";"Barcelona";"11";"Baix Llobregat";"08073";"Cornellà de Llobregat";"1";"4";"A";"708";"220";"438";"563";"145";"0";"1";"562";"563"
"8";"Barcelona";"1";"Barcelona";"11";"Baix Llobregat";"08073";"Cornellà de Llobregat";"1";"4";"B";"832";"221";"512";"664";"168";"1";"3";"660";"663"
"8";"Barcelona";"1";"Barcelona";"11";"Baix Llobregat";"08073";"Cornellà de Llobregat";"1";"5";"U";"906";"324";"543";"725";"181";"2";"1";"722";"723"
"8";"Barcelona";"1";"Barcelona";"11";"Baix Llobregat";"08073";"Cornellà de Llobregat";"1";"6";"U";"607";"199";"389";"494";"113";"1";"1";"492";"493"
"8";"Barcelona";"1";"Barcelona";"11";"Baix Llobregat";"08073";"Cornellà de Llobregat";"1";"7";"A";"685";"229";"448";"575";"110";"0";"3";"572";"575"
"8";"Barcelona";"1";"Barcelona";"11";"Baix Llobregat";"08073";"Cornellà de Llobregat";"1";"7";"B";"783";"245";"516";"650";"133";"0";"8";"642";"650"
"8";"Barcelona";"1";"Barcelona";"11";"Baix Llobregat";"08073";"Cornellà de Llobregat";"1";"8";"A";"661";"218";"435";"544";"117";"2";"2";"540";"542"
"8";"Barcelona";"1";"Barcelona";"11";"Baix Llobregat";"08073";"Cornellà de Llobregat";"1";"8";"B";"745";"245";"453";"596";"149";"2";"8";"586";"594"
"8";"Barcelona";"1";"Barcelona";"11";"Baix Llobregat";"08073";"Cornellà de Llobregat";"1";"9";"A";"368";"134";"234";"301";"67";"3";"1";"297";"298"
"8";"Barcelona";"1";"Barcelona";"11";"Baix Llobregat";"08073";"Cornellà de Llobregat";"1";"9";"B";"373";"153";"250";"304";"69";"4";"2";"298";"300"
"8";"Barcelona";"1";"Barcelona";"11";"Baix Llobregat";"08073";"Cornellà de Llobregat";"2";"1";"A";"730";"213";"443";"584";"146";"0";"2";"582";"584"
"8";"Barcelona";"1";"Barcelona";"11";"Baix Llobregat";"08073";"Cornellà de Llobregat";"2";"1";"B";"776";"236";"493";"634";"142";"0";"3";"631";"634"
"8";"Barcelona";"1";"Barcelona";"11";"Baix Llobregat";"08073";"Cornellà de Llobregat";"2";"1";"C";"825";"266";"497";"643";"182";"2";"4";"637";"641"
"8";"Barcelona";"1";"Barcelona";"11";"Baix Llobregat";"08073";"Cornellà de Llobregat";"2";"2";"A";"607";"176";"389";"500";"107";"2";"1";"497";"498"
"8";"Barcelona";"1";"Barcelona";"11";"Baix Llobregat";"08073";"Cornellà de Llobregat";"2";"2";"B";"575";"146";"364";"463";"112";"1";"1";"461";"462"
"8";"Barcelona";"1";"Barcelona";"11";"Baix Llobregat";"08073";"Cornellà de Llobregat";"2";"2";"C";"623";"177";"391";"496";"127";"1";"1";"494";"495"
"8";"Barcelona";"1";"Barcelona";"11";"Baix Llobregat";"08073";"Cornellà de Llobregat";"3";"1";"A";"393";"156";"257";"309";"84";"1";"2";"306";"308"
"8";"Barcelona";"1";"Barcelona";"11";"Baix Llobregat";"08073";"Cornellà de Llobregat";"3";"1";"B";"451";"158";"288";"361";"90";"1";"2";"358";"360"
"8";"Barcelona";"1";"Barcelona";"11";"Baix Llobregat";"08073";"Cornellà de Llobregat";"3";"2";"A";"341";"116";"208";"254";"87";"1";"2";"251";"253"
"8";"Barcelona";"1";"Barcelona";"11";"Baix Llobregat";"08073";"Cornellà de Llobregat";"3";"2";"B";"341";"112";"219";"261";"80";"2";"0";"259";"259"
"8";"Barcelona";"1";"Barcelona";"11";"Baix Llobregat";"08073";"Cornellà de Llobregat";"3";"3";"U";"679";"208";"403";"513";"166";"2";"3";"508";"511"
"8";"Barcelona";"1";"Barcelona";"11";"Baix Llobregat";"08073";"Cornellà de Llobregat";"3";"4";"A";"882";"227";"567";"732";"150";"2";"4";"726";"730"
"8";"Barcelona";"1";"Barcelona";"11";"Baix Llobregat";"08073";"Cornellà de Llobregat";"3";"4";"B";"1039";"262";"665";"875";"164";"1";"3";"871";"874"
"8";"Barcelona";"1";"Barcelona";"11";"Baix Llobregat";"08073";"Cornellà de Llobregat";"3";"4";"C";"933";"207";"576";"772";"161";"3";"3";"766";"769"
"8";"Barcelona";"1";"Barcelona";"11";"Baix Llobregat";"08073";"Cornellà de Llobregat";"3";"5";"A";"666";"192";"402";"530";"136";"2";"2";"526";"528"
"8";"Barcelona";"1";"Barcelona";"11";"Baix Llobregat";"08073";"Cornellà de Llobregat";"3";"5";"B";"698";"210";"417";"546";"152";"1";"6";"539";"545"
"8";"Barcelona";"1";"Barcelona";"11";"Baix Llobregat";"08073";"Cornellà de Llobregat";"3";"6";"U";"685";"202";"439";"548";"137";"2";"4";"542";"546"
"8";"Barcelona";"1";"Barcelona";"11";"Baix Llobregat";"08073";"Cornellà de Llobregat";"3";"7";"A";"428";"141";"240";"303";"125";"1";"2";"300";"302"
"8";"Barcelona";"1";"Barcelona";"11";"Baix Llobregat";"08073";"Cornellà de Llobregat";"3";"7";"B";"536";"180";"330";"422";"114";"1";"3";"418";"421"
"8";"Barcelona";"1";"Barcelona";"11";"Baix Llobregat";"08073";"Cornellà de Llobregat";"3";"8";"U";"1071";"258";"625";"854";"217";"5";"5";"844";"849"
"8";"Barcelona";"1";"Barcelona";"11";"Baix Llobregat";"08073";"Cornellà de Llobregat";"3";"9";"A";"325";"97";"196";"237";"88";"1";"0";"236";"236"
"8";"Barcelona";"1";"Barcelona";"11";"Baix Llobregat";"08073";"Cornellà de Llobregat";"3";"9";"B";"394";"118";"245";"301";"93";"1";"0";"300";"300"
"8";"Barcelona";"1";"Barcelona";"11";"Baix Llobregat";"08073";"Cornellà de Llobregat";"4";"1";"A";"460";"169";"302";"354";"106";"2";"3";"349";"352"
"8";"Barcelona";"1";"Barcelona";"11";"Baix Llobregat";"08073";"Cornellà de Llobregat";"4";"1";"B";"542";"163";"339";"433";"109";"1";"2";"430";"432"
"8";"Barcelona";"1";"Barcelona";"11";"Baix Llobregat";"08073";"Cornellà de Llobregat";"4";"10";"A";"371";"120";"211";"268";"103";"0";"0";"268";"268"
"8";"Barcelona";"1";"Barcelona";"11";"Baix Llobregat";"08073";"Cornellà de Llobregat";"4";"10";"B";"448";"133";"324";"338";"110";"0";"0";"338";"338"
"8";"Barcelona";"1";"Barcelona";"11";"Baix Llobregat";"08073";"Cornellà de Llobregat";"4";"11";"A";"393";"114";"208";"288";"105";"0";"0";"288";"288"
"8";"Barcelona";"1";"Barcelona";"11";"Baix Llobregat";"08073";"Cornellà de Llobregat";"4";"11";"B";"405";"143";"238";"300";"105";"0";"1";"299";"300"
"8";"Barcelona";"1";"Barcelona";"11";"Baix Llobregat";"08073";"Cornellà de Llobregat";"4";"12";"A";"462";"161";"282";"344";"118";"0";"3";"341";"344"
"8";"Barcelona";"1";"Barcelona";"11";"Baix Llobregat";"08073";"Cornellà de Llobregat";"4";"12";"B";"518";"170";"311";"378";"140";"2";"4";"372";"376"
"8";"Barcelona";"1";"Barcelona";"11";"Baix Llobregat";"08073";"Cornellà de Llobregat";"4";"13";"A";"572";"199";"358";"468";"104";"1";"1";"466";"467"
"8";"Barcelona";"1";"Barcelona";"11";"Baix Llobregat";"08073";"Cornellà de Llobregat";"4";"13";"B";"620";"214";"370";"473";"147";"0";"3";"470";"473"
"8";"Barcelona";"1";"Barcelona";"11";"Baix Llobregat";"08073";"Cornellà de Llobregat";"4";"14";"A";"377";"126";"218";"291";"86";"0";"1";"290";"291"
"8";"Barcelona";"1";"Barcelona";"11";"Baix Llobregat";"08073";"Cornellà de Llobregat";"4";"14";"B";"467";"148";"275";"378";"89";"0";"1";"377";"378"
"8";"Barcelona";"1";"Barcelona";"11";"Baix Llobregat";"08073";"Cornellà de Llobregat";"4";"15";"A";"321";"114";"195";"239";"82";"0";"1";"238";"239"
"8";"Barcelona";"1";"Barcelona";"11";"Baix Llobregat";"08073";"Cornellà de Llobregat";"4";"15";"B";"424";"145";"269";"323";"101";"1";"2";"320";"322"
"8";"Barcelona";"1";"Barcelona";"11";"Baix Llobregat";"08073";"Cornellà de Llobregat";"4";"16";"A";"437";"136";"271";"340";"97";"2";"2";"336";"338"
"8";"Barcelona";"1";"Barcelona";"11";"Baix Llobregat";"08073";"Cornellà de Llobregat";"4";"16";"B";"517";"179";"321";"420";"97";"0";"1";"419";"420"
"8";"Barcelona";"1";"Barcelona";"11";"Baix Llobregat";"08073";"Cornellà de Llobregat";"4";"17";"A";"432";"166";"280";"337";"95";"0";"1";"336";"337"
"8";"Barcelona";"1";"Barcelona";"11";"Baix Llobregat";"08073";"Cornellà de Llobregat";"4";"17";"B";"486";"167";"284";"361";"125";"0";"1";"360";"361"
"8";"Barcelona";"1";"Barcelona";"11";"Baix Llobregat";"08073";"Cornellà de Llobregat";"4";"18";"U";"634";"196";"383";"493";"141";"1";"2";"490";"492"
"8";"Barcelona";"1";"Barcelona";"11";"Baix Llobregat";"08073";"Cornellà de Llobregat";"4";"19";"U";"648";"192";"389";"493";"155";"4";"1";"488";"489"
"8";"Barcelona";"1";"Barcelona";"11";"Baix Llobregat";"08073";"Cornellà de Llobregat";"4";"2";"U";"536";"165";"323";"428";"108";"0";"0";"428";"428"
"8";"Barcelona";"1";"Barcelona";"11";"Baix Llobregat";"08073";"Cornellà de Llobregat";"4";"3";"A";"505";"160";"298";"398";"107";"1";"2";"395";"397"
"8";"Barcelona";"1";"Barcelona";"11";"Baix Llobregat";"08073";"Cornellà de Llobregat";"4";"3";"B";"621";"178";"366";"482";"139";"2";"1";"479";"480"
"8";"Barcelona";"1";"Barcelona";"11";"Baix Llobregat";"08073";"Cornellà de Llobregat";"4";"4";"A";"358";"119";"220";"264";"94";"2";"1";"261";"262"
"8";"Barcelona";"1";"Barcelona";"11";"Baix Llobregat";"08073";"Cornellà de Llobregat";"4";"4";"B";"404";"132";"220";"311";"93";"2";"1";"308";"309"
"8";"Barcelona";"1";"Barcelona";"11";"Baix Llobregat";"08073";"Cornellà de Llobregat";"4";"5";"A";"292";"108";"210";"246";"46";"1";"0";"245";"245"
"8";"Barcelona";"1";"Barcelona";"11";"Baix Llobregat";"08073";"Cornellà de Llobregat";"4";"5";"B";"346";"106";"197";"273";"73";"3";"1";"269";"270"
"8";"Barcelona";"1";"Barcelona";"11";"Baix Llobregat";"08073";"Cornellà de Llobregat";"4";"6";"A";"449";"162";"290";"355";"94";"2";"0";"353";"353"
"8";"Barcelona";"1";"Barcelona";"11";"Baix Llobregat";"08073";"Cornellà de Llobregat";"4";"6";"B";"502";"175";"313";"388";"114";"0";"2";"386";"388"
"8";"Barcelona";"1";"Barcelona";"11";"Baix Llobregat";"08073";"Cornellà de Llobregat";"4";"7";"A";"374";"109";"198";"279";"95";"0";"1";"278";"279"
"8";"Barcelona";"1";"Barcelona";"11";"Baix Llobregat";"08073";"Cornellà de Llobregat";"4";"7";"B";"454";"136";"246";"326";"128";"1";"4";"321";"325"
"8";"Barcelona";"1";"Barcelona";"11";"Baix Llobregat";"08073";"Cornellà de Llobregat";"4";"8";"A";"493";"173";"310";"380";"113";"1";"6";"373";"379"
"8";"Barcelona";"1";"Barcelona";"11";"Baix Llobregat";"08073";"Cornellà de Llobregat";"4";"8";"B";"599";"213";"385";"458";"141";"2";"3";"453";"456"
"8";"Barcelona";"1";"Barcelona";"11";"Baix Llobregat";"08073";"Cornellà de Llobregat";"4";"9";"U";"662";"223";"395";"516";"146";"3";"2";"511";"513"
"8";"Barcelona";"1";"Barcelona";"11";"Baix Llobregat";"08073";"Cornellà de Llobregat";"5";"1";"U";"560";"174";"305";"386";"174";"1";"1";"384";"385"
"8";"Barcelona";"1";"Barcelona";"11";"Baix Llobregat";"08073";"Cornellà de Llobregat";"5";"10";"A";"391";"131";"234";"288";"103";"2";"2";"284";"286"
"8";"Barcelona";"1";"Barcelona";"11";"Baix Llobregat";"08073";"Cornellà de Llobregat";"5";"10";"B";"401";"129";"224";"301";"100";"2";"1";"298";"299"
"8";"Barcelona";"1";"Barcelona";"11";"Baix Llobregat";"08073";"Cornellà de Llobregat";"5";"2";"U";"562";"141";"276";"331";"231";"1";"0";"330";"330"
"8";"Barcelona";"1";"Barcelona";"11";"Baix Llobregat";"08073";"Cornellà de Llobregat";"5";"3";"A";"332";"98";"174";"214";"118";"3";"2";"209";"211"
"8";"Barcelona";"1";"Barcelona";"11";"Baix Llobregat";"08073";"Cornellà de Llobregat";"5";"3";"B";"345";"98";"178";"224";"121";"2";"0";"222";"222"
"8";"Barcelona";"1";"Barcelona";"11";"Baix Llobregat";"08073";"Cornellà de Llobregat";"5";"4";"U";"519";"154";"274";"332";"187";"2";"5";"325";"330"
"8";"Barcelona";"1";"Barcelona";"11";"Baix Llobregat";"08073";"Cornellà de Llobregat";"5";"5";"U";"615";"162";"335";"410";"205";"1";"0";"409";"409"
"8";"Barcelona";"1";"Barcelona";"11";"Baix Llobregat";"08073";"Cornellà de Llobregat";"5";"6";"A";"340";"125";"206";"250";"90";"2";"0";"248";"248"
"8";"Barcelona";"1";"Barcelona";"11";"Baix Llobregat";"08073";"Cornellà de Llobregat";"5";"6";"B";"389";"136";"230";"282";"107";"2";"0";"280";"280"
"8";"Barcelona";"1";"Barcelona";"11";"Baix Llobregat";"08073";"Cornellà de Llobregat";"5";"7";"A";"343";"90";"177";"214";"129";"2";"0";"212";"212"
"8";"Barcelona";"1";"Barcelona";"11";"Baix Llobregat";"08073";"Cornellà de Llobregat";"5";"7";"B";"392";"124";"166";"275";"117";"3";"2";"270";"272"
"8";"Barcelona";"1";"Barcelona";"11";"Baix Llobregat";"08073";"Cornellà de Llobregat";"5";"8";"A";"319";"97";"205";"205";"114";"2";"0";"203";"203"
"8";"Barcelona";"1";"Barcelona";"11";"Baix Llobregat";"08073";"Cornellà de Llobregat";"5";"8";"B";"341";"105";"177";"224";"117";"0";"2";"222";"224"
"8";"Barcelona";"1";"Barcelona";"11";"Baix Llobregat";"08073";"Cornellà de Llobregat";"5";"9";"U";"716";"242";"450";"578";"138";"3";"4";"571";"575"
"8";"Barcelona";"1";"Barcelona";"11";"Baix Llobregat";"08073";"Cornellà de Llobregat";"6";"1";"U";"439";"119";"208";"252";"187";"4";"0";"248";"248"
"8";"Barcelona";"1";"Barcelona";"11";"Baix Llobregat";"08073";"Cornellà de Llobregat";"6";"10";"U";"584";"183";"270";"425";"159";"2";"4";"419";"423"
"8";"Barcelona";"1";"Barcelona";"11";"Baix Llobregat";"08073";"Cornellà de Llobregat";"6";"11";"U";"380";"118";"186";"243";"137";"0";"0";"243";"243"
"8";"Barcelona";"1";"Barcelona";"11";"Baix Llobregat";"08073";"Cornellà de Llobregat";"6";"12";"U";"605";"189";"332";"452";"153";"0";"0";"452";"452"
"8";"Barcelona";"1";"Barcelona";"11";"Baix Llobregat";"08073";"Cornellà de Llobregat";"6";"13";"U";"490";"163";"279";"334";"156";"0";"0";"334";"334"
"8";"Barcelona";"1";"Barcelona";"11";"Baix Llobregat";"08073";"Cornellà de Llobregat";"6";"14";"U";"616";"193";"364";"455";"161";"1";"2";"452";"454"
"8";"Barcelona";"1";"Barcelona";"11";"Baix Llobregat";"08073";"Cornellà de Llobregat";"6";"15";"U";"882";"264";"571";"720";"162";"0";"4";"716";"720"
"8";"Barcelona";"1";"Barcelona";"11";"Baix Llobregat";"08073";"Cornellà de Llobregat";"6";"16";"U";"481";"143";"338";"340";"141";"1";"3";"336";"339"
"8";"Barcelona";"1";"Barcelona";"11";"Baix Llobregat";"08073";"Cornellà de Llobregat";"6";"2";"A";"332";"95";"187";"246";"86";"1";"1";"244";"245"
"8";"Barcelona";"1";"Barcelona";"11";"Baix Llobregat";"08073";"Cornellà de Llobregat";"6";"2";"B";"381";"118";"199";"256";"125";"2";"1";"253";"254"
"8";"Barcelona";"1";"Barcelona";"11";"Baix Llobregat";"08073";"Cornellà de Llobregat";"6";"3";"U";"393";"129";"199";"256";"137";"1";"0";"255";"255"
"8";"Barcelona";"1";"Barcelona";"11";"Baix Llobregat";"08073";"Cornellà de Llobregat";"6";"4";"U";"400";"146";"233";"288";"112";"0";"2";"286";"288"
"8";"Barcelona";"1";"Barcelona";"11";"Baix Llobregat";"08073";"Cornellà de Llobregat";"6";"5";"U";"529";"163";"292";"346";"183";"0";"3";"343";"346"
"8";"Barcelona";"1";"Barcelona";"11";"Baix Llobregat";"08073";"Cornellà de Llobregat";"6";"6";"U";"427";"132";"252";"286";"141";"0";"0";"286";"286"
"8";"Barcelona";"1";"Barcelona";"11";"Baix Llobregat";"08073";"Cornellà de Llobregat";"6";"7";"A";"321";"91";"183";"231";"90";"2";"2";"227";"229"
"8";"Barcelona";"1";"Barcelona";"11";"Baix Llobregat";"08073";"Cornellà de Llobregat";"6";"7";"B";"354";"100";"205";"242";"112";"2";"1";"239";"240"
"8";"Barcelona";"1";"Barcelona";"11";"Baix Llobregat";"08073";"Cornellà de Llobregat";"6";"8";"U";"442";"136";"231";"279";"163";"2";"1";"276";"277"
"8";"Barcelona";"1";"Barcelona";"11";"Baix Llobregat";"08073";"Cornellà de Llobregat";"6";"9";"A";"453";"148";"286";"366";"87";"0";"0";"366";"366"
"8";"Barcelona";"1";"Barcelona";"11";"Baix Llobregat";"08073";"Cornellà de Llobregat";"6";"9";"B";"543";"162";"337";"431";"112";"4";"1";"426";"427"
"8";"Barcelona";"1";"Barcelona";"11";"Baix Llobregat";"08073";"Cornellà de Llobregat";"6";"9";"C";"505";"156";"326";"407";"98";"1";"1";"405";"406"
"8";"Barcelona";"1";"Barcelona";"17";"Garraf";"08074";"Cubelles";"1";"1";"U";"698";"211";"416";"496";"202";"3";"7";"486";"493"
"8";"Barcelona";"1";"Barcelona";"17";"Garraf";"08074";"Cubelles";"1";"10";"U";"671";"213";"373";"478";"193";"2";"1";"475";"476"
"8";"Barcelona";"1";"Barcelona";"17";"Garraf";"08074";"Cubelles";"1";"2";"A";"556";"180";"348";"432";"124";"2";"2";"428";"430"
"8";"Barcelona";"1";"Barcelona";"17";"Garraf";"08074";"Cubelles";"1";"2";"B";"605";"191";"368";"450";"155";"1";"0";"449";"449"
"8";"Barcelona";"1";"Barcelona";"17";"Garraf";"08074";"Cubelles";"1";"3";"A";"566";"248";"382";"440";"126";"1";"4";"435";"439"
"8";"Barcelona";"1";"Barcelona";"17";"Garraf";"08074";"Cubelles";"1";"3";"B";"676";"277";"465";"536";"140";"1";"1";"534";"535"
"8";"Barcelona";"1";"Barcelona";"17";"Garraf";"08074";"Cubelles";"1";"4";"A";"522";"192";"341";"412";"110";"4";"4";"404";"408"
"8";"Barcelona";"1";"Barcelona";"17";"Garraf";"08074";"Cubelles";"1";"4";"B";"669";"230";"394";"483";"186";"8";"1";"474";"475"
"8";"Barcelona";"1";"Barcelona";"17";"Garraf";"08074";"Cubelles";"1";"4";"C";"549";"180";"342";"407";"142";"0";"0";"407";"407"
"8";"Barcelona";"1";"Barcelona";"17";"Garraf";"08074";"Cubelles";"1";"5";"A";"617";"219";"395";"480";"137";"1";"0";"479";"479"
"8";"Barcelona";"1";"Barcelona";"17";"Garraf";"08074";"Cubelles";"1";"5";"B";"701";"269";"475";"545";"156";"1";"0";"544";"544"
"8";"Barcelona";"1";"Barcelona";"17";"Garraf";"08074";"Cubelles";"1";"6";"A";"621";"208";"361";"449";"172";"1";"5";"443";"448"
"8";"Barcelona";"1";"Barcelona";"17";"Garraf";"08074";"Cubelles";"1";"6";"B";"794";"299";"497";"605";"189";"1";"6";"598";"604"
"8";"Barcelona";"1";"Barcelona";"17";"Garraf";"08074";"Cubelles";"1";"7";"A";"416";"161";"246";"292";"124";"0";"2";"290";"292"
"8";"Barcelona";"1";"Barcelona";"17";"Garraf";"08074";"Cubelles";"1";"7";"B";"504";"195";"294";"354";"150";"5";"0";"349";"349"
"8";"Barcelona";"1";"Barcelona";"17";"Garraf";"08074";"Cubelles";"1";"8";"U";"762";"256";"430";"505";"257";"2";"4";"499";"503"
"8";"Barcelona";"1";"Barcelona";"17";"Garraf";"08074";"Cubelles";"1";"9";"U";"638";"234";"370";"476";"162";"7";"6";"463";"469"
"8";"Barcelona";"1";"Barcelona";"41";"Vallès Oriental";"08042";"Cànoves i Samalús";"1";"1";"A";"738";"298";"525";"618";"120";"0";"3";"615";"618"
"8";"Barcelona";"1";"Barcelona";"41";"Vallès Oriental";"08042";"Cànoves i Samalús";"1";"1";"B";"785";"302";"528";"632";"153";"4";"0";"628";"628"
"8";"Barcelona";"1";"Barcelona";"41";"Vallès Oriental";"08042";"Cànoves i Samalús";"1";"1";"C";"711";"263";"473";"582";"129";"1";"2";"579";"581"
"8";"Barcelona";"1";"Barcelona";"21";"Maresme";"08075";"Dosrius";"1";"1";"A";"508";"183";"304";"407";"101";"2";"2";"403";"405"
"8";"Barcelona";"1";"Barcelona";"21";"Maresme";"08075";"Dosrius";"1";"1";"B";"626";"267";"414";"517";"109";"0";"5";"512";"517"
"8";"Barcelona";"1";"Barcelona";"21";"Maresme";"08075";"Dosrius";"1";"2";"A";"959";"382";"641";"763";"196";"4";"0";"759";"759"
"8";"Barcelona";"1";"Barcelona";"21";"Maresme";"08075";"Dosrius";"1";"2";"B";"894";"328";"582";"687";"207";"4";"2";"681";"683"
"8";"Barcelona";"1";"Barcelona";"21";"Maresme";"08075";"Dosrius";"1";"3";"U";"882";"304";"585";"711";"171";"2";"3";"706";"709"
"8";"Barcelona";"1";"Barcelona";"11";"Baix Llobregat";"08076";"Esparreguera";"1";"1";"A";"616";"206";"371";"463";"153";"2";"2";"459";"461"
"8";"Barcelona";"1";"Barcelona";"11";"Baix Llobregat";"08076";"Esparreguera";"1";"1";"B";"727";"224";"426";"515";"212";"2";"7";"506";"513"
"8";"Barcelona";"1";"Barcelona";"11";"Baix Llobregat";"08076";"Esparreguera";"1";"1";"C";"547";"206";"344";"421";"126";"3";"3";"415";"418"
"8";"Barcelona";"1";"Barcelona";"11";"Baix Llobregat";"08076";"Esparreguera";"1";"2";"A";"713";"219";"431";"529";"184";"1";"1";"527";"528"
"8";"Barcelona";"1";"Barcelona";"11";"Baix Llobregat";"08076";"Esparreguera";"1";"2";"B";"814";"291";"520";"649";"165";"2";"2";"645";"647"
"8";"Barcelona";"1";"Barcelona";"11";"Baix Llobregat";"08076";"Esparreguera";"1";"3";"A";"581";"226";"372";"464";"117";"0";"4";"460";"464"
"8";"Barcelona";"1";"Barcelona";"11";"Baix Llobregat";"08076";"Esparreguera";"1";"3";"B";"762";"440";"593";"602";"160";"1";"1";"600";"601"
"8";"Barcelona";"1";"Barcelona";"11";"Baix Llobregat";"08076";"Esparreguera";"1";"4";"A";"821";"294";"534";"635";"186";"1";"3";"631";"634"
"8";"Barcelona";"1";"Barcelona";"11";"Baix Llobregat";"08076";"Esparreguera";"1";"4";"B";"982";"291";"621";"773";"209";"3";"5";"765";"770"
"8";"Barcelona";"1";"Barcelona";"11";"Baix Llobregat";"08076";"Esparreguera";"1";"5";"U";"685";"249";"411";"495";"190";"1";"4";"490";"494"
"8";"Barcelona";"1";"Barcelona";"11";"Baix Llobregat";"08076";"Esparreguera";"1";"6";"A";"662";"245";"424";"548";"114";"2";"3";"543";"546"
"8";"Barcelona";"1";"Barcelona";"11";"Baix Llobregat";"08076";"Esparreguera";"1";"6";"B";"696";"277";"467";"601";"95";"4";"4";"593";"597"
"8";"Barcelona";"1";"Barcelona";"11";"Baix Llobregat";"08076";"Esparreguera";"2";"1";"A";"851";"282";"558";"645";"206";"4";"3";"638";"641"
"8";"Barcelona";"1";"Barcelona";"11";"Baix Llobregat";"08076";"Esparreguera";"2";"1";"B";"943";"326";"574";"690";"253";"7";"7";"676";"683"
"8";"Barcelona";"1";"Barcelona";"11";"Baix Llobregat";"08076";"Esparreguera";"2";"2";"A";"606";"238";"396";"475";"131";"1";"0";"474";"474"
"8";"Barcelona";"1";"Barcelona";"11";"Baix Llobregat";"08076";"Esparreguera";"2";"2";"B";"692";"263";"442";"540";"152";"2";"3";"535";"538"
"8";"Barcelona";"1";"Barcelona";"11";"Baix Llobregat";"08076";"Esparreguera";"2";"3";"A";"717";"255";"505";"591";"126";"2";"1";"588";"589"
"8";"Barcelona";"1";"Barcelona";"11";"Baix Llobregat";"08076";"Esparreguera";"2";"3";"B";"827";"335";"589";"689";"138";"1";"5";"683";"688"
"8";"Barcelona";"1";"Barcelona";"11";"Baix Llobregat";"08076";"Esparreguera";"2";"4";"A";"712";"217";"419";"546";"166";"2";"2";"542";"544"
"8";"Barcelona";"1";"Barcelona";"11";"Baix Llobregat";"08076";"Esparreguera";"2";"4";"B";"795";"250";"479";"621";"174";"4";"5";"612";"617"
"8";"Barcelona";"1";"Barcelona";"11";"Baix Llobregat";"08076";"Esparreguera";"2";"5";"A";"678";"238";"381";"474";"204";"1";"1";"472";"473"
"8";"Barcelona";"1";"Barcelona";"11";"Baix Llobregat";"08076";"Esparreguera";"2";"5";"B";"727";"244";"385";"480";"247";"3";"1";"476";"477"
"8";"Barcelona";"1";"Barcelona";"11";"Baix Llobregat";"08077";"Esplugues de Llobregat";"1";"1";"A";"803";"254";"532";"699";"104";"1";"4";"694";"698"
"8";"Barcelona";"1";"Barcelona";"11";"Baix Llobregat";"08077";"Esplugues de Llobregat";"1";"1";"B";"795";"269";"527";"688";"107";"3";"3";"682";"685"
"8";"Barcelona";"1";"Barcelona";"11";"Baix Llobregat";"08077";"Esplugues de Llobregat";"1";"2";"A";"442";"160";"287";"365";"77";"0";"1";"364";"365"
"8";"Barcelona";"1";"Barcelona";"11";"Baix Llobregat";"08077";"Esplugues de Llobregat";"1";"2";"B";"505";"186";"327";"415";"90";"1";"3";"411";"414"
"8";"Barcelona";"1";"Barcelona";"11";"Baix Llobregat";"08077";"Esplugues de Llobregat";"1";"3";"A";"591";"186";"370";"479";"112";"0";"0";"479";"479"
"8";"Barcelona";"1";"Barcelona";"11";"Baix Llobregat";"08077";"Esplugues de Llobregat";"1";"3";"B";"676";"232";"457";"563";"113";"2";"3";"558";"561"
"8";"Barcelona";"1";"Barcelona";"11";"Baix Llobregat";"08077";"Esplugues de Llobregat";"1";"4";"A";"494";"157";"292";"368";"126";"0";"4";"364";"368"
"8";"Barcelona";"1";"Barcelona";"11";"Baix Llobregat";"08077";"Esplugues de Llobregat";"1";"4";"B";"519";"171";"309";"384";"135";"2";"2";"380";"382"
"8";"Barcelona";"1";"Barcelona";"11";"Baix Llobregat";"08077";"Esplugues de Llobregat";"1";"5";"A";"636";"219";"403";"515";"121";"0";"0";"515";"515"
"8";"Barcelona";"1";"Barcelona";"11";"Baix Llobregat";"08077";"Esplugues de Llobregat";"1";"5";"B";"690";"215";"457";"568";"122";"4";"3";"561";"564"
"8";"Barcelona";"1";"Barcelona";"11";"Baix Llobregat";"08077";"Esplugues de Llobregat";"10";"1";"A";"442";"176";"283";"363";"79";"0";"2";"361";"363"
"8";"Barcelona";"1";"Barcelona";"11";"Baix Llobregat";"08077";"Esplugues de Llobregat";"10";"1";"B";"562";"205";"364";"463";"99";"1";"0";"462";"462"
"8";"Barcelona";"1";"Barcelona";"11";"Baix Llobregat";"08077";"Esplugues de Llobregat";"10";"1";"C";"609";"200";"354";"478";"131";"2";"0";"476";"476"
"8";"Barcelona";"1";"Barcelona";"11";"Baix Llobregat";"08077";"Esplugues de Llobregat";"10";"2";"A";"477";"174";"315";"400";"77";"0";"4";"396";"400"
"8";"Barcelona";"1";"Barcelona";"11";"Baix Llobregat";"08077";"Esplugues de Llobregat";"10";"2";"B";"643";"223";"415";"525";"118";"0";"1";"524";"525"
"8";"Barcelona";"1";"Barcelona";"11";"Baix Llobregat";"08077";"Esplugues de Llobregat";"10";"3";"A";"545";"196";"319";"394";"151";"1";"3";"390";"393"
"8";"Barcelona";"1";"Barcelona";"11";"Baix Llobregat";"08077";"Esplugues de Llobregat";"10";"3";"B";"565";"218";"362";"441";"124";"1";"0";"440";"440"
"8";"Barcelona";"1";"Barcelona";"11";"Baix Llobregat";"08077";"Esplugues de Llobregat";"10";"3";"C";"587";"229";"357";"468";"119";"1";"3";"464";"467"
"8";"Barcelona";"1";"Barcelona";"11";"Baix Llobregat";"08077";"Esplugues de Llobregat";"10";"4";"A";"420";"129";"207";"266";"154";"0";"1";"265";"266"
"8";"Barcelona";"1";"Barcelona";"11";"Baix Llobregat";"08077";"Esplugues de Llobregat";"10";"4";"B";"484";"161";"247";"306";"178";"0";"0";"306";"306"
"8";"Barcelona";"1";"Barcelona";"11";"Baix Llobregat";"08077";"Esplugues de Llobregat";"10";"5";"A";"383";"128";"207";"258";"125";"0";"1";"257";"258"
"8";"Barcelona";"1";"Barcelona";"11";"Baix Llobregat";"08077";"Esplugues de Llobregat";"10";"5";"B";"447";"134";"228";"292";"155";"1";"3";"288";"291"
"8";"Barcelona";"1";"Barcelona";"11";"Baix Llobregat";"08077";"Esplugues de Llobregat";"10";"6";"A";"585";"205";"354";"458";"127";"2";"4";"452";"456"
"8";"Barcelona";"1";"Barcelona";"11";"Baix Llobregat";"08077";"Esplugues de Llobregat";"10";"6";"B";"657";"225";"371";"485";"172";"2";"2";"481";"483"
"8";"Barcelona";"1";"Barcelona";"11";"Baix Llobregat";"08077";"Esplugues de Llobregat";"10";"7";"A";"597";"211";"382";"476";"121";"6";"3";"467";"470"
"8";"Barcelona";"1";"Barcelona";"11";"Baix Llobregat";"08077";"Esplugues de Llobregat";"10";"7";"B";"644";"223";"400";"513";"131";"2";"0";"511";"511"
"8";"Barcelona";"1";"Barcelona";"11";"Baix Llobregat";"08077";"Esplugues de Llobregat";"10";"8";"A";"629";"186";"311";"405";"224";"2";"3";"400";"403"
"8";"Barcelona";"1";"Barcelona";"11";"Baix Llobregat";"08077";"Esplugues de Llobregat";"10";"8";"B";"755";"208";"406";"519";"236";"2";"4";"513";"517"
"8";"Barcelona";"1";"Barcelona";"11";"Baix Llobregat";"08077";"Esplugues de Llobregat";"2";"1";"A";"549";"175";"343";"446";"103";"1";"0";"445";"445"
"8";"Barcelona";"1";"Barcelona";"11";"Baix Llobregat";"08077";"Esplugues de Llobregat";"2";"1";"B";"564";"195";"368";"478";"86";"0";"3";"475";"478"
"8";"Barcelona";"1";"Barcelona";"11";"Baix Llobregat";"08077";"Esplugues de Llobregat";"2";"2";"A";"467";"160";"280";"348";"119";"0";"0";"348";"348"
"8";"Barcelona";"1";"Barcelona";"11";"Baix Llobregat";"08077";"Esplugues de Llobregat";"2";"2";"B";"585";"182";"350";"457";"128";"3";"0";"454";"454"
"8";"Barcelona";"1";"Barcelona";"11";"Baix Llobregat";"08077";"Esplugues de Llobregat";"2";"3";"A";"602";"139";"367";"471";"131";"1";"5";"465";"470"
"8";"Barcelona";"1";"Barcelona";"11";"Baix Llobregat";"08077";"Esplugues de Llobregat";"2";"3";"B";"708";"210";"407";"555";"153";"1";"2";"552";"554"
"8";"Barcelona";"1";"Barcelona";"11";"Baix Llobregat";"08077";"Esplugues de Llobregat";"2";"4";"A";"543";"183";"354";"442";"101";"1";"0";"441";"441"
"8";"Barcelona";"1";"Barcelona";"11";"Baix Llobregat";"08077";"Esplugues de Llobregat";"2";"4";"B";"606";"184";"372";"456";"150";"0";"4";"452";"456"
"8";"Barcelona";"1";"Barcelona";"11";"Baix Llobregat";"08077";"Esplugues de Llobregat";"2";"5";"A";"586";"173";"345";"447";"139";"3";"5";"439";"444"
"8";"Barcelona";"1";"Barcelona";"11";"Baix Llobregat";"08077";"Esplugues de Llobregat";"2";"5";"B";"656";"202";"404";"511";"145";"1";"2";"508";"510"
"8";"Barcelona";"1";"Barcelona";"11";"Baix Llobregat";"08077";"Esplugues de Llobregat";"2";"6";"A";"626";"186";"387";"509";"117";"0";"0";"509";"509"
"8";"Barcelona";"1";"Barcelona";"11";"Baix Llobregat";"08077";"Esplugues de Llobregat";"2";"6";"B";"690";"190";"442";"568";"122";"1";"3";"564";"567"
"8";"Barcelona";"1";"Barcelona";"11";"Baix Llobregat";"08077";"Esplugues de Llobregat";"3";"1";"A";"501";"169";"318";"404";"97";"0";"0";"404";"404"
"8";"Barcelona";"1";"Barcelona";"11";"Baix Llobregat";"08077";"Esplugues de Llobregat";"3";"1";"B";"609";"200";"382";"485";"124";"0";"4";"481";"485"
"8";"Barcelona";"1";"Barcelona";"11";"Baix Llobregat";"08077";"Esplugues de Llobregat";"3";"2";"A";"550";"199";"353";"439";"111";"0";"3";"436";"439"
"8";"Barcelona";"1";"Barcelona";"11";"Baix Llobregat";"08077";"Esplugues de Llobregat";"3";"2";"B";"578";"204";"365";"463";"115";"1";"2";"460";"462"
"8";"Barcelona";"1";"Barcelona";"11";"Baix Llobregat";"08077";"Esplugues de Llobregat";"3";"2";"C";"546";"198";"370";"436";"110";"3";"1";"432";"433"
"8";"Barcelona";"1";"Barcelona";"11";"Baix Llobregat";"08077";"Esplugues de Llobregat";"4";"1";"U";"538";"188";"366";"451";"87";"2";"5";"444";"449"
"8";"Barcelona";"1";"Barcelona";"11";"Baix Llobregat";"08077";"Esplugues de Llobregat";"5";"1";"U";"648";"158";"335";"411";"237";"0";"1";"410";"411"
"8";"Barcelona";"1";"Barcelona";"11";"Baix Llobregat";"08077";"Esplugues de Llobregat";"6";"1";"U";"583";"196";"346";"435";"148";"1";"1";"433";"434"
"8";"Barcelona";"1";"Barcelona";"11";"Baix Llobregat";"08077";"Esplugues de Llobregat";"7";"1";"U";"821";"240";"531";"679";"142";"0";"2";"677";"679"
"8";"Barcelona";"1";"Barcelona";"11";"Baix Llobregat";"08077";"Esplugues de Llobregat";"8";"1";"A";"671";"233";"451";"553";"118";"2";"4";"547";"551"
"8";"Barcelona";"1";"Barcelona";"11";"Baix Llobregat";"08077";"Esplugues de Llobregat";"8";"1";"B";"816";"294";"550";"690";"126";"2";"1";"687";"688"
"8";"Barcelona";"1";"Barcelona";"11";"Baix Llobregat";"08077";"Esplugues de Llobregat";"8";"2";"A";"726";"221";"465";"579";"147";"1";"3";"575";"578"
"8";"Barcelona";"1";"Barcelona";"11";"Baix Llobregat";"08077";"Esplugues de Llobregat";"8";"2";"B";"881";"291";"564";"681";"200";"1";"3";"677";"680"
"8";"Barcelona";"1";"Barcelona";"11";"Baix Llobregat";"08077";"Esplugues de Llobregat";"9";"1";"A";"578";"184";"379";"464";"114";"0";"2";"462";"464"
"8";"Barcelona";"1";"Barcelona";"11";"Baix Llobregat";"08077";"Esplugues de Llobregat";"9";"1";"B";"648";"186";"395";"494";"154";"0";"2";"492";"494"
"8";"Barcelona";"1";"Barcelona";"11";"Baix Llobregat";"08077";"Esplugues de Llobregat";"9";"2";"A";"709";"208";"449";"588";"121";"4";"3";"581";"584"
"8";"Barcelona";"1";"Barcelona";"11";"Baix Llobregat";"08077";"Esplugues de Llobregat";"9";"2";"B";"767";"228";"489";"637";"130";"1";"3";"633";"636"
"8";"Barcelona";"1";"Barcelona";"41";"Vallès Oriental";"08134";"Figaró-Montmany";"1";"1";"U";"802";"344";"557";"650";"152";"4";"5";"641";"646"
"8";"Barcelona";"1";"Barcelona";"41";"Vallès Oriental";"08081";"Fogars de Montclús";"1";"1";"U";"348";"150";"244";"305";"43";"0";"0";"305";"305"
"8";"Barcelona";"1";"Barcelona";"3";"Alt Penedès";"08085";"Font-rubí";"1";"1";"U";"987";"384";"682";"837";"150";"2";"3";"832";"835"
"8";"Barcelona";"1";"Barcelona";"41";"Vallès Oriental";"08086";"Franqueses del Vallès, les";"1";"1";"A";"565";"174";"367";"464";"101";"1";"3";"460";"463"
"8";"Barcelona";"1";"Barcelona";"41";"Vallès Oriental";"08086";"Franqueses del Vallès, les";"1";"1";"B";"592";"230";"408";"495";"97";"1";"3";"491";"494"
"8";"Barcelona";"1";"Barcelona";"41";"Vallès Oriental";"08086";"Franqueses del Vallès, les";"1";"1";"C";"519";"198";"338";"403";"116";"2";"2";"399";"401"
"8";"Barcelona";"1";"Barcelona";"41";"Vallès Oriental";"08086";"Franqueses del Vallès, les";"1";"2";"A";"712";"263";"396";"468";"244";"3";"3";"462";"465"
"8";"Barcelona";"1";"Barcelona";"41";"Vallès Oriental";"08086";"Franqueses del Vallès, les";"1";"2";"B";"775";"237";"415";"503";"272";"1";"2";"500";"502"
"8";"Barcelona";"1";"Barcelona";"41";"Vallès Oriental";"08086";"Franqueses del Vallès, les";"1";"3";"A";"675";"185";"325";"426";"249";"4";"3";"419";"422"
"8";"Barcelona";"1";"Barcelona";"41";"Vallès Oriental";"08086";"Franqueses del Vallès, les";"1";"3";"B";"630";"180";"319";"408";"222";"4";"1";"403";"404"
"8";"Barcelona";"1";"Barcelona";"41";"Vallès Oriental";"08086";"Franqueses del Vallès, les";"1";"3";"C";"569";"170";"295";"374";"195";"0";"0";"374";"374"
"8";"Barcelona";"1";"Barcelona";"41";"Vallès Oriental";"08086";"Franqueses del Vallès, les";"1";"4";"A";"681";"230";"427";"530";"151";"1";"1";"528";"529"
"8";"Barcelona";"1";"Barcelona";"41";"Vallès Oriental";"08086";"Franqueses del Vallès, les";"1";"4";"B";"752";"220";"445";"563";"189";"3";"8";"552";"560"
"8";"Barcelona";"1";"Barcelona";"41";"Vallès Oriental";"08086";"Franqueses del Vallès, les";"1";"4";"C";"678";"228";"397";"509";"169";"2";"6";"501";"507"
"8";"Barcelona";"1";"Barcelona";"41";"Vallès Oriental";"08086";"Franqueses del Vallès, les";"1";"5";"A";"606";"200";"374";"457";"149";"0";"3";"454";"457"
"8";"Barcelona";"1";"Barcelona";"41";"Vallès Oriental";"08086";"Franqueses del Vallès, les";"1";"5";"B";"814";"263";"498";"630";"184";"3";"6";"621";"627"
"8";"Barcelona";"1";"Barcelona";"41";"Vallès Oriental";"08086";"Franqueses del Vallès, les";"1";"5";"C";"660";"201";"390";"505";"155";"5";"4";"496";"500"
"8";"Barcelona";"1";"Barcelona";"41";"Vallès Oriental";"08086";"Franqueses del Vallès, les";"1";"6";"A";"604";"231";"408";"507";"97";"3";"2";"502";"504"
"8";"Barcelona";"1";"Barcelona";"41";"Vallès Oriental";"08086";"Franqueses del Vallès, les";"1";"6";"B";"734";"258";"497";"621";"113";"1";"4";"616";"620"
"8";"Barcelona";"1";"Barcelona";"41";"Vallès Oriental";"08086";"Franqueses del Vallès, les";"1";"7";"A";"549";"182";"370";"464";"85";"0";"2";"462";"464"
"8";"Barcelona";"1";"Barcelona";"41";"Vallès Oriental";"08086";"Franqueses del Vallès, les";"1";"7";"B";"698";"221";"445";"562";"136";"0";"7";"555";"562"
"8";"Barcelona";"1";"Barcelona";"41";"Vallès Oriental";"08086";"Franqueses del Vallès, les";"2";"1";"A";"1030";"320";"693";"838";"192";"0";"1";"837";"838"
"8";"Barcelona";"1";"Barcelona";"41";"Vallès Oriental";"08086";"Franqueses del Vallès, les";"2";"1";"B";"305";"118";"214";"263";"42";"0";"0";"263";"263"
"8";"Barcelona";"1";"Barcelona";"41";"Vallès Oriental";"08086";"Franqueses del Vallès, les";"2";"1";"C";"387";"186";"301";"336";"51";"1";"1";"334";"335"
"8";"Barcelona";"1";"Barcelona";"40";"Vallès Occidental";"08087";"Gallifa";"1";"1";"U";"162";"67";"125";"151";"11";"0";"2";"149";"151"
"8";"Barcelona";"1";"Barcelona";"41";"Vallès Oriental";"08088";"Garriga, la";"1";"1";"A";"814";"333";"572";"674";"140";"2";"3";"669";"672"
"8";"Barcelona";"1";"Barcelona";"41";"Vallès Oriental";"08088";"Garriga, la";"1";"1";"B";"907";"372";"637";"750";"157";"0";"9";"741";"750"
"8";"Barcelona";"1";"Barcelona";"41";"Vallès Oriental";"08088";"Garriga, la";"1";"2";"A";"733";"230";"475";"591";"142";"0";"2";"589";"591"
"8";"Barcelona";"1";"Barcelona";"41";"Vallès Oriental";"08088";"Garriga, la";"1";"2";"B";"700";"250";"475";"584";"116";"4";"2";"578";"580"
"8";"Barcelona";"1";"Barcelona";"41";"Vallès Oriental";"08088";"Garriga, la";"1";"3";"A";"695";"244";"448";"553";"142";"2";"1";"550";"551"
"8";"Barcelona";"1";"Barcelona";"41";"Vallès Oriental";"08088";"Garriga, la";"1";"3";"B";"656";"259";"435";"533";"123";"2";"3";"528";"531"
"8";"Barcelona";"1";"Barcelona";"41";"Vallès Oriental";"08088";"Garriga, la";"1";"3";"C";"644";"248";"421";"513";"131";"3";"1";"509";"510"
"8";"Barcelona";"1";"Barcelona";"41";"Vallès Oriental";"08088";"Garriga, la";"2";"1";"A";"760";"312";"553";"636";"124";"1";"2";"633";"635"
"8";"Barcelona";"1";"Barcelona";"41";"Vallès Oriental";"08088";"Garriga, la";"2";"1";"B";"655";"263";"473";"563";"92";"1";"5";"557";"562"
"8";"Barcelona";"1";"Barcelona";"41";"Vallès Oriental";"08088";"Garriga, la";"2";"1";"C";"718";"324";"517";"614";"104";"1";"1";"612";"613"
"8";"Barcelona";"1";"Barcelona";"41";"Vallès Oriental";"08088";"Garriga, la";"2";"2";"A";"685";"285";"480";"571";"114";"2";"0";"569";"569"
"8";"Barcelona";"1";"Barcelona";"41";"Vallès Oriental";"08088";"Garriga, la";"2";"2";"B";"669";"393";"444";"518";"151";"3";"4";"511";"515"
"8";"Barcelona";"1";"Barcelona";"41";"Vallès Oriental";"08088";"Garriga, la";"2";"2";"C";"647";"336";"445";"522";"125";"1";"5";"516";"521"
"8";"Barcelona";"1";"Barcelona";"41";"Vallès Oriental";"08088";"Garriga, la";"2";"3";"A";"663";"260";"465";"562";"101";"0";"2";"560";"562"
"8";"Barcelona";"1";"Barcelona";"41";"Vallès Oriental";"08088";"Garriga, la";"2";"3";"B";"627";"250";"449";"542";"85";"2";"0";"540";"540"
"8";"Barcelona";"1";"Barcelona";"41";"Vallès Oriental";"08088";"Garriga, la";"2";"3";"C";"623";"238";"445";"525";"98";"1";"5";"519";"524"
"8";"Barcelona";"1";"Barcelona";"41";"Vallès Oriental";"08088";"Garriga, la";"2";"4";"U";"626";"233";"454";"535";"91";"1";"3";"531";"534"
"8";"Barcelona";"1";"Barcelona";"11";"Baix Llobregat";"08089";"Gavà";"1";"1";"A";"611";"240";"367";"449";"162";"6";"5";"438";"443"
"8";"Barcelona";"1";"Barcelona";"11";"Baix Llobregat";"08089";"Gavà";"1";"1";"B";"712";"277";"465";"558";"154";"3";"3";"552";"555"
"8";"Barcelona";"1";"Barcelona";"11";"Baix Llobregat";"08089";"Gavà";"1";"2";"A";"568";"210";"370";"433";"135";"1";"3";"429";"432"
"8";"Barcelona";"1";"Barcelona";"11";"Baix Llobregat";"08089";"Gavà";"1";"2";"B";"681";"258";"444";"544";"137";"3";"1";"540";"541"
"8";"Barcelona";"1";"Barcelona";"11";"Baix Llobregat";"08089";"Gavà";"1";"3";"A";"461";"198";"311";"354";"107";"0";"2";"352";"354"
"8";"Barcelona";"1";"Barcelona";"11";"Baix Llobregat";"08089";"Gavà";"1";"3";"B";"490";"218";"320";"391";"99";"4";"2";"385";"387"
"8";"Barcelona";"1";"Barcelona";"11";"Baix Llobregat";"08089";"Gavà";"1";"3";"C";"464";"178";"290";"353";"111";"1";"0";"352";"352"
"8";"Barcelona";"1";"Barcelona";"11";"Baix Llobregat";"08089";"Gavà";"1";"4";"A";"614";"213";"370";"461";"153";"2";"1";"458";"459"
"8";"Barcelona";"1";"Barcelona";"11";"Baix Llobregat";"08089";"Gavà";"1";"4";"B";"685";"269";"416";"514";"171";"0";"0";"514";"514"
"8";"Barcelona";"1";"Barcelona";"11";"Baix Llobregat";"08089";"Gavà";"1";"5";"A";"469";"153";"252";"326";"143";"1";"0";"325";"325"
"8";"Barcelona";"1";"Barcelona";"11";"Baix Llobregat";"08089";"Gavà";"1";"5";"B";"508";"207";"298";"370";"138";"1";"1";"368";"369"
"8";"Barcelona";"1";"Barcelona";"11";"Baix Llobregat";"08089";"Gavà";"1";"6";"U";"826";"292";"469";"600";"226";"2";"1";"597";"598"
"8";"Barcelona";"1";"Barcelona";"11";"Baix Llobregat";"08089";"Gavà";"1";"7";"A";"684";"230";"422";"522";"162";"1";"2";"519";"521"
"8";"Barcelona";"1";"Barcelona";"11";"Baix Llobregat";"08089";"Gavà";"1";"7";"B";"820";"270";"473";"599";"221";"2";"2";"595";"597"
"8";"Barcelona";"1";"Barcelona";"11";"Baix Llobregat";"08089";"Gavà";"1";"8";"A";"728";"253";"457";"608";"120";"0";"3";"605";"608"
"8";"Barcelona";"1";"Barcelona";"11";"Baix Llobregat";"08089";"Gavà";"1";"8";"B";"848";"279";"560";"722";"126";"0";"0";"722";"722"
"8";"Barcelona";"1";"Barcelona";"11";"Baix Llobregat";"08089";"Gavà";"2";"1";"A";"523";"157";"354";"420";"103";"3";"0";"417";"417"
"8";"Barcelona";"1";"Barcelona";"11";"Baix Llobregat";"08089";"Gavà";"2";"1";"B";"632";"210";"410";"492";"140";"2";"1";"489";"490"
"8";"Barcelona";"1";"Barcelona";"11";"Baix Llobregat";"08089";"Gavà";"2";"1";"C";"525";"169";"349";"427";"98";"3";"0";"424";"424"
"8";"Barcelona";"1";"Barcelona";"11";"Baix Llobregat";"08089";"Gavà";"2";"10";"U";"650";"191";"350";"449";"201";"0";"1";"448";"449"
"8";"Barcelona";"1";"Barcelona";"11";"Baix Llobregat";"08089";"Gavà";"2";"2";"U";"851";"260";"514";"635";"216";"2";"2";"631";"633"
"8";"Barcelona";"1";"Barcelona";"11";"Baix Llobregat";"08089";"Gavà";"2";"3";"U";"763";"262";"512";"620";"143";"2";"4";"614";"618"
"8";"Barcelona";"1";"Barcelona";"11";"Baix Llobregat";"08089";"Gavà";"2";"4";"A";"621";"232";"387";"462";"159";"2";"1";"459";"460"
"8";"Barcelona";"1";"Barcelona";"11";"Baix Llobregat";"08089";"Gavà";"2";"4";"B";"744";"265";"444";"557";"187";"3";"3";"551";"554"
"8";"Barcelona";"1";"Barcelona";"11";"Baix Llobregat";"08089";"Gavà";"2";"5";"U";"871";"239";"462";"570";"301";"1";"5";"564";"569"
"8";"Barcelona";"1";"Barcelona";"11";"Baix Llobregat";"08089";"Gavà";"2";"6";"A";"599";"183";"363";"439";"160";"2";"3";"434";"437"
"8";"Barcelona";"1";"Barcelona";"11";"Baix Llobregat";"08089";"Gavà";"2";"6";"B";"764";"238";"446";"558";"206";"1";"2";"555";"557"
"8";"Barcelona";"1";"Barcelona";"11";"Baix Llobregat";"08089";"Gavà";"2";"7";"U";"739";"242";"479";"578";"161";"2";"1";"575";"576"
"8";"Barcelona";"1";"Barcelona";"11";"Baix Llobregat";"08089";"Gavà";"2";"8";"A";"569";"198";"384";"460";"109";"1";"0";"459";"459"
"8";"Barcelona";"1";"Barcelona";"11";"Baix Llobregat";"08089";"Gavà";"2";"8";"B";"691";"274";"454";"551";"140";"0";"7";"544";"551"
"8";"Barcelona";"1";"Barcelona";"11";"Baix Llobregat";"08089";"Gavà";"2";"9";"A";"634";"207";"370";"493";"141";"0";"2";"491";"493"
"8";"Barcelona";"1";"Barcelona";"11";"Baix Llobregat";"08089";"Gavà";"2";"9";"B";"717";"244";"433";"548";"169";"2";"4";"542";"546"
"8";"Barcelona";"1";"Barcelona";"11";"Baix Llobregat";"08089";"Gavà";"3";"1";"A";"432";"162";"266";"333";"99";"2";"1";"330";"331"
"8";"Barcelona";"1";"Barcelona";"11";"Baix Llobregat";"08089";"Gavà";"3";"1";"B";"527";"189";"329";"398";"129";"0";"3";"395";"398"
"8";"Barcelona";"1";"Barcelona";"11";"Baix Llobregat";"08089";"Gavà";"3";"2";"U";"845";"297";"572";"677";"168";"2";"4";"671";"675"
"8";"Barcelona";"1";"Barcelona";"11";"Baix Llobregat";"08089";"Gavà";"3";"3";"A";"534";"170";"311";"407";"127";"0";"0";"407";"407"
"8";"Barcelona";"1";"Barcelona";"11";"Baix Llobregat";"08089";"Gavà";"3";"3";"B";"636";"220";"386";"480";"156";"1";"0";"479";"479"
"8";"Barcelona";"1";"Barcelona";"11";"Baix Llobregat";"08089";"Gavà";"3";"3";"C";"516";"184";"333";"403";"113";"1";"2";"400";"402"
"8";"Barcelona";"1";"Barcelona";"11";"Baix Llobregat";"08089";"Gavà";"3";"4";"A";"550";"189";"305";"386";"164";"2";"2";"382";"384"
"8";"Barcelona";"1";"Barcelona";"11";"Baix Llobregat";"08089";"Gavà";"3";"4";"B";"619";"206";"349";"432";"187";"1";"2";"429";"431"
"8";"Barcelona";"1";"Barcelona";"11";"Baix Llobregat";"08089";"Gavà";"3";"5";"A";"785";"230";"418";"512";"273";"0";"2";"510";"512"
"8";"Barcelona";"1";"Barcelona";"11";"Baix Llobregat";"08089";"Gavà";"3";"5";"B";"713";"227";"410";"506";"207";"1";"3";"502";"505"
"8";"Barcelona";"1";"Barcelona";"11";"Baix Llobregat";"08089";"Gavà";"3";"6";"A";"441";"147";"268";"329";"112";"0";"0";"329";"329"
"8";"Barcelona";"1";"Barcelona";"11";"Baix Llobregat";"08089";"Gavà";"3";"6";"B";"477";"184";"318";"373";"104";"2";"1";"370";"371"
"8";"Barcelona";"1";"Barcelona";"11";"Baix Llobregat";"08089";"Gavà";"3";"7";"U";"757";"269";"494";"631";"126";"2";"3";"626";"629"
"8";"Barcelona";"1";"Barcelona";"11";"Baix Llobregat";"08089";"Gavà";"3";"8";"A";"649";"225";"423";"517";"132";"1";"1";"515";"516"
"8";"Barcelona";"1";"Barcelona";"11";"Baix Llobregat";"08089";"Gavà";"3";"8";"B";"799";"255";"510";"650";"149";"1";"5";"644";"649"
"8";"Barcelona";"1";"Barcelona";"11";"Baix Llobregat";"08089";"Gavà";"3";"8";"C";"618";"207";"387";"493";"125";"1";"3";"489";"492"
"8";"Barcelona";"1";"Barcelona";"11";"Baix Llobregat";"08089";"Gavà";"4";"1";"A";"496";"190";"317";"385";"111";"1";"2";"382";"384"
"8";"Barcelona";"1";"Barcelona";"11";"Baix Llobregat";"08089";"Gavà";"4";"1";"B";"652";"241";"412";"506";"146";"0";"1";"505";"506"
"8";"Barcelona";"1";"Barcelona";"11";"Baix Llobregat";"08089";"Gavà";"4";"1";"C";"537";"198";"324";"416";"121";"0";"1";"415";"416"
"8";"Barcelona";"1";"Barcelona";"11";"Baix Llobregat";"08089";"Gavà";"4";"2";"A";"612";"219";"360";"424";"188";"0";"0";"424";"424"
"8";"Barcelona";"1";"Barcelona";"11";"Baix Llobregat";"08089";"Gavà";"4";"2";"B";"647";"254";"399";"472";"175";"4";"5";"463";"468"
"8";"Barcelona";"1";"Barcelona";"3";"Alt Penedès";"08091";"Gelida";"1";"1";"A";"814";"240";"532";"650";"164";"2";"1";"647";"648"
"8";"Barcelona";"1";"Barcelona";"3";"Alt Penedès";"08091";"Gelida";"1";"1";"B";"888";"301";"593";"721";"167";"4";"3";"714";"717"
"8";"Barcelona";"1";"Barcelona";"3";"Alt Penedès";"08091";"Gelida";"1";"2";"A";"767";"250";"486";"624";"143";"3";"2";"619";"621"
"8";"Barcelona";"1";"Barcelona";"3";"Alt Penedès";"08091";"Gelida";"1";"2";"B";"898";"275";"551";"703";"195";"7";"4";"692";"696"
"8";"Barcelona";"1";"Barcelona";"3";"Alt Penedès";"08091";"Gelida";"2";"1";"A";"622";"237";"411";"496";"126";"1";"0";"495";"495"
"8";"Barcelona";"1";"Barcelona";"3";"Alt Penedès";"08091";"Gelida";"2";"1";"B";"695";"260";"446";"542";"153";"2";"2";"538";"540"
"8";"Barcelona";"1";"Barcelona";"3";"Alt Penedès";"08091";"Gelida";"2";"1";"C";"582";"235";"390";"460";"122";"2";"4";"454";"458"
"8";"Barcelona";"1";"Barcelona";"3";"Alt Penedès";"08094";"Granada, la";"1";"1";"A";"727";"251";"518";"615";"112";"7";"2";"606";"608"
"8";"Barcelona";"1";"Barcelona";"3";"Alt Penedès";"08094";"Granada, la";"1";"1";"B";"811";"264";"553";"691";"120";"5";"5";"681";"686"
"8";"Barcelona";"1";"Barcelona";"41";"Vallès Oriental";"08096";"Granollers";"1";"1";"A";"752";"325";"516";"618";"134";"2";"6";"610";"616"
"8";"Barcelona";"1";"Barcelona";"41";"Vallès Oriental";"08096";"Granollers";"1";"1";"B";"825";"378";"591";"689";"136";"2";"4";"683";"687"
"8";"Barcelona";"1";"Barcelona";"41";"Vallès Oriental";"08096";"Granollers";"1";"10";"A";"506";"207";"348";"393";"113";"2";"3";"388";"391"
"8";"Barcelona";"1";"Barcelona";"41";"Vallès Oriental";"08096";"Granollers";"1";"10";"B";"636";"247";"410";"483";"153";"3";"2";"478";"480"
"8";"Barcelona";"1";"Barcelona";"41";"Vallès Oriental";"08096";"Granollers";"1";"11";"A";"598";"229";"381";"454";"144";"2";"1";"451";"452"
"8";"Barcelona";"1";"Barcelona";"41";"Vallès Oriental";"08096";"Granollers";"1";"11";"B";"596";"247";"372";"440";"156";"3";"3";"434";"437"
"8";"Barcelona";"1";"Barcelona";"41";"Vallès Oriental";"08096";"Granollers";"1";"3";"A";"601";"238";"403";"486";"115";"2";"2";"482";"484"
"8";"Barcelona";"1";"Barcelona";"41";"Vallès Oriental";"08096";"Granollers";"1";"3";"B";"777";"290";"498";"621";"156";"4";"1";"616";"617"
"8";"Barcelona";"1";"Barcelona";"41";"Vallès Oriental";"08096";"Granollers";"1";"4";"A";"550";"210";"414";"437";"113";"3";"2";"432";"434"
"8";"Barcelona";"1";"Barcelona";"41";"Vallès Oriental";"08096";"Granollers";"1";"4";"B";"632";"226";"430";"523";"109";"3";"1";"519";"520"
"8";"Barcelona";"1";"Barcelona";"41";"Vallès Oriental";"08096";"Granollers";"1";"4";"C";"614";"247";"367";"496";"118";"4";"2";"490";"492"
"8";"Barcelona";"1";"Barcelona";"41";"Vallès Oriental";"08096";"Granollers";"1";"5";"A";"601";"243";"400";"469";"132";"1";"3";"465";"468"
"8";"Barcelona";"1";"Barcelona";"41";"Vallès Oriental";"08096";"Granollers";"1";"5";"B";"809";"286";"515";"646";"163";"3";"2";"641";"643"
"8";"Barcelona";"1";"Barcelona";"41";"Vallès Oriental";"08096";"Granollers";"1";"6";"U";"823";"285";"419";"502";"321";"6";"4";"492";"496"
"8";"Barcelona";"1";"Barcelona";"41";"Vallès Oriental";"08096";"Granollers";"1";"9";"A";"658";"217";"362";"451";"207";"5";"1";"445";"446"
"8";"Barcelona";"1";"Barcelona";"41";"Vallès Oriental";"08096";"Granollers";"1";"9";"B";"745";"265";"410";"513";"232";"6";"4";"503";"507"
"8";"Barcelona";"1";"Barcelona";"41";"Vallès Oriental";"08096";"Granollers";"2";"1";"A";"679";"236";"446";"538";"141";"0";"2";"536";"538"
"8";"Barcelona";"1";"Barcelona";"41";"Vallès Oriental";"08096";"Granollers";"2";"1";"B";"740";"272";"479";"592";"148";"1";"2";"589";"591"
"8";"Barcelona";"1";"Barcelona";"41";"Vallès Oriental";"08096";"Granollers";"2";"2";"A";"438";"181";"308";"362";"76";"0";"1";"361";"362"
"8";"Barcelona";"1";"Barcelona";"41";"Vallès Oriental";"08096";"Granollers";"2";"2";"B";"542";"261";"379";"458";"84";"1";"5";"452";"457"
"8";"Barcelona";"1";"Barcelona";"41";"Vallès Oriental";"08096";"Granollers";"2";"3";"U";"515";"233";"376";"443";"72";"0";"5";"438";"443"
"8";"Barcelona";"1";"Barcelona";"41";"Vallès Oriental";"08096";"Granollers";"2";"4";"A";"597";"215";"381";"447";"150";"0";"4";"443";"447"
"8";"Barcelona";"1";"Barcelona";"41";"Vallès Oriental";"08096";"Granollers";"2";"4";"B";"676";"246";"420";"500";"176";"2";"2";"496";"498"
"8";"Barcelona";"1";"Barcelona";"41";"Vallès Oriental";"08096";"Granollers";"2";"5";"A";"484";"181";"310";"368";"116";"4";"2";"362";"364"
"8";"Barcelona";"1";"Barcelona";"41";"Vallès Oriental";"08096";"Granollers";"2";"5";"B";"631";"259";"409";"488";"143";"3";"4";"481";"485"
"8";"Barcelona";"1";"Barcelona";"41";"Vallès Oriental";"08096";"Granollers";"2";"6";"A";"568";"224";"366";"455";"113";"2";"4";"449";"453"
"8";"Barcelona";"1";"Barcelona";"41";"Vallès Oriental";"08096";"Granollers";"2";"6";"B";"697";"260";"439";"543";"154";"2";"3";"538";"541"
"8";"Barcelona";"1";"Barcelona";"41";"Vallès Oriental";"08096";"Granollers";"2";"7";"A";"458";"172";"266";"349";"109";"1";"1";"347";"348"
"8";"Barcelona";"1";"Barcelona";"41";"Vallès Oriental";"08096";"Granollers";"2";"7";"B";"519";"184";"280";"381";"138";"1";"3";"377";"380"
"8";"Barcelona";"1";"Barcelona";"41";"Vallès Oriental";"08096";"Granollers";"3";"1";"A";"703";"262";"454";"564";"139";"1";"3";"560";"563"
"8";"Barcelona";"1";"Barcelona";"41";"Vallès Oriental";"08096";"Granollers";"3";"1";"B";"870";"337";"609";"728";"142";"1";"1";"726";"727"
"8";"Barcelona";"1";"Barcelona";"41";"Vallès Oriental";"08096";"Granollers";"3";"10";"A";"484";"150";"271";"348";"136";"1";"1";"346";"347"
"8";"Barcelona";"1";"Barcelona";"41";"Vallès Oriental";"08096";"Granollers";"3";"10";"B";"513";"168";"302";"374";"139";"1";"1";"372";"373"
"8";"Barcelona";"1";"Barcelona";"41";"Vallès Oriental";"08096";"Granollers";"3";"2";"A";"619";"223";"392";"475";"144";"1";"4";"470";"474"
"8";"Barcelona";"1";"Barcelona";"41";"Vallès Oriental";"08096";"Granollers";"3";"2";"B";"806";"265";"497";"587";"219";"1";"3";"583";"586"
"8";"Barcelona";"1";"Barcelona";"41";"Vallès Oriental";"08096";"Granollers";"3";"3";"A";"476";"173";"287";"339";"137";"0";"1";"338";"339"
"8";"Barcelona";"1";"Barcelona";"41";"Vallès Oriental";"08096";"Granollers";"3";"3";"B";"545";"199";"341";"416";"129";"0";"3";"413";"416"
"8";"Barcelona";"1";"Barcelona";"41";"Vallès Oriental";"08096";"Granollers";"3";"4";"A";"672";"230";"428";"542";"130";"5";"6";"531";"537"
"8";"Barcelona";"1";"Barcelona";"41";"Vallès Oriental";"08096";"Granollers";"3";"4";"B";"772";"270";"506";"623";"149";"0";"5";"618";"623"
"8";"Barcelona";"1";"Barcelona";"41";"Vallès Oriental";"08096";"Granollers";"3";"5";"A";"644";"246";"418";"514";"130";"1";"10";"503";"513"
"8";"Barcelona";"1";"Barcelona";"41";"Vallès Oriental";"08096";"Granollers";"3";"5";"B";"688";"273";"415";"529";"159";"2";"4";"523";"527"
"8";"Barcelona";"1";"Barcelona";"41";"Vallès Oriental";"08096";"Granollers";"3";"6";"A";"450";"178";"317";"388";"62";"2";"1";"385";"386"
"8";"Barcelona";"1";"Barcelona";"41";"Vallès Oriental";"08096";"Granollers";"3";"6";"B";"580";"229";"379";"463";"117";"2";"1";"460";"461"
"8";"Barcelona";"1";"Barcelona";"41";"Vallès Oriental";"08096";"Granollers";"3";"7";"U";"683";"292";"412";"499";"184";"2";"3";"494";"497"
"8";"Barcelona";"1";"Barcelona";"41";"Vallès Oriental";"08096";"Granollers";"3";"8";"U";"946";"270";"491";"622";"324";"4";"2";"616";"618"
"8";"Barcelona";"1";"Barcelona";"41";"Vallès Oriental";"08096";"Granollers";"3";"9";"U";"810";"304";"552";"674";"136";"2";"2";"670";"672"
"8";"Barcelona";"1";"Barcelona";"41";"Vallès Oriental";"08096";"Granollers";"4";"1";"A";"797";"266";"530";"659";"138";"0";"2";"657";"659"
"8";"Barcelona";"1";"Barcelona";"41";"Vallès Oriental";"08096";"Granollers";"4";"1";"B";"875";"415";"591";"718";"157";"1";"3";"714";"717"
"8";"Barcelona";"1";"Barcelona";"41";"Vallès Oriental";"08096";"Granollers";"4";"10";"A";"505";"187";"355";"434";"71";"1";"0";"433";"433"
"8";"Barcelona";"1";"Barcelona";"41";"Vallès Oriental";"08096";"Granollers";"4";"10";"B";"680";"247";"449";"573";"107";"0";"1";"572";"573"
"8";"Barcelona";"1";"Barcelona";"41";"Vallès Oriental";"08096";"Granollers";"4";"10";"C";"589";"215";"394";"494";"95";"0";"7";"487";"494"
"8";"Barcelona";"1";"Barcelona";"41";"Vallès Oriental";"08096";"Granollers";"4";"11";"A";"583";"222";"386";"469";"114";"0";"3";"466";"469"
"8";"Barcelona";"1";"Barcelona";"41";"Vallès Oriental";"08096";"Granollers";"4";"11";"B";"689";"275";"470";"571";"118";"1";"4";"566";"570"
"8";"Barcelona";"1";"Barcelona";"41";"Vallès Oriental";"08096";"Granollers";"4";"2";"A";"754";"268";"481";"576";"178";"8";"0";"568";"568"
"8";"Barcelona";"1";"Barcelona";"41";"Vallès Oriental";"08096";"Granollers";"4";"2";"B";"832";"283";"519";"636";"196";"8";"4";"624";"628"
"8";"Barcelona";"1";"Barcelona";"41";"Vallès Oriental";"08096";"Granollers";"4";"3";"U";"680";"222";"388";"482";"198";"0";"2";"480";"482"
"8";"Barcelona";"1";"Barcelona";"41";"Vallès Oriental";"08096";"Granollers";"4";"4";"A";"523";"193";"320";"373";"150";"1";"1";"371";"372"
"8";"Barcelona";"1";"Barcelona";"41";"Vallès Oriental";"08096";"Granollers";"4";"4";"B";"596";"210";"359";"405";"191";"2";"2";"401";"403"
"8";"Barcelona";"1";"Barcelona";"41";"Vallès Oriental";"08096";"Granollers";"4";"6";"U";"794";"274";"467";"568";"226";"2";"5";"561";"566"
"8";"Barcelona";"1";"Barcelona";"41";"Vallès Oriental";"08096";"Granollers";"4";"7";"A";"529";"163";"313";"431";"98";"3";"1";"427";"428"
"8";"Barcelona";"1";"Barcelona";"41";"Vallès Oriental";"08096";"Granollers";"4";"7";"B";"704";"223";"423";"575";"129";"2";"5";"568";"573"
"8";"Barcelona";"1";"Barcelona";"41";"Vallès Oriental";"08096";"Granollers";"4";"7";"C";"572";"168";"352";"468";"104";"0";"5";"463";"468"
"8";"Barcelona";"1";"Barcelona";"41";"Vallès Oriental";"08096";"Granollers";"4";"8";"A";"436";"150";"266";"325";"111";"1";"3";"321";"324"
"8";"Barcelona";"1";"Barcelona";"41";"Vallès Oriental";"08096";"Granollers";"4";"8";"B";"493";"172";"306";"375";"118";"1";"0";"374";"374"
"8";"Barcelona";"1";"Barcelona";"41";"Vallès Oriental";"08096";"Granollers";"4";"9";"A";"809";"299";"491";"600";"209";"3";"0";"597";"597"
"8";"Barcelona";"1";"Barcelona";"41";"Vallès Oriental";"08096";"Granollers";"4";"9";"B";"422";"185";"279";"335";"87";"1";"2";"332";"334"
"8";"Barcelona";"1";"Barcelona";"41";"Vallès Oriental";"08097";"Gualba";"1";"1";"A";"463";"190";"319";"393";"70";"1";"1";"391";"392"
"8";"Barcelona";"1";"Barcelona";"41";"Vallès Oriental";"08097";"Gualba";"1";"1";"B";"553";"219";"388";"470";"83";"1";"1";"468";"469"
"8";"Barcelona";"1";"Barcelona";"13";"Barcelonès";"08101";"Hospitalet de Llobregat, l'";"1";"1";"A";"691";"240";"413";"552";"139";"2";"2";"548";"550"
"8";"Barcelona";"1";"Barcelona";"13";"Barcelonès";"08101";"Hospitalet de Llobregat, l'";"1";"1";"B";"798";"284";"516";"686";"112";"2";"7";"677";"684"
"8";"Barcelona";"1";"Barcelona";"13";"Barcelonès";"08101";"Hospitalet de Llobregat, l'";"1";"10";"U";"887";"383";"621";"714";"173";"1";"0";"713";"713"
"8";"Barcelona";"1";"Barcelona";"13";"Barcelonès";"08101";"Hospitalet de Llobregat, l'";"1";"11";"U";"630";"232";"435";"497";"133";"2";"2";"493";"495"
"8";"Barcelona";"1";"Barcelona";"13";"Barcelonès";"08101";"Hospitalet de Llobregat, l'";"1";"12";"A";"579";"218";"407";"496";"83";"2";"3";"491";"494"
"8";"Barcelona";"1";"Barcelona";"13";"Barcelonès";"08101";"Hospitalet de Llobregat, l'";"1";"12";"B";"575";"202";"377";"460";"115";"1";"0";"459";"459"
"8";"Barcelona";"1";"Barcelona";"13";"Barcelonès";"08101";"Hospitalet de Llobregat, l'";"1";"13";"A";"576";"224";"380";"478";"98";"3";"4";"471";"475"
"8";"Barcelona";"1";"Barcelona";"13";"Barcelonès";"08101";"Hospitalet de Llobregat, l'";"1";"13";"B";"663";"254";"439";"549";"114";"3";"4";"542";"546"
"8";"Barcelona";"1";"Barcelona";"13";"Barcelonès";"08101";"Hospitalet de Llobregat, l'";"1";"14";"A";"528";"225";"319";"395";"133";"1";"2";"392";"394"
"8";"Barcelona";"1";"Barcelona";"13";"Barcelonès";"08101";"Hospitalet de Llobregat, l'";"1";"14";"B";"596";"244";"356";"450";"146";"3";"3";"444";"447"
"8";"Barcelona";"1";"Barcelona";"13";"Barcelonès";"08101";"Hospitalet de Llobregat, l'";"1";"15";"U";"905";"302";"528";"681";"224";"1";"4";"676";"680"
"8";"Barcelona";"1";"Barcelona";"13";"Barcelonès";"08101";"Hospitalet de Llobregat, l'";"1";"16";"A";"502";"193";"335";"412";"90";"0";"0";"412";"412"
"8";"Barcelona";"1";"Barcelona";"13";"Barcelonès";"08101";"Hospitalet de Llobregat, l'";"1";"16";"B";"582";"234";"376";"456";"126";"2";"2";"452";"454"
"8";"Barcelona";"1";"Barcelona";"13";"Barcelonès";"08101";"Hospitalet de Llobregat, l'";"1";"17";"A";"677";"247";"411";"517";"160";"3";"4";"510";"514"
"8";"Barcelona";"1";"Barcelona";"13";"Barcelonès";"08101";"Hospitalet de Llobregat, l'";"1";"17";"B";"759";"280";"478";"599";"160";"4";"5";"590";"595"
"8";"Barcelona";"1";"Barcelona";"13";"Barcelonès";"08101";"Hospitalet de Llobregat, l'";"1";"18";"A";"600";"225";"359";"466";"134";"0";"1";"465";"466"
"8";"Barcelona";"1";"Barcelona";"13";"Barcelonès";"08101";"Hospitalet de Llobregat, l'";"1";"18";"B";"636";"234";"402";"516";"120";"0";"2";"514";"516"
"8";"Barcelona";"1";"Barcelona";"13";"Barcelonès";"08101";"Hospitalet de Llobregat, l'";"1";"19";"A";"483";"174";"300";"390";"93";"0";"2";"388";"390"
"8";"Barcelona";"1";"Barcelona";"13";"Barcelonès";"08101";"Hospitalet de Llobregat, l'";"1";"19";"B";"535";"202";"334";"414";"121";"1";"3";"410";"413"
"8";"Barcelona";"1";"Barcelona";"13";"Barcelonès";"08101";"Hospitalet de Llobregat, l'";"1";"2";"A";"557";"214";"354";"442";"115";"4";"1";"437";"438"
"8";"Barcelona";"1";"Barcelona";"13";"Barcelonès";"08101";"Hospitalet de Llobregat, l'";"1";"2";"B";"631";"215";"384";"496";"135";"2";"2";"492";"494"
"8";"Barcelona";"1";"Barcelona";"13";"Barcelonès";"08101";"Hospitalet de Llobregat, l'";"1";"20";"A";"589";"208";"379";"465";"124";"2";"2";"461";"463"
"8";"Barcelona";"1";"Barcelona";"13";"Barcelonès";"08101";"Hospitalet de Llobregat, l'";"1";"20";"B";"721";"237";"435";"556";"165";"1";"6";"549";"555"
"8";"Barcelona";"1";"Barcelona";"13";"Barcelonès";"08101";"Hospitalet de Llobregat, l'";"1";"21";"U";"587";"214";"354";"412";"175";"3";"1";"408";"409"
"8";"Barcelona";"1";"Barcelona";"13";"Barcelonès";"08101";"Hospitalet de Llobregat, l'";"1";"22";"U";"570";"222";"357";"429";"141";"4";"3";"422";"425"
"8";"Barcelona";"1";"Barcelona";"13";"Barcelonès";"08101";"Hospitalet de Llobregat, l'";"1";"23";"U";"961";"351";"450";"778";"183";"1";"5";"772";"777"
"8";"Barcelona";"1";"Barcelona";"13";"Barcelonès";"08101";"Hospitalet de Llobregat, l'";"1";"24";"U";"602";"337";"401";"511";"91";"2";"3";"506";"509"
"8";"Barcelona";"1";"Barcelona";"13";"Barcelonès";"08101";"Hospitalet de Llobregat, l'";"1";"25";"A";"535";"178";"319";"376";"159";"0";"2";"374";"376"
"8";"Barcelona";"1";"Barcelona";"13";"Barcelonès";"08101";"Hospitalet de Llobregat, l'";"1";"25";"B";"574";"220";"360";"447";"127";"1";"3";"443";"446"
"8";"Barcelona";"1";"Barcelona";"13";"Barcelonès";"08101";"Hospitalet de Llobregat, l'";"1";"26";"U";"718";"264";"434";"538";"180";"6";"2";"530";"532"
"8";"Barcelona";"1";"Barcelona";"13";"Barcelonès";"08101";"Hospitalet de Llobregat, l'";"1";"27";"U";"573";"214";"351";"426";"147";"1";"5";"420";"425"
"8";"Barcelona";"1";"Barcelona";"13";"Barcelonès";"08101";"Hospitalet de Llobregat, l'";"1";"28";"U";"763";"271";"450";"558";"205";"0";"2";"556";"558"
"8";"Barcelona";"1";"Barcelona";"13";"Barcelonès";"08101";"Hospitalet de Llobregat, l'";"1";"29";"U";"796";"260";"459";"552";"244";"0";"0";"552";"552"
"8";"Barcelona";"1";"Barcelona";"13";"Barcelonès";"08101";"Hospitalet de Llobregat, l'";"1";"3";"U";"562";"195";"368";"444";"118";"0";"3";"441";"444"
"8";"Barcelona";"1";"Barcelona";"13";"Barcelonès";"08101";"Hospitalet de Llobregat, l'";"1";"30";"U";"806";"277";"555";"646";"160";"2";"6";"638";"644"
"8";"Barcelona";"1";"Barcelona";"13";"Barcelonès";"08101";"Hospitalet de Llobregat, l'";"1";"31";"A";"442";"154";"256";"325";"117";"0";"2";"323";"325"
"8";"Barcelona";"1";"Barcelona";"13";"Barcelonès";"08101";"Hospitalet de Llobregat, l'";"1";"31";"B";"571";"205";"365";"445";"126";"2";"1";"442";"443"
"8";"Barcelona";"1";"Barcelona";"13";"Barcelonès";"08101";"Hospitalet de Llobregat, l'";"1";"32";"A";"778";"280";"477";"597";"181";"2";"5";"590";"595"
"8";"Barcelona";"1";"Barcelona";"13";"Barcelonès";"08101";"Hospitalet de Llobregat, l'";"1";"32";"B";"854";"296";"525";"641";"213";"3";"3";"635";"638"
"8";"Barcelona";"1";"Barcelona";"13";"Barcelonès";"08101";"Hospitalet de Llobregat, l'";"1";"33";"U";"636";"266";"454";"518";"118";"0";"3";"515";"518"
"8";"Barcelona";"1";"Barcelona";"13";"Barcelonès";"08101";"Hospitalet de Llobregat, l'";"1";"34";"U";"1013";"331";"629";"801";"212";"2";"5";"794";"799"
"8";"Barcelona";"1";"Barcelona";"13";"Barcelonès";"08101";"Hospitalet de Llobregat, l'";"1";"35";"A";"528";"172";"297";"400";"128";"3";"3";"394";"397"
"8";"Barcelona";"1";"Barcelona";"13";"Barcelonès";"08101";"Hospitalet de Llobregat, l'";"1";"35";"B";"606";"215";"377";"469";"137";"2";"1";"466";"467"
"8";"Barcelona";"1";"Barcelona";"13";"Barcelonès";"08101";"Hospitalet de Llobregat, l'";"1";"36";"U";"904";"352";"594";"727";"177";"2";"4";"721";"725"
"8";"Barcelona";"1";"Barcelona";"13";"Barcelonès";"08101";"Hospitalet de Llobregat, l'";"1";"37";"A";"463";"160";"300";"368";"95";"2";"5";"361";"366"
"8";"Barcelona";"1";"Barcelona";"13";"Barcelonès";"08101";"Hospitalet de Llobregat, l'";"1";"37";"B";"582";"238";"400";"475";"107";"0";"0";"475";"475"
"8";"Barcelona";"1";"Barcelona";"13";"Barcelonès";"08101";"Hospitalet de Llobregat, l'";"1";"38";"U";"618";"252";"419";"523";"95";"1";"4";"518";"522"
"8";"Barcelona";"1";"Barcelona";"13";"Barcelonès";"08101";"Hospitalet de Llobregat, l'";"1";"39";"U";"643";"225";"407";"504";"139";"2";"0";"502";"502"
"8";"Barcelona";"1";"Barcelona";"13";"Barcelonès";"08101";"Hospitalet de Llobregat, l'";"1";"4";"U";"668";"246";"435";"526";"142";"2";"6";"518";"524"
"8";"Barcelona";"1";"Barcelona";"13";"Barcelonès";"08101";"Hospitalet de Llobregat, l'";"1";"40";"U";"625";"219";"340";"410";"215";"3";"3";"404";"407"
"8";"Barcelona";"1";"Barcelona";"13";"Barcelonès";"08101";"Hospitalet de Llobregat, l'";"1";"5";"U";"882";"319";"574";"713";"169";"3";"2";"708";"710"
"8";"Barcelona";"1";"Barcelona";"13";"Barcelonès";"08101";"Hospitalet de Llobregat, l'";"1";"6";"A";"624";"237";"401";"499";"125";"2";"1";"496";"497"
"8";"Barcelona";"1";"Barcelona";"13";"Barcelonès";"08101";"Hospitalet de Llobregat, l'";"1";"6";"B";"711";"287";"452";"553";"158";"1";"2";"550";"552"
"8";"Barcelona";"1";"Barcelona";"13";"Barcelonès";"08101";"Hospitalet de Llobregat, l'";"1";"7";"A";"551";"190";"314";"401";"150";"2";"1";"398";"399"
"8";"Barcelona";"1";"Barcelona";"13";"Barcelonès";"08101";"Hospitalet de Llobregat, l'";"1";"7";"B";"641";"206";"370";"463";"178";"0";"2";"461";"463"
"8";"Barcelona";"1";"Barcelona";"13";"Barcelonès";"08101";"Hospitalet de Llobregat, l'";"1";"8";"A";"466";"188";"308";"387";"79";"1";"5";"381";"386"
"8";"Barcelona";"1";"Barcelona";"13";"Barcelonès";"08101";"Hospitalet de Llobregat, l'";"1";"8";"B";"588";"193";"401";"461";"127";"2";"3";"456";"459"
"8";"Barcelona";"1";"Barcelona";"13";"Barcelonès";"08101";"Hospitalet de Llobregat, l'";"1";"9";"U";"894";"337";"609";"736";"158";"2";"0";"734";"734"
"8";"Barcelona";"1";"Barcelona";"13";"Barcelonès";"08101";"Hospitalet de Llobregat, l'";"2";"1";"A";"491";"172";"307";"393";"98";"1";"1";"391";"392"
"8";"Barcelona";"1";"Barcelona";"13";"Barcelonès";"08101";"Hospitalet de Llobregat, l'";"2";"1";"B";"552";"190";"323";"407";"145";"0";"1";"406";"407"
"8";"Barcelona";"1";"Barcelona";"13";"Barcelonès";"08101";"Hospitalet de Llobregat, l'";"2";"10";"U";"630";"233";"370";"458";"172";"3";"1";"454";"455"
"8";"Barcelona";"1";"Barcelona";"13";"Barcelonès";"08101";"Hospitalet de Llobregat, l'";"2";"11";"U";"736";"229";"380";"458";"278";"1";"4";"453";"457"
"8";"Barcelona";"1";"Barcelona";"13";"Barcelonès";"08101";"Hospitalet de Llobregat, l'";"2";"12";"U";"786";"201";"421";"513";"273";"3";"0";"510";"510"
"8";"Barcelona";"1";"Barcelona";"13";"Barcelonès";"08101";"Hospitalet de Llobregat, l'";"2";"13";"U";"563";"182";"320";"379";"184";"4";"1";"374";"375"
"8";"Barcelona";"1";"Barcelona";"13";"Barcelonès";"08101";"Hospitalet de Llobregat, l'";"2";"14";"A";"605";"201";"327";"381";"224";"1";"3";"377";"380"
"8";"Barcelona";"1";"Barcelona";"13";"Barcelonès";"08101";"Hospitalet de Llobregat, l'";"2";"14";"B";"619";"197";"342";"413";"206";"1";"5";"407";"412"
"8";"Barcelona";"1";"Barcelona";"13";"Barcelonès";"08101";"Hospitalet de Llobregat, l'";"2";"16";"U";"824";"281";"446";"564";"260";"0";"9";"555";"564"
"8";"Barcelona";"1";"Barcelona";"13";"Barcelonès";"08101";"Hospitalet de Llobregat, l'";"2";"17";"U";"824";"259";"455";"536";"288";"5";"3";"528";"531"
"8";"Barcelona";"1";"Barcelona";"13";"Barcelonès";"08101";"Hospitalet de Llobregat, l'";"2";"2";"U";"936";"289";"475";"571";"365";"5";"3";"563";"566"
"8";"Barcelona";"1";"Barcelona";"13";"Barcelonès";"08101";"Hospitalet de Llobregat, l'";"2";"20";"A";"419";"144";"222";"270";"149";"1";"0";"269";"269"
"8";"Barcelona";"1";"Barcelona";"13";"Barcelonès";"08101";"Hospitalet de Llobregat, l'";"2";"20";"B";"547";"187";"304";"370";"177";"1";"2";"367";"369"
"8";"Barcelona";"1";"Barcelona";"13";"Barcelonès";"08101";"Hospitalet de Llobregat, l'";"2";"21";"A";"577";"181";"295";"376";"201";"0";"3";"373";"376"
"8";"Barcelona";"1";"Barcelona";"13";"Barcelonès";"08101";"Hospitalet de Llobregat, l'";"2";"21";"B";"626";"195";"303";"399";"227";"2";"1";"396";"397"
"8";"Barcelona";"1";"Barcelona";"13";"Barcelonès";"08101";"Hospitalet de Llobregat, l'";"2";"23";"U";"695";"240";"373";"460";"235";"1";"4";"455";"459"
"8";"Barcelona";"1";"Barcelona";"13";"Barcelonès";"08101";"Hospitalet de Llobregat, l'";"2";"24";"U";"697";"208";"358";"433";"264";"1";"3";"429";"432"
"8";"Barcelona";"1";"Barcelona";"13";"Barcelonès";"08101";"Hospitalet de Llobregat, l'";"2";"26";"A";"513";"203";"314";"372";"141";"2";"3";"367";"370"
"8";"Barcelona";"1";"Barcelona";"13";"Barcelonès";"08101";"Hospitalet de Llobregat, l'";"2";"26";"B";"588";"180";"341";"405";"183";"1";"2";"402";"404"
"8";"Barcelona";"1";"Barcelona";"13";"Barcelonès";"08101";"Hospitalet de Llobregat, l'";"2";"28";"A";"588";"177";"267";"338";"250";"3";"0";"335";"335"
"8";"Barcelona";"1";"Barcelona";"13";"Barcelonès";"08101";"Hospitalet de Llobregat, l'";"2";"28";"B";"677";"213";"350";"426";"251";"0";"4";"422";"426"
"8";"Barcelona";"1";"Barcelona";"13";"Barcelonès";"08101";"Hospitalet de Llobregat, l'";"2";"29";"A";"438";"114";"201";"253";"185";"2";"4";"247";"251"
"8";"Barcelona";"1";"Barcelona";"13";"Barcelonès";"08101";"Hospitalet de Llobregat, l'";"2";"29";"B";"520";"125";"246";"297";"223";"4";"1";"292";"293"
"8";"Barcelona";"1";"Barcelona";"13";"Barcelonès";"08101";"Hospitalet de Llobregat, l'";"2";"31";"U";"659";"209";"348";"419";"240";"1";"1";"417";"418"
"8";"Barcelona";"1";"Barcelona";"13";"Barcelonès";"08101";"Hospitalet de Llobregat, l'";"2";"32";"U";"624";"206";"385";"455";"169";"3";"0";"452";"452"
"8";"Barcelona";"1";"Barcelona";"13";"Barcelonès";"08101";"Hospitalet de Llobregat, l'";"2";"33";"U";"542";"193";"298";"361";"181";"0";"1";"360";"361"
"8";"Barcelona";"1";"Barcelona";"13";"Barcelonès";"08101";"Hospitalet de Llobregat, l'";"2";"34";"U";"594";"195";"316";"379";"215";"4";"4";"371";"375"
"8";"Barcelona";"1";"Barcelona";"13";"Barcelonès";"08101";"Hospitalet de Llobregat, l'";"2";"36";"U";"677";"216";"383";"439";"238";"2";"0";"437";"437"
"8";"Barcelona";"1";"Barcelona";"13";"Barcelonès";"08101";"Hospitalet de Llobregat, l'";"2";"37";"U";"792";"339";"501";"501";"291";"4";"1";"496";"497"
"8";"Barcelona";"1";"Barcelona";"13";"Barcelonès";"08101";"Hospitalet de Llobregat, l'";"2";"38";"U";"557";"174";"303";"366";"191";"1";"3";"362";"365"
"8";"Barcelona";"1";"Barcelona";"13";"Barcelonès";"08101";"Hospitalet de Llobregat, l'";"2";"39";"U";"699";"237";"403";"492";"207";"2";"0";"490";"490"
"8";"Barcelona";"1";"Barcelona";"13";"Barcelonès";"08101";"Hospitalet de Llobregat, l'";"2";"4";"U";"880";"250";"510";"603";"277";"6";"3";"594";"597"
"8";"Barcelona";"1";"Barcelona";"13";"Barcelonès";"08101";"Hospitalet de Llobregat, l'";"2";"40";"A";"458";"143";"255";"316";"142";"3";"1";"312";"313"
"8";"Barcelona";"1";"Barcelona";"13";"Barcelonès";"08101";"Hospitalet de Llobregat, l'";"2";"40";"B";"510";"152";"270";"315";"195";"2";"2";"311";"313"
"8";"Barcelona";"1";"Barcelona";"13";"Barcelonès";"08101";"Hospitalet de Llobregat, l'";"2";"42";"U";"699";"230";"365";"444";"255";"1";"1";"442";"443"
"8";"Barcelona";"1";"Barcelona";"13";"Barcelonès";"08101";"Hospitalet de Llobregat, l'";"2";"43";"A";"455";"158";"265";"314";"141";"0";"2";"312";"314"
"8";"Barcelona";"1";"Barcelona";"13";"Barcelonès";"08101";"Hospitalet de Llobregat, l'";"2";"43";"B";"575";"185";"328";"386";"189";"1";"1";"384";"385"
"8";"Barcelona";"1";"Barcelona";"13";"Barcelonès";"08101";"Hospitalet de Llobregat, l'";"2";"45";"U";"647";"235";"345";"417";"230";"3";"1";"413";"414"
"8";"Barcelona";"1";"Barcelona";"13";"Barcelonès";"08101";"Hospitalet de Llobregat, l'";"2";"46";"U";"658";"237";"369";"424";"234";"0";"3";"421";"424"
"8";"Barcelona";"1";"Barcelona";"13";"Barcelonès";"08101";"Hospitalet de Llobregat, l'";"2";"47";"U";"760";"226";"422";"503";"257";"4";"4";"495";"499"
"8";"Barcelona";"1";"Barcelona";"13";"Barcelonès";"08101";"Hospitalet de Llobregat, l'";"2";"48";"U";"756";"219";"412";"504";"252";"7";"3";"494";"497"
"8";"Barcelona";"1";"Barcelona";"13";"Barcelonès";"08101";"Hospitalet de Llobregat, l'";"2";"49";"U";"631";"215";"366";"427";"204";"0";"0";"427";"427"
"8";"Barcelona";"1";"Barcelona";"13";"Barcelonès";"08101";"Hospitalet de Llobregat, l'";"2";"5";"U";"675";"251";"396";"475";"200";"2";"2";"471";"473"
"8";"Barcelona";"1";"Barcelona";"13";"Barcelonès";"08101";"Hospitalet de Llobregat, l'";"2";"7";"A";"507";"174";"277";"353";"154";"0";"2";"351";"353"
"8";"Barcelona";"1";"Barcelona";"13";"Barcelonès";"08101";"Hospitalet de Llobregat, l'";"2";"7";"B";"584";"220";"340";"417";"167";"2";"2";"413";"415"
"8";"Barcelona";"1";"Barcelona";"13";"Barcelonès";"08101";"Hospitalet de Llobregat, l'";"2";"8";"A";"611";"223";"353";"431";"180";"1";"6";"424";"430"
"8";"Barcelona";"1";"Barcelona";"13";"Barcelonès";"08101";"Hospitalet de Llobregat, l'";"2";"8";"B";"686";"248";"419";"499";"187";"4";"8";"487";"495"
"8";"Barcelona";"1";"Barcelona";"13";"Barcelonès";"08101";"Hospitalet de Llobregat, l'";"2";"9";"U";"662";"237";"401";"472";"190";"1";"0";"471";"471"
"8";"Barcelona";"1";"Barcelona";"13";"Barcelonès";"08101";"Hospitalet de Llobregat, l'";"3";"1";"A";"627";"222";"382";"467";"160";"3";"1";"463";"464"
"8";"Barcelona";"1";"Barcelona";"13";"Barcelonès";"08101";"Hospitalet de Llobregat, l'";"3";"1";"B";"774";"276";"487";"590";"184";"4";"5";"581";"586"
"8";"Barcelona";"1";"Barcelona";"13";"Barcelonès";"08101";"Hospitalet de Llobregat, l'";"3";"1";"C";"611";"247";"398";"465";"146";"3";"3";"459";"462"
"8";"Barcelona";"1";"Barcelona";"13";"Barcelonès";"08101";"Hospitalet de Llobregat, l'";"3";"10";"U";"643";"200";"381";"461";"182";"1";"0";"460";"460"
"8";"Barcelona";"1";"Barcelona";"13";"Barcelonès";"08101";"Hospitalet de Llobregat, l'";"3";"11";"U";"888";"271";"513";"622";"266";"1";"2";"619";"621"
"8";"Barcelona";"1";"Barcelona";"13";"Barcelonès";"08101";"Hospitalet de Llobregat, l'";"3";"12";"A";"587";"223";"366";"435";"152";"2";"0";"433";"433"
"8";"Barcelona";"1";"Barcelona";"13";"Barcelonès";"08101";"Hospitalet de Llobregat, l'";"3";"12";"B";"611";"212";"369";"451";"160";"3";"2";"446";"448"
"8";"Barcelona";"1";"Barcelona";"13";"Barcelonès";"08101";"Hospitalet de Llobregat, l'";"3";"13";"A";"660";"236";"405";"496";"164";"2";"3";"491";"494"
"8";"Barcelona";"1";"Barcelona";"13";"Barcelonès";"08101";"Hospitalet de Llobregat, l'";"3";"13";"B";"717";"246";"440";"547";"170";"1";"2";"544";"546"
"8";"Barcelona";"1";"Barcelona";"13";"Barcelonès";"08101";"Hospitalet de Llobregat, l'";"3";"14";"A";"797";"252";"481";"597";"200";"3";"8";"586";"594"
"8";"Barcelona";"1";"Barcelona";"13";"Barcelonès";"08101";"Hospitalet de Llobregat, l'";"3";"14";"B";"939";"297";"572";"705";"234";"4";"5";"696";"701"
"8";"Barcelona";"1";"Barcelona";"13";"Barcelonès";"08101";"Hospitalet de Llobregat, l'";"3";"15";"A";"579";"211";"365";"442";"137";"2";"1";"439";"440"
"8";"Barcelona";"1";"Barcelona";"13";"Barcelonès";"08101";"Hospitalet de Llobregat, l'";"3";"15";"B";"629";"214";"371";"455";"174";"1";"1";"453";"454"
"8";"Barcelona";"1";"Barcelona";"13";"Barcelonès";"08101";"Hospitalet de Llobregat, l'";"3";"16";"A";"808";"292";"523";"685";"123";"8";"4";"673";"677"
"8";"Barcelona";"1";"Barcelona";"13";"Barcelonès";"08101";"Hospitalet de Llobregat, l'";"3";"16";"B";"942";"282";"618";"772";"170";"1";"2";"769";"771"
"8";"Barcelona";"1";"Barcelona";"13";"Barcelonès";"08101";"Hospitalet de Llobregat, l'";"3";"17";"U";"597";"179";"302";"412";"185";"1";"5";"406";"411"
"8";"Barcelona";"1";"Barcelona";"13";"Barcelonès";"08101";"Hospitalet de Llobregat, l'";"3";"18";"U";"621";"227";"414";"515";"106";"0";"3";"512";"515"
"8";"Barcelona";"1";"Barcelona";"13";"Barcelonès";"08101";"Hospitalet de Llobregat, l'";"3";"19";"A";"529";"188";"328";"422";"107";"1";"5";"416";"421"
"8";"Barcelona";"1";"Barcelona";"13";"Barcelonès";"08101";"Hospitalet de Llobregat, l'";"3";"19";"B";"593";"218";"419";"499";"94";"1";"4";"494";"498"
"8";"Barcelona";"1";"Barcelona";"13";"Barcelonès";"08101";"Hospitalet de Llobregat, l'";"3";"2";"A";"437";"155";"256";"328";"109";"2";"1";"325";"326"
"8";"Barcelona";"1";"Barcelona";"13";"Barcelonès";"08101";"Hospitalet de Llobregat, l'";"3";"2";"B";"558";"197";"345";"430";"128";"1";"0";"429";"429"
"8";"Barcelona";"1";"Barcelona";"13";"Barcelonès";"08101";"Hospitalet de Llobregat, l'";"3";"20";"A";"492";"196";"305";"385";"107";"4";"1";"380";"381"
"8";"Barcelona";"1";"Barcelona";"13";"Barcelonès";"08101";"Hospitalet de Llobregat, l'";"3";"20";"B";"575";"216";"361";"444";"131";"0";"1";"443";"444"
"8";"Barcelona";"1";"Barcelona";"13";"Barcelonès";"08101";"Hospitalet de Llobregat, l'";"3";"21";"A";"826";"305";"549";"686";"140";"3";"4";"679";"683"
"8";"Barcelona";"1";"Barcelona";"13";"Barcelonès";"08101";"Hospitalet de Llobregat, l'";"3";"21";"B";"923";"329";"600";"754";"169";"1";"3";"750";"753"
"8";"Barcelona";"1";"Barcelona";"13";"Barcelonès";"08101";"Hospitalet de Llobregat, l'";"3";"22";"U";"876";"288";"481";"605";"271";"1";"3";"601";"604"
"8";"Barcelona";"1";"Barcelona";"13";"Barcelonès";"08101";"Hospitalet de Llobregat, l'";"3";"23";"A";"377";"133";"229";"280";"97";"1";"0";"279";"279"
"8";"Barcelona";"1";"Barcelona";"13";"Barcelonès";"08101";"Hospitalet de Llobregat, l'";"3";"23";"B";"504";"173";"316";"389";"115";"1";"2";"386";"388"
"8";"Barcelona";"1";"Barcelona";"13";"Barcelonès";"08101";"Hospitalet de Llobregat, l'";"3";"23";"C";"459";"161";"286";"348";"111";"3";"1";"344";"345"
"8";"Barcelona";"1";"Barcelona";"13";"Barcelonès";"08101";"Hospitalet de Llobregat, l'";"3";"24";"U";"702";"218";"374";"449";"253";"7";"1";"441";"442"
"8";"Barcelona";"1";"Barcelona";"13";"Barcelonès";"08101";"Hospitalet de Llobregat, l'";"3";"25";"A";"684";"273";"435";"527";"157";"1";"5";"521";"526"
"8";"Barcelona";"1";"Barcelona";"13";"Barcelonès";"08101";"Hospitalet de Llobregat, l'";"3";"25";"B";"719";"277";"454";"570";"149";"2";"4";"564";"568"
"8";"Barcelona";"1";"Barcelona";"13";"Barcelonès";"08101";"Hospitalet de Llobregat, l'";"3";"26";"U";"663";"220";"426";"543";"120";"1";"2";"540";"542"
"8";"Barcelona";"1";"Barcelona";"13";"Barcelonès";"08101";"Hospitalet de Llobregat, l'";"3";"27";"U";"902";"266";"574";"732";"170";"2";"1";"729";"730"
"8";"Barcelona";"1";"Barcelona";"13";"Barcelonès";"08101";"Hospitalet de Llobregat, l'";"3";"3";"A";"542";"175";"308";"373";"169";"3";"2";"368";"370"
"8";"Barcelona";"1";"Barcelona";"13";"Barcelonès";"08101";"Hospitalet de Llobregat, l'";"3";"3";"B";"591";"196";"348";"413";"178";"0";"3";"410";"413"
"8";"Barcelona";"1";"Barcelona";"13";"Barcelonès";"08101";"Hospitalet de Llobregat, l'";"3";"4";"A";"610";"222";"370";"463";"147";"3";"2";"458";"460"
"8";"Barcelona";"1";"Barcelona";"13";"Barcelonès";"08101";"Hospitalet de Llobregat, l'";"3";"4";"B";"680";"246";"405";"501";"179";"2";"3";"496";"499"
"8";"Barcelona";"1";"Barcelona";"13";"Barcelonès";"08101";"Hospitalet de Llobregat, l'";"3";"4";"C";"604";"213";"381";"461";"143";"1";"1";"459";"460"
"8";"Barcelona";"1";"Barcelona";"13";"Barcelonès";"08101";"Hospitalet de Llobregat, l'";"3";"5";"A";"560";"221";"360";"428";"132";"2";"2";"424";"426"
"8";"Barcelona";"1";"Barcelona";"13";"Barcelonès";"08101";"Hospitalet de Llobregat, l'";"3";"5";"B";"571";"218";"348";"419";"152";"2";"2";"415";"417"
"8";"Barcelona";"1";"Barcelona";"13";"Barcelonès";"08101";"Hospitalet de Llobregat, l'";"3";"6";"A";"507";"178";"317";"361";"146";"0";"1";"360";"361"
"8";"Barcelona";"1";"Barcelona";"13";"Barcelonès";"08101";"Hospitalet de Llobregat, l'";"3";"6";"B";"572";"210";"339";"403";"169";"0";"2";"401";"403"
"8";"Barcelona";"1";"Barcelona";"13";"Barcelonès";"08101";"Hospitalet de Llobregat, l'";"3";"7";"A";"521";"214";"355";"428";"93";"1";"1";"426";"427"
"8";"Barcelona";"1";"Barcelona";"13";"Barcelonès";"08101";"Hospitalet de Llobregat, l'";"3";"7";"B";"577";"223";"379";"466";"111";"3";"2";"461";"463"
"8";"Barcelona";"1";"Barcelona";"13";"Barcelonès";"08101";"Hospitalet de Llobregat, l'";"3";"8";"A";"682";"252";"411";"537";"145";"1";"1";"535";"536"
"8";"Barcelona";"1";"Barcelona";"13";"Barcelonès";"08101";"Hospitalet de Llobregat, l'";"3";"8";"B";"847";"294";"528";"681";"166";"0";"1";"680";"681"
"8";"Barcelona";"1";"Barcelona";"13";"Barcelonès";"08101";"Hospitalet de Llobregat, l'";"3";"9";"U";"746";"241";"466";"567";"179";"1";"5";"561";"566"
"8";"Barcelona";"1";"Barcelona";"13";"Barcelonès";"08101";"Hospitalet de Llobregat, l'";"4";"1";"U";"780";"262";"444";"546";"234";"0";"3";"543";"546"
"8";"Barcelona";"1";"Barcelona";"13";"Barcelonès";"08101";"Hospitalet de Llobregat, l'";"4";"10";"A";"534";"181";"303";"371";"163";"2";"2";"367";"369"
"8";"Barcelona";"1";"Barcelona";"13";"Barcelonès";"08101";"Hospitalet de Llobregat, l'";"4";"10";"B";"580";"222";"360";"423";"157";"0";"0";"423";"423"
"8";"Barcelona";"1";"Barcelona";"13";"Barcelonès";"08101";"Hospitalet de Llobregat, l'";"4";"11";"U";"683";"253";"397";"503";"180";"4";"1";"498";"499"
"8";"Barcelona";"1";"Barcelona";"13";"Barcelonès";"08101";"Hospitalet de Llobregat, l'";"4";"12";"A";"510";"189";"289";"354";"156";"1";"3";"350";"353"
"8";"Barcelona";"1";"Barcelona";"13";"Barcelonès";"08101";"Hospitalet de Llobregat, l'";"4";"12";"B";"589";"213";"360";"431";"158";"0";"0";"431";"431"
"8";"Barcelona";"1";"Barcelona";"13";"Barcelonès";"08101";"Hospitalet de Llobregat, l'";"4";"14";"A";"434";"134";"235";"274";"160";"0";"3";"271";"274"
"8";"Barcelona";"1";"Barcelona";"13";"Barcelonès";"08101";"Hospitalet de Llobregat, l'";"4";"14";"B";"514";"154";"270";"318";"196";"4";"4";"310";"314"
"8";"Barcelona";"1";"Barcelona";"13";"Barcelonès";"08101";"Hospitalet de Llobregat, l'";"4";"16";"U";"812";"272";"449";"521";"291";"2";"2";"517";"519"
"8";"Barcelona";"1";"Barcelona";"13";"Barcelonès";"08101";"Hospitalet de Llobregat, l'";"4";"18";"U";"810";"247";"432";"534";"276";"11";"1";"522";"523"
"8";"Barcelona";"1";"Barcelona";"13";"Barcelonès";"08101";"Hospitalet de Llobregat, l'";"4";"19";"A";"476";"155";"254";"292";"184";"0";"0";"292";"292"
"8";"Barcelona";"1";"Barcelona";"13";"Barcelonès";"08101";"Hospitalet de Llobregat, l'";"4";"19";"B";"554";"164";"282";"335";"219";"1";"3";"331";"334"
"8";"Barcelona";"1";"Barcelona";"13";"Barcelonès";"08101";"Hospitalet de Llobregat, l'";"4";"2";"U";"568";"195";"311";"356";"212";"2";"3";"351";"354"
"8";"Barcelona";"1";"Barcelona";"13";"Barcelonès";"08101";"Hospitalet de Llobregat, l'";"4";"20";"A";"530";"171";"312";"370";"160";"1";"2";"367";"369"
"8";"Barcelona";"1";"Barcelona";"13";"Barcelonès";"08101";"Hospitalet de Llobregat, l'";"4";"20";"B";"686";"222";"377";"455";"231";"2";"5";"448";"453"
"8";"Barcelona";"1";"Barcelona";"13";"Barcelonès";"08101";"Hospitalet de Llobregat, l'";"4";"21";"U";"728";"281";"442";"523";"205";"3";"1";"519";"520"
"8";"Barcelona";"1";"Barcelona";"13";"Barcelonès";"08101";"Hospitalet de Llobregat, l'";"4";"22";"U";"669";"185";"309";"379";"290";"1";"2";"376";"378"
"8";"Barcelona";"1";"Barcelona";"13";"Barcelonès";"08101";"Hospitalet de Llobregat, l'";"4";"23";"U";"581";"231";"355";"409";"172";"1";"1";"407";"408"
"8";"Barcelona";"1";"Barcelona";"13";"Barcelonès";"08101";"Hospitalet de Llobregat, l'";"4";"25";"U";"645";"217";"361";"434";"211";"3";"2";"429";"431"
"8";"Barcelona";"1";"Barcelona";"13";"Barcelonès";"08101";"Hospitalet de Llobregat, l'";"4";"26";"U";"561";"176";"300";"342";"219";"1";"1";"340";"341"
"8";"Barcelona";"1";"Barcelona";"13";"Barcelonès";"08101";"Hospitalet de Llobregat, l'";"4";"27";"U";"862";"279";"431";"486";"376";"4";"3";"479";"482"
"8";"Barcelona";"1";"Barcelona";"13";"Barcelonès";"08101";"Hospitalet de Llobregat, l'";"4";"3";"U";"801";"319";"524";"598";"203";"2";"6";"590";"596"
"8";"Barcelona";"1";"Barcelona";"13";"Barcelonès";"08101";"Hospitalet de Llobregat, l'";"4";"30";"U";"569";"164";"281";"337";"232";"3";"4";"330";"334"
"8";"Barcelona";"1";"Barcelona";"13";"Barcelonès";"08101";"Hospitalet de Llobregat, l'";"4";"31";"U";"784";"288";"423";"481";"303";"1";"5";"475";"480"
"8";"Barcelona";"1";"Barcelona";"13";"Barcelonès";"08101";"Hospitalet de Llobregat, l'";"4";"32";"U";"772";"328";"459";"548";"224";"2";"3";"543";"546"
"8";"Barcelona";"1";"Barcelona";"13";"Barcelonès";"08101";"Hospitalet de Llobregat, l'";"4";"33";"A";"443";"111";"190";"241";"202";"0";"0";"241";"241"
"8";"Barcelona";"1";"Barcelona";"13";"Barcelonès";"08101";"Hospitalet de Llobregat, l'";"4";"33";"B";"528";"159";"264";"317";"211";"1";"0";"316";"316"
"8";"Barcelona";"1";"Barcelona";"13";"Barcelonès";"08101";"Hospitalet de Llobregat, l'";"4";"35";"U";"587";"134";"246";"288";"299";"0";"0";"288";"288"
"8";"Barcelona";"1";"Barcelona";"13";"Barcelonès";"08101";"Hospitalet de Llobregat, l'";"4";"36";"U";"808";"257";"445";"516";"292";"2";"1";"513";"514"
"8";"Barcelona";"1";"Barcelona";"13";"Barcelonès";"08101";"Hospitalet de Llobregat, l'";"4";"37";"U";"951";"331";"521";"631";"320";"2";"2";"627";"629"
"8";"Barcelona";"1";"Barcelona";"13";"Barcelonès";"08101";"Hospitalet de Llobregat, l'";"4";"4";"U";"805";"326";"471";"547";"258";"1";"0";"546";"546"
"8";"Barcelona";"1";"Barcelona";"13";"Barcelonès";"08101";"Hospitalet de Llobregat, l'";"4";"40";"U";"657";"274";"401";"475";"182";"2";"4";"469";"473"
"8";"Barcelona";"1";"Barcelona";"13";"Barcelonès";"08101";"Hospitalet de Llobregat, l'";"4";"41";"A";"662";"247";"415";"511";"151";"3";"4";"504";"508"
"8";"Barcelona";"1";"Barcelona";"13";"Barcelonès";"08101";"Hospitalet de Llobregat, l'";"4";"41";"B";"803";"294";"505";"603";"200";"1";"1";"601";"602"
"8";"Barcelona";"1";"Barcelona";"13";"Barcelonès";"08101";"Hospitalet de Llobregat, l'";"4";"5";"A";"502";"172";"262";"315";"187";"4";"1";"310";"311"
"8";"Barcelona";"1";"Barcelona";"13";"Barcelonès";"08101";"Hospitalet de Llobregat, l'";"4";"5";"B";"553";"207";"314";"366";"187";"3";"0";"363";"363"
"8";"Barcelona";"1";"Barcelona";"13";"Barcelonès";"08101";"Hospitalet de Llobregat, l'";"4";"6";"U";"876";"310";"508";"578";"298";"0";"0";"578";"578"
"8";"Barcelona";"1";"Barcelona";"13";"Barcelonès";"08101";"Hospitalet de Llobregat, l'";"4";"7";"U";"594";"185";"325";"373";"221";"1";"0";"372";"372"
"8";"Barcelona";"1";"Barcelona";"13";"Barcelonès";"08101";"Hospitalet de Llobregat, l'";"4";"9";"A";"512";"160";"273";"335";"177";"0";"3";"332";"335"
"8";"Barcelona";"1";"Barcelona";"13";"Barcelonès";"08101";"Hospitalet de Llobregat, l'";"4";"9";"B";"621";"246";"348";"422";"199";"0";"0";"422";"422"
"8";"Barcelona";"1";"Barcelona";"13";"Barcelonès";"08101";"Hospitalet de Llobregat, l'";"5";"1";"U";"814";"291";"518";"649";"165";"2";"2";"645";"647"
"8";"Barcelona";"1";"Barcelona";"13";"Barcelonès";"08101";"Hospitalet de Llobregat, l'";"5";"10";"U";"662";"256";"392";"480";"182";"0";"2";"478";"480"
"8";"Barcelona";"1";"Barcelona";"13";"Barcelonès";"08101";"Hospitalet de Llobregat, l'";"5";"11";"A";"610";"207";"332";"395";"215";"1";"0";"394";"394"
"8";"Barcelona";"1";"Barcelona";"13";"Barcelonès";"08101";"Hospitalet de Llobregat, l'";"5";"11";"B";"696";"212";"361";"426";"270";"1";"0";"425";"425"
"8";"Barcelona";"1";"Barcelona";"13";"Barcelonès";"08101";"Hospitalet de Llobregat, l'";"5";"13";"U";"828";"243";"411";"508";"320";"0";"1";"507";"508"
"8";"Barcelona";"1";"Barcelona";"13";"Barcelonès";"08101";"Hospitalet de Llobregat, l'";"5";"14";"U";"837";"261";"442";"533";"304";"0";"5";"528";"533"
"8";"Barcelona";"1";"Barcelona";"13";"Barcelonès";"08101";"Hospitalet de Llobregat, l'";"5";"17";"A";"521";"170";"265";"320";"201";"1";"2";"317";"319"
"8";"Barcelona";"1";"Barcelona";"13";"Barcelonès";"08101";"Hospitalet de Llobregat, l'";"5";"17";"B";"596";"196";"319";"390";"206";"0";"1";"389";"390"
"8";"Barcelona";"1";"Barcelona";"13";"Barcelonès";"08101";"Hospitalet de Llobregat, l'";"5";"18";"U";"698";"234";"365";"472";"226";"0";"3";"469";"472"
"8";"Barcelona";"1";"Barcelona";"13";"Barcelonès";"08101";"Hospitalet de Llobregat, l'";"5";"2";"A";"492";"179";"284";"329";"163";"0";"2";"327";"329"
"8";"Barcelona";"1";"Barcelona";"13";"Barcelonès";"08101";"Hospitalet de Llobregat, l'";"5";"2";"B";"557";"210";"323";"392";"165";"0";"4";"388";"392"
"8";"Barcelona";"1";"Barcelona";"13";"Barcelonès";"08101";"Hospitalet de Llobregat, l'";"5";"20";"U";"557";"200";"334";"404";"153";"2";"2";"400";"402"
"8";"Barcelona";"1";"Barcelona";"13";"Barcelonès";"08101";"Hospitalet de Llobregat, l'";"5";"21";"U";"766";"325";"518";"618";"148";"1";"0";"617";"617"
"8";"Barcelona";"1";"Barcelona";"13";"Barcelonès";"08101";"Hospitalet de Llobregat, l'";"5";"23";"U";"875";"276";"500";"592";"283";"2";"5";"585";"590"
"8";"Barcelona";"1";"Barcelona";"13";"Barcelonès";"08101";"Hospitalet de Llobregat, l'";"5";"24";"U";"711";"234";"363";"431";"280";"1";"2";"428";"430"
"8";"Barcelona";"1";"Barcelona";"13";"Barcelonès";"08101";"Hospitalet de Llobregat, l'";"5";"25";"U";"568";"163";"288";"357";"211";"2";"4";"351";"355"
"8";"Barcelona";"1";"Barcelona";"13";"Barcelonès";"08101";"Hospitalet de Llobregat, l'";"5";"26";"A";"460";"135";"201";"262";"198";"1";"2";"259";"261"
"8";"Barcelona";"1";"Barcelona";"13";"Barcelonès";"08101";"Hospitalet de Llobregat, l'";"5";"26";"B";"546";"156";"244";"310";"236";"0";"2";"308";"310"
"8";"Barcelona";"1";"Barcelona";"13";"Barcelonès";"08101";"Hospitalet de Llobregat, l'";"5";"28";"U";"729";"235";"393";"489";"240";"9";"3";"477";"480"
"8";"Barcelona";"1";"Barcelona";"13";"Barcelonès";"08101";"Hospitalet de Llobregat, l'";"5";"29";"U";"735";"255";"395";"462";"273";"4";"0";"458";"458"
"8";"Barcelona";"1";"Barcelona";"13";"Barcelonès";"08101";"Hospitalet de Llobregat, l'";"5";"3";"U";"616";"239";"384";"493";"123";"3";"3";"487";"490"
"8";"Barcelona";"1";"Barcelona";"13";"Barcelonès";"08101";"Hospitalet de Llobregat, l'";"5";"30";"A";"504";"174";"298";"343";"161";"0";"3";"340";"343"
"8";"Barcelona";"1";"Barcelona";"13";"Barcelonès";"08101";"Hospitalet de Llobregat, l'";"5";"30";"B";"564";"201";"336";"400";"164";"0";"1";"399";"400"
"8";"Barcelona";"1";"Barcelona";"13";"Barcelonès";"08101";"Hospitalet de Llobregat, l'";"5";"31";"U";"562";"182";"310";"363";"199";"1";"1";"361";"362"
"8";"Barcelona";"1";"Barcelona";"13";"Barcelonès";"08101";"Hospitalet de Llobregat, l'";"5";"32";"U";"859";"305";"522";"596";"263";"0";"1";"595";"596"
"8";"Barcelona";"1";"Barcelona";"13";"Barcelonès";"08101";"Hospitalet de Llobregat, l'";"5";"33";"A";"491";"162";"272";"335";"156";"0";"0";"335";"335"
"8";"Barcelona";"1";"Barcelona";"13";"Barcelonès";"08101";"Hospitalet de Llobregat, l'";"5";"33";"B";"580";"165";"298";"363";"217";"0";"2";"361";"363"
"8";"Barcelona";"1";"Barcelona";"13";"Barcelonès";"08101";"Hospitalet de Llobregat, l'";"5";"34";"U";"590";"215";"354";"408";"182";"2";"1";"405";"406"
"8";"Barcelona";"1";"Barcelona";"13";"Barcelonès";"08101";"Hospitalet de Llobregat, l'";"5";"35";"U";"763";"266";"523";"624";"139";"0";"1";"623";"624"
"8";"Barcelona";"1";"Barcelona";"13";"Barcelonès";"08101";"Hospitalet de Llobregat, l'";"5";"37";"U";"782";"267";"510";"595";"187";"3";"4";"588";"592"
"8";"Barcelona";"1";"Barcelona";"13";"Barcelonès";"08101";"Hospitalet de Llobregat, l'";"5";"38";"U";"843";"264";"464";"567";"276";"1";"2";"564";"566"
"8";"Barcelona";"1";"Barcelona";"13";"Barcelonès";"08101";"Hospitalet de Llobregat, l'";"5";"4";"U";"803";"295";"503";"625";"178";"4";"4";"617";"621"
"8";"Barcelona";"1";"Barcelona";"13";"Barcelonès";"08101";"Hospitalet de Llobregat, l'";"5";"5";"U";"925";"334";"626";"752";"173";"3";"4";"745";"749"
"8";"Barcelona";"1";"Barcelona";"13";"Barcelonès";"08101";"Hospitalet de Llobregat, l'";"5";"6";"A";"669";"243";"394";"508";"161";"2";"4";"502";"506"
"8";"Barcelona";"1";"Barcelona";"13";"Barcelonès";"08101";"Hospitalet de Llobregat, l'";"5";"6";"B";"687";"240";"418";"539";"148";"2";"3";"534";"537"
"8";"Barcelona";"1";"Barcelona";"13";"Barcelonès";"08101";"Hospitalet de Llobregat, l'";"5";"7";"U";"570";"213";"343";"422";"148";"2";"3";"417";"420"
"8";"Barcelona";"1";"Barcelona";"13";"Barcelonès";"08101";"Hospitalet de Llobregat, l'";"5";"8";"U";"853";"229";"470";"573";"280";"0";"1";"572";"573"
"8";"Barcelona";"1";"Barcelona";"13";"Barcelonès";"08101";"Hospitalet de Llobregat, l'";"6";"1";"A";"691";"245";"402";"532";"159";"3";"3";"526";"529"
"8";"Barcelona";"1";"Barcelona";"13";"Barcelonès";"08101";"Hospitalet de Llobregat, l'";"6";"1";"B";"770";"242";"436";"544";"226";"6";"3";"535";"538"
"8";"Barcelona";"1";"Barcelona";"13";"Barcelonès";"08101";"Hospitalet de Llobregat, l'";"6";"10";"U";"874";"283";"568";"706";"168";"5";"1";"700";"701"
"8";"Barcelona";"1";"Barcelona";"13";"Barcelonès";"08101";"Hospitalet de Llobregat, l'";"6";"11";"A";"605";"200";"344";"439";"166";"0";"3";"436";"439"
"8";"Barcelona";"1";"Barcelona";"13";"Barcelonès";"08101";"Hospitalet de Llobregat, l'";"6";"11";"B";"638";"200";"345";"447";"191";"1";"1";"445";"446"
"8";"Barcelona";"1";"Barcelona";"13";"Barcelonès";"08101";"Hospitalet de Llobregat, l'";"6";"12";"U";"759";"281";"462";"543";"216";"3";"2";"538";"540"
"8";"Barcelona";"1";"Barcelona";"13";"Barcelonès";"08101";"Hospitalet de Llobregat, l'";"6";"13";"U";"889";"322";"587";"703";"186";"1";"4";"698";"702"
"8";"Barcelona";"1";"Barcelona";"13";"Barcelonès";"08101";"Hospitalet de Llobregat, l'";"6";"14";"U";"719";"311";"473";"575";"144";"2";"1";"572";"573"
"8";"Barcelona";"1";"Barcelona";"13";"Barcelonès";"08101";"Hospitalet de Llobregat, l'";"6";"15";"U";"621";"229";"409";"479";"142";"2";"0";"477";"477"
"8";"Barcelona";"1";"Barcelona";"13";"Barcelonès";"08101";"Hospitalet de Llobregat, l'";"6";"16";"A";"773";"212";"404";"514";"259";"3";"0";"511";"511"
"8";"Barcelona";"1";"Barcelona";"13";"Barcelonès";"08101";"Hospitalet de Llobregat, l'";"6";"16";"B";"856";"215";"431";"548";"308";"4";"5";"539";"544"
"8";"Barcelona";"1";"Barcelona";"13";"Barcelonès";"08101";"Hospitalet de Llobregat, l'";"6";"17";"U";"733";"276";"428";"524";"209";"2";"4";"518";"522"
"8";"Barcelona";"1";"Barcelona";"13";"Barcelonès";"08101";"Hospitalet de Llobregat, l'";"6";"18";"U";"897";"298";"597";"746";"151";"1";"5";"740";"745"
"8";"Barcelona";"1";"Barcelona";"13";"Barcelonès";"08101";"Hospitalet de Llobregat, l'";"6";"19";"A";"451";"176";"267";"345";"106";"0";"6";"339";"345"
"8";"Barcelona";"1";"Barcelona";"13";"Barcelonès";"08101";"Hospitalet de Llobregat, l'";"6";"19";"B";"532";"230";"349";"424";"108";"0";"3";"421";"424"
"8";"Barcelona";"1";"Barcelona";"13";"Barcelonès";"08101";"Hospitalet de Llobregat, l'";"6";"2";"U";"865";"283";"525";"632";"233";"1";"0";"631";"631"
"8";"Barcelona";"1";"Barcelona";"13";"Barcelonès";"08101";"Hospitalet de Llobregat, l'";"6";"21";"A";"523";"196";"329";"416";"107";"3";"3";"410";"413"
"8";"Barcelona";"1";"Barcelona";"13";"Barcelonès";"08101";"Hospitalet de Llobregat, l'";"6";"21";"B";"572";"239";"387";"447";"125";"2";"2";"443";"445"
"8";"Barcelona";"1";"Barcelona";"13";"Barcelonès";"08101";"Hospitalet de Llobregat, l'";"6";"22";"U";"629";"240";"397";"483";"146";"1";"0";"482";"482"
"8";"Barcelona";"1";"Barcelona";"13";"Barcelonès";"08101";"Hospitalet de Llobregat, l'";"6";"23";"A";"497";"158";"349";"408";"89";"2";"1";"405";"406"
"8";"Barcelona";"1";"Barcelona";"13";"Barcelonès";"08101";"Hospitalet de Llobregat, l'";"6";"23";"B";"547";"230";"375";"457";"90";"1";"1";"455";"456"
"8";"Barcelona";"1";"Barcelona";"13";"Barcelonès";"08101";"Hospitalet de Llobregat, l'";"6";"24";"U";"791";"285";"473";"588";"203";"1";"5";"582";"587"
"8";"Barcelona";"1";"Barcelona";"13";"Barcelonès";"08101";"Hospitalet de Llobregat, l'";"6";"25";"A";"477";"190";"323";"402";"75";"5";"0";"397";"397"
"8";"Barcelona";"1";"Barcelona";"13";"Barcelonès";"08101";"Hospitalet de Llobregat, l'";"6";"25";"B";"485";"208";"321";"398";"87";"3";"1";"394";"395"
"8";"Barcelona";"1";"Barcelona";"13";"Barcelonès";"08101";"Hospitalet de Llobregat, l'";"6";"26";"U";"704";"248";"413";"527";"177";"4";"3";"520";"523"
"8";"Barcelona";"1";"Barcelona";"13";"Barcelonès";"08101";"Hospitalet de Llobregat, l'";"6";"27";"U";"754";"289";"492";"612";"142";"1";"4";"607";"611"
"8";"Barcelona";"1";"Barcelona";"13";"Barcelonès";"08101";"Hospitalet de Llobregat, l'";"6";"30";"U";"606";"232";"371";"468";"138";"7";"5";"456";"461"
"8";"Barcelona";"1";"Barcelona";"13";"Barcelonès";"08101";"Hospitalet de Llobregat, l'";"6";"31";"U";"796";"308";"500";"628";"168";"6";"0";"622";"622"
"8";"Barcelona";"1";"Barcelona";"13";"Barcelonès";"08101";"Hospitalet de Llobregat, l'";"6";"32";"U";"703";"231";"396";"466";"237";"3";"1";"462";"463"
"8";"Barcelona";"1";"Barcelona";"13";"Barcelonès";"08101";"Hospitalet de Llobregat, l'";"6";"5";"A";"560";"222";"365";"449";"111";"4";"1";"444";"445"
"8";"Barcelona";"1";"Barcelona";"13";"Barcelonès";"08101";"Hospitalet de Llobregat, l'";"6";"5";"B";"646";"194";"377";"484";"162";"0";"4";"480";"484"
"8";"Barcelona";"1";"Barcelona";"13";"Barcelonès";"08101";"Hospitalet de Llobregat, l'";"6";"6";"U";"707";"266";"415";"473";"234";"4";"1";"468";"469"
"8";"Barcelona";"1";"Barcelona";"13";"Barcelonès";"08101";"Hospitalet de Llobregat, l'";"6";"7";"U";"731";"241";"442";"524";"207";"2";"5";"517";"522"
"8";"Barcelona";"1";"Barcelona";"13";"Barcelonès";"08101";"Hospitalet de Llobregat, l'";"6";"8";"A";"495";"158";"281";"351";"144";"0";"3";"348";"351"
"8";"Barcelona";"1";"Barcelona";"13";"Barcelonès";"08101";"Hospitalet de Llobregat, l'";"6";"8";"B";"547";"192";"315";"397";"150";"6";"4";"387";"391"
"8";"Barcelona";"1";"Barcelona";"13";"Barcelonès";"08101";"Hospitalet de Llobregat, l'";"6";"9";"U";"602";"139";"385";"471";"131";"1";"1";"469";"470"
"8";"Barcelona";"1";"Barcelona";"41";"Vallès Oriental";"08105";"Llagosta, la";"1";"1";"A";"474";"151";"275";"340";"134";"1";"2";"337";"339"
"8";"Barcelona";"1";"Barcelona";"41";"Vallès Oriental";"08105";"Llagosta, la";"1";"1";"B";"667";"200";"387";"492";"175";"1";"0";"491";"491"
"8";"Barcelona";"1";"Barcelona";"41";"Vallès Oriental";"08105";"Llagosta, la";"1";"2";"A";"581";"190";"335";"424";"157";"3";"2";"419";"421"
"8";"Barcelona";"1";"Barcelona";"41";"Vallès Oriental";"08105";"Llagosta, la";"1";"2";"B";"685";"210";"390";"497";"188";"4";"2";"491";"493"
"8";"Barcelona";"1";"Barcelona";"41";"Vallès Oriental";"08105";"Llagosta, la";"1";"3";"A";"443";"168";"278";"349";"94";"2";"3";"344";"347"
"8";"Barcelona";"1";"Barcelona";"41";"Vallès Oriental";"08105";"Llagosta, la";"1";"3";"B";"596";"221";"362";"462";"134";"3";"2";"457";"459"
"8";"Barcelona";"1";"Barcelona";"41";"Vallès Oriental";"08105";"Llagosta, la";"1";"4";"A";"486";"184";"297";"370";"116";"1";"2";"367";"369"
"8";"Barcelona";"1";"Barcelona";"41";"Vallès Oriental";"08105";"Llagosta, la";"1";"4";"B";"563";"221";"347";"422";"141";"2";"2";"418";"420"
"8";"Barcelona";"1";"Barcelona";"41";"Vallès Oriental";"08105";"Llagosta, la";"1";"5";"A";"543";"184";"306";"377";"166";"2";"2";"373";"375"
"8";"Barcelona";"1";"Barcelona";"41";"Vallès Oriental";"08105";"Llagosta, la";"1";"5";"B";"566";"216";"351";"418";"148";"4";"4";"410";"414"
"8";"Barcelona";"1";"Barcelona";"41";"Vallès Oriental";"08105";"Llagosta, la";"1";"6";"A";"436";"171";"273";"335";"101";"2";"1";"332";"333"
"8";"Barcelona";"1";"Barcelona";"41";"Vallès Oriental";"08105";"Llagosta, la";"1";"6";"B";"492";"208";"336";"387";"105";"2";"2";"383";"385"
"8";"Barcelona";"1";"Barcelona";"41";"Vallès Oriental";"08105";"Llagosta, la";"1";"7";"A";"479";"209";"302";"355";"124";"3";"1";"351";"352"
"8";"Barcelona";"1";"Barcelona";"41";"Vallès Oriental";"08105";"Llagosta, la";"1";"7";"B";"525";"201";"313";"377";"148";"2";"1";"374";"375"
"8";"Barcelona";"1";"Barcelona";"41";"Vallès Oriental";"08105";"Llagosta, la";"1";"8";"A";"375";"116";"225";"307";"68";"0";"2";"305";"307"
"8";"Barcelona";"1";"Barcelona";"41";"Vallès Oriental";"08105";"Llagosta, la";"1";"8";"B";"532";"179";"326";"441";"91";"2";"1";"438";"439"
"8";"Barcelona";"1";"Barcelona";"41";"Vallès Oriental";"08105";"Llagosta, la";"1";"9";"A";"539";"197";"352";"442";"97";"1";"1";"440";"441"
"8";"Barcelona";"1";"Barcelona";"41";"Vallès Oriental";"08105";"Llagosta, la";"1";"9";"B";"616";"212";"405";"509";"107";"5";"3";"501";"504"
"8";"Barcelona";"1";"Barcelona";"41";"Vallès Oriental";"08106";"Llinars del Vallès";"1";"1";"A";"522";"192";"330";"399";"123";"1";"3";"395";"398"
"8";"Barcelona";"1";"Barcelona";"41";"Vallès Oriental";"08106";"Llinars del Vallès";"1";"1";"B";"542";"205";"321";"391";"151";"2";"1";"388";"389"
"8";"Barcelona";"1";"Barcelona";"41";"Vallès Oriental";"08106";"Llinars del Vallès";"1";"2";"A";"661";"249";"431";"526";"135";"2";"5";"519";"524"
"8";"Barcelona";"1";"Barcelona";"41";"Vallès Oriental";"08106";"Llinars del Vallès";"1";"2";"B";"785";"299";"489";"601";"184";"4";"4";"593";"597"
"8";"Barcelona";"1";"Barcelona";"41";"Vallès Oriental";"08106";"Llinars del Vallès";"2";"1";"A";"708";"259";"466";"570";"138";"1";"6";"563";"569"
"8";"Barcelona";"1";"Barcelona";"41";"Vallès Oriental";"08106";"Llinars del Vallès";"2";"1";"B";"809";"263";"516";"648";"161";"1";"1";"646";"647"
"8";"Barcelona";"1";"Barcelona";"41";"Vallès Oriental";"08106";"Llinars del Vallès";"2";"2";"A";"507";"230";"370";"431";"76";"1";"1";"429";"430"
"8";"Barcelona";"1";"Barcelona";"41";"Vallès Oriental";"08106";"Llinars del Vallès";"2";"2";"B";"545";"263";"402";"454";"91";"0";"3";"451";"454"
"8";"Barcelona";"1";"Barcelona";"41";"Vallès Oriental";"08106";"Llinars del Vallès";"2";"3";"A";"529";"170";"321";"394";"135";"0";"2";"392";"394"
"8";"Barcelona";"1";"Barcelona";"41";"Vallès Oriental";"08106";"Llinars del Vallès";"2";"3";"B";"624";"223";"405";"492";"132";"0";"2";"490";"492"
"8";"Barcelona";"1";"Barcelona";"41";"Vallès Oriental";"08106";"Llinars del Vallès";"2";"4";"A";"453";"194";"300";"361";"92";"3";"2";"356";"358"
"8";"Barcelona";"1";"Barcelona";"41";"Vallès Oriental";"08106";"Llinars del Vallès";"2";"4";"B";"515";"205";"337";"412";"103";"0";"3";"409";"412"
"8";"Barcelona";"1";"Barcelona";"41";"Vallès Oriental";"08107";"Lliçà d'Amunt";"1";"1";"A";"640";"227";"394";"515";"125";"5";"2";"508";"510"
"8";"Barcelona";"1";"Barcelona";"41";"Vallès Oriental";"08107";"Lliçà d'Amunt";"1";"1";"B";"894";"325";"578";"717";"177";"3";"8";"706";"714"
"8";"Barcelona";"1";"Barcelona";"41";"Vallès Oriental";"08107";"Lliçà d'Amunt";"1";"10";"A";"492";"181";"312";"374";"118";"0";"2";"372";"374"
"8";"Barcelona";"1";"Barcelona";"41";"Vallès Oriental";"08107";"Lliçà d'Amunt";"1";"10";"B";"549";"198";"342";"419";"130";"3";"2";"414";"416"
"8";"Barcelona";"1";"Barcelona";"41";"Vallès Oriental";"08107";"Lliçà d'Amunt";"1";"2";"A";"469";"151";"281";"362";"107";"1";"1";"360";"361"
"8";"Barcelona";"1";"Barcelona";"41";"Vallès Oriental";"08107";"Lliçà d'Amunt";"1";"2";"B";"646";"239";"397";"505";"141";"1";"2";"502";"504"
"8";"Barcelona";"1";"Barcelona";"41";"Vallès Oriental";"08107";"Lliçà d'Amunt";"1";"3";"A";"429";"156";"266";"345";"84";"2";"1";"342";"343"
"8";"Barcelona";"1";"Barcelona";"41";"Vallès Oriental";"08107";"Lliçà d'Amunt";"1";"3";"B";"529";"181";"332";"417";"112";"3";"1";"413";"414"
"8";"Barcelona";"1";"Barcelona";"41";"Vallès Oriental";"08107";"Lliçà d'Amunt";"1";"4";"A";"623";"227";"373";"453";"170";"1";"3";"449";"452"
"8";"Barcelona";"1";"Barcelona";"41";"Vallès Oriental";"08107";"Lliçà d'Amunt";"1";"4";"B";"787";"266";"516";"599";"188";"1";"2";"596";"598"
"8";"Barcelona";"1";"Barcelona";"41";"Vallès Oriental";"08107";"Lliçà d'Amunt";"1";"5";"A";"573";"213";"368";"445";"128";"2";"7";"436";"443"
"8";"Barcelona";"1";"Barcelona";"41";"Vallès Oriental";"08107";"Lliçà d'Amunt";"1";"5";"B";"671";"242";"411";"510";"161";"1";"0";"509";"509"
"8";"Barcelona";"1";"Barcelona";"41";"Vallès Oriental";"08107";"Lliçà d'Amunt";"1";"6";"A";"412";"154";"248";"308";"104";"0";"4";"304";"308"
"8";"Barcelona";"1";"Barcelona";"41";"Vallès Oriental";"08107";"Lliçà d'Amunt";"1";"6";"B";"416";"169";"264";"319";"97";"1";"1";"317";"318"
"8";"Barcelona";"1";"Barcelona";"41";"Vallès Oriental";"08107";"Lliçà d'Amunt";"1";"7";"A";"562";"221";"377";"455";"107";"0";"7";"448";"455"
"8";"Barcelona";"1";"Barcelona";"41";"Vallès Oriental";"08107";"Lliçà d'Amunt";"1";"7";"B";"666";"256";"439";"523";"143";"2";"4";"517";"521"
"8";"Barcelona";"1";"Barcelona";"41";"Vallès Oriental";"08107";"Lliçà d'Amunt";"1";"8";"A";"541";"200";"323";"418";"123";"1";"9";"408";"417"
"8";"Barcelona";"1";"Barcelona";"41";"Vallès Oriental";"08107";"Lliçà d'Amunt";"1";"8";"B";"571";"203";"335";"446";"125";"1";"2";"443";"445"
"8";"Barcelona";"1";"Barcelona";"41";"Vallès Oriental";"08107";"Lliçà d'Amunt";"1";"9";"A";"440";"164";"278";"351";"89";"1";"6";"344";"350"
"8";"Barcelona";"1";"Barcelona";"41";"Vallès Oriental";"08107";"Lliçà d'Amunt";"1";"9";"B";"535";"204";"320";"417";"118";"2";"6";"409";"415"
"8";"Barcelona";"1";"Barcelona";"41";"Vallès Oriental";"08108";"Lliçà de Vall";"1";"1";"A";"682";"271";"458";"551";"131";"1";"3";"547";"550"
"8";"Barcelona";"1";"Barcelona";"41";"Vallès Oriental";"08108";"Lliçà de Vall";"1";"1";"B";"778";"321";"524";"639";"139";"3";"4";"632";"636"
"8";"Barcelona";"1";"Barcelona";"41";"Vallès Oriental";"08108";"Lliçà de Vall";"1";"2";"A";"657";"259";"450";"544";"113";"1";"3";"540";"543"
"8";"Barcelona";"1";"Barcelona";"41";"Vallès Oriental";"08108";"Lliçà de Vall";"1";"2";"B";"739";"262";"493";"601";"138";"2";"3";"596";"599"
"8";"Barcelona";"1";"Barcelona";"41";"Vallès Oriental";"08108";"Lliçà de Vall";"1";"3";"A";"608";"261";"405";"497";"111";"5";"1";"491";"492"
"8";"Barcelona";"1";"Barcelona";"41";"Vallès Oriental";"08108";"Lliçà de Vall";"1";"3";"B";"679";"292";"460";"554";"125";"1";"4";"549";"553"
"8";"Barcelona";"1";"Barcelona";"41";"Vallès Oriental";"08108";"Lliçà de Vall";"1";"4";"U";"847";"318";"546";"663";"184";"4";"6";"653";"659"
"8";"Barcelona";"1";"Barcelona";"21";"Maresme";"08110";"Malgrat de Mar";"1";"1";"A";"371";"145";"233";"284";"87";"1";"0";"283";"283"
"8";"Barcelona";"1";"Barcelona";"21";"Maresme";"08110";"Malgrat de Mar";"1";"1";"B";"432";"171";"268";"341";"91";"2";"0";"339";"339"
"8";"Barcelona";"1";"Barcelona";"21";"Maresme";"08110";"Malgrat de Mar";"1";"1";"C";"404";"159";"247";"314";"90";"1";"1";"312";"313"
"8";"Barcelona";"1";"Barcelona";"21";"Maresme";"08110";"Malgrat de Mar";"1";"2";"A";"428";"180";"284";"334";"94";"4";"2";"328";"330"
"8";"Barcelona";"1";"Barcelona";"21";"Maresme";"08110";"Malgrat de Mar";"1";"2";"B";"392";"154";"252";"298";"94";"1";"1";"296";"297"
"8";"Barcelona";"1";"Barcelona";"21";"Maresme";"08110";"Malgrat de Mar";"1";"2";"C";"601";"260";"408";"477";"124";"1";"1";"475";"476"
"8";"Barcelona";"1";"Barcelona";"21";"Maresme";"08110";"Malgrat de Mar";"1";"2";"D";"440";"180";"275";"337";"103";"1";"3";"333";"336"
"8";"Barcelona";"1";"Barcelona";"21";"Maresme";"08110";"Malgrat de Mar";"1";"3";"A";"496";"194";"293";"364";"132";"1";"4";"359";"363"
"8";"Barcelona";"1";"Barcelona";"21";"Maresme";"08110";"Malgrat de Mar";"1";"3";"B";"630";"223";"378";"466";"164";"5";"5";"456";"461"
"8";"Barcelona";"1";"Barcelona";"21";"Maresme";"08110";"Malgrat de Mar";"1";"3";"C";"476";"178";"291";"360";"116";"2";"2";"356";"358"
"8";"Barcelona";"1";"Barcelona";"21";"Maresme";"08110";"Malgrat de Mar";"1";"4";"A";"403";"140";"236";"295";"108";"0";"2";"293";"295"
"8";"Barcelona";"1";"Barcelona";"21";"Maresme";"08110";"Malgrat de Mar";"1";"4";"B";"516";"174";"290";"344";"172";"3";"3";"338";"341"
"8";"Barcelona";"1";"Barcelona";"21";"Maresme";"08110";"Malgrat de Mar";"1";"4";"C";"433";"150";"260";"331";"102";"1";"1";"329";"330"
"8";"Barcelona";"1";"Barcelona";"21";"Maresme";"08110";"Malgrat de Mar";"1";"5";"A";"373";"123";"221";"272";"101";"2";"1";"269";"270"
"8";"Barcelona";"1";"Barcelona";"21";"Maresme";"08110";"Malgrat de Mar";"1";"5";"B";"525";"157";"310";"385";"140";"0";"3";"382";"385"
"8";"Barcelona";"1";"Barcelona";"21";"Maresme";"08110";"Malgrat de Mar";"1";"5";"C";"402";"141";"242";"296";"106";"2";"2";"292";"294"
"8";"Barcelona";"1";"Barcelona";"21";"Maresme";"08110";"Malgrat de Mar";"1";"6";"A";"530";"188";"336";"400";"130";"4";"2";"394";"396"
"8";"Barcelona";"1";"Barcelona";"21";"Maresme";"08110";"Malgrat de Mar";"1";"6";"B";"707";"247";"418";"533";"174";"4";"5";"524";"529"
"8";"Barcelona";"1";"Barcelona";"21";"Maresme";"08110";"Malgrat de Mar";"1";"6";"C";"560";"197";"309";"396";"164";"2";"3";"391";"394"
"8";"Barcelona";"1";"Barcelona";"21";"Maresme";"08110";"Malgrat de Mar";"2";"1";"A";"401";"155";"270";"311";"90";"0";"3";"308";"311"
"8";"Barcelona";"1";"Barcelona";"21";"Maresme";"08110";"Malgrat de Mar";"2";"1";"B";"418";"191";"282";"324";"94";"2";"2";"320";"322"
"8";"Barcelona";"1";"Barcelona";"21";"Maresme";"08110";"Malgrat de Mar";"2";"1";"C";"462";"203";"326";"373";"89";"3";"3";"367";"370"
"8";"Barcelona";"1";"Barcelona";"21";"Maresme";"08110";"Malgrat de Mar";"2";"2";"A";"521";"198";"341";"421";"100";"2";"4";"415";"419"
"8";"Barcelona";"1";"Barcelona";"21";"Maresme";"08110";"Malgrat de Mar";"2";"2";"B";"574";"212";"363";"441";"133";"0";"2";"439";"441"
"8";"Barcelona";"1";"Barcelona";"21";"Maresme";"08110";"Malgrat de Mar";"2";"2";"C";"538";"215";"345";"406";"132";"0";"1";"405";"406"
"8";"Barcelona";"1";"Barcelona";"21";"Maresme";"08110";"Malgrat de Mar";"2";"3";"A";"400";"150";"232";"274";"126";"0";"0";"274";"274"
"8";"Barcelona";"1";"Barcelona";"21";"Maresme";"08110";"Malgrat de Mar";"2";"3";"B";"517";"196";"302";"358";"159";"4";"2";"352";"354"
"8";"Barcelona";"1";"Barcelona";"21";"Maresme";"08110";"Malgrat de Mar";"2";"3";"C";"428";"164";"237";"298";"130";"2";"2";"294";"296"
"8";"Barcelona";"1";"Barcelona";"11";"Baix Llobregat";"08114";"Martorell";"1";"1";"A";"530";"152";"324";"382";"148";"1";"2";"379";"381"
"8";"Barcelona";"1";"Barcelona";"11";"Baix Llobregat";"08114";"Martorell";"1";"1";"B";"552";"167";"337";"402";"150";"1";"3";"398";"401"
"8";"Barcelona";"1";"Barcelona";"11";"Baix Llobregat";"08114";"Martorell";"1";"2";"U";"592";"185";"319";"387";"205";"5";"1";"381";"382"
"8";"Barcelona";"1";"Barcelona";"11";"Baix Llobregat";"08114";"Martorell";"1";"3";"A";"451";"150";"271";"324";"127";"2";"2";"320";"322"
"8";"Barcelona";"1";"Barcelona";"11";"Baix Llobregat";"08114";"Martorell";"1";"3";"B";"440";"144";"256";"312";"128";"3";"1";"308";"309"
"8";"Barcelona";"1";"Barcelona";"11";"Baix Llobregat";"08114";"Martorell";"2";"3";"A";"598";"195";"341";"413";"185";"1";"1";"411";"412"
"8";"Barcelona";"1";"Barcelona";"11";"Baix Llobregat";"08114";"Martorell";"2";"3";"B";"597";"180";"340";"405";"192";"2";"2";"401";"403"
"8";"Barcelona";"1";"Barcelona";"11";"Baix Llobregat";"08114";"Martorell";"2";"3";"C";"564";"159";"307";"384";"180";"3";"1";"380";"381"
"8";"Barcelona";"1";"Barcelona";"11";"Baix Llobregat";"08114";"Martorell";"3";"10";"U";"539";"247";"394";"465";"74";"1";"6";"458";"464"
"8";"Barcelona";"1";"Barcelona";"11";"Baix Llobregat";"08114";"Martorell";"3";"2";"A";"552";"192";"307";"367";"185";"1";"4";"362";"366"
"8";"Barcelona";"1";"Barcelona";"11";"Baix Llobregat";"08114";"Martorell";"3";"2";"B";"566";"215";"311";"371";"195";"0";"3";"368";"371"
"8";"Barcelona";"1";"Barcelona";"11";"Baix Llobregat";"08114";"Martorell";"3";"4";"A";"376";"128";"207";"252";"124";"1";"0";"251";"251"
"8";"Barcelona";"1";"Barcelona";"11";"Baix Llobregat";"08114";"Martorell";"3";"4";"B";"406";"146";"240";"285";"121";"3";"3";"279";"282"
"8";"Barcelona";"1";"Barcelona";"11";"Baix Llobregat";"08114";"Martorell";"3";"4";"C";"441";"147";"256";"311";"130";"2";"0";"309";"309"
"8";"Barcelona";"1";"Barcelona";"11";"Baix Llobregat";"08114";"Martorell";"3";"5";"A";"542";"185";"320";"368";"174";"3";"1";"364";"365"
"8";"Barcelona";"1";"Barcelona";"11";"Baix Llobregat";"08114";"Martorell";"3";"5";"B";"523";"181";"312";"369";"154";"2";"0";"367";"367"
"8";"Barcelona";"1";"Barcelona";"11";"Baix Llobregat";"08114";"Martorell";"3";"6";"A";"456";"174";"286";"346";"110";"4";"3";"339";"342"
"8";"Barcelona";"1";"Barcelona";"11";"Baix Llobregat";"08114";"Martorell";"3";"6";"B";"416";"182";"264";"314";"102";"1";"1";"312";"313"
"8";"Barcelona";"1";"Barcelona";"11";"Baix Llobregat";"08114";"Martorell";"3";"6";"C";"450";"181";"275";"334";"116";"1";"1";"332";"333"
"8";"Barcelona";"1";"Barcelona";"11";"Baix Llobregat";"08114";"Martorell";"3";"7";"A";"543";"245";"395";"464";"79";"2";"4";"458";"462"
"8";"Barcelona";"1";"Barcelona";"11";"Baix Llobregat";"08114";"Martorell";"3";"7";"B";"567";"213";"369";"447";"120";"1";"1";"445";"446"
"8";"Barcelona";"1";"Barcelona";"11";"Baix Llobregat";"08114";"Martorell";"3";"8";"A";"493";"181";"307";"393";"100";"1";"2";"390";"392"
"8";"Barcelona";"1";"Barcelona";"11";"Baix Llobregat";"08114";"Martorell";"3";"8";"B";"670";"230";"430";"556";"114";"0";"4";"552";"556"
"8";"Barcelona";"1";"Barcelona";"11";"Baix Llobregat";"08114";"Martorell";"3";"8";"C";"494";"178";"318";"400";"94";"5";"1";"394";"395"
"8";"Barcelona";"1";"Barcelona";"11";"Baix Llobregat";"08114";"Martorell";"4";"1";"A";"558";"180";"329";"428";"130";"0";"3";"425";"428"
"8";"Barcelona";"1";"Barcelona";"11";"Baix Llobregat";"08114";"Martorell";"4";"1";"B";"647";"218";"385";"507";"140";"0";"4";"503";"507"
"8";"Barcelona";"1";"Barcelona";"11";"Baix Llobregat";"08114";"Martorell";"4";"1";"C";"547";"187";"336";"417";"130";"2";"1";"414";"415"
"8";"Barcelona";"1";"Barcelona";"11";"Baix Llobregat";"08114";"Martorell";"4";"2";"A";"453";"176";"317";"383";"70";"0";"1";"382";"383"
"8";"Barcelona";"1";"Barcelona";"11";"Baix Llobregat";"08114";"Martorell";"4";"2";"B";"606";"192";"395";"511";"95";"3";"3";"505";"508"
"8";"Barcelona";"1";"Barcelona";"11";"Baix Llobregat";"08114";"Martorell";"4";"2";"C";"510";"199";"349";"436";"74";"0";"3";"433";"436"
"8";"Barcelona";"1";"Barcelona";"11";"Baix Llobregat";"08114";"Martorell";"4";"3";"A";"538";"168";"317";"411";"127";"2";"2";"407";"409"
"8";"Barcelona";"1";"Barcelona";"11";"Baix Llobregat";"08114";"Martorell";"4";"3";"B";"635";"199";"394";"492";"143";"5";"1";"486";"487"
"8";"Barcelona";"1";"Barcelona";"11";"Baix Llobregat";"08114";"Martorell";"4";"4";"A";"458";"165";"308";"391";"67";"0";"0";"391";"391"
"8";"Barcelona";"1";"Barcelona";"11";"Baix Llobregat";"08114";"Martorell";"4";"4";"B";"564";"210";"395";"467";"97";"1";"1";"465";"466"
"8";"Barcelona";"1";"Barcelona";"11";"Baix Llobregat";"08114";"Martorell";"4";"4";"C";"449";"169";"315";"381";"68";"1";"2";"378";"380"
"8";"Barcelona";"1";"Barcelona";"41";"Vallès Oriental";"08115";"Martorelles";"1";"1";"A";"408";"168";"253";"304";"104";"0";"0";"304";"304"
"8";"Barcelona";"1";"Barcelona";"41";"Vallès Oriental";"08115";"Martorelles";"1";"1";"B";"460";"179";"294";"358";"102";"2";"3";"353";"356"
"8";"Barcelona";"1";"Barcelona";"41";"Vallès Oriental";"08115";"Martorelles";"1";"1";"C";"534";"191";"326";"407";"127";"5";"0";"402";"402"
"8";"Barcelona";"1";"Barcelona";"41";"Vallès Oriental";"08115";"Martorelles";"1";"2";"A";"498";"180";"323";"407";"91";"5";"3";"399";"402"
"8";"Barcelona";"1";"Barcelona";"41";"Vallès Oriental";"08115";"Martorelles";"1";"2";"B";"764";"279";"524";"656";"108";"2";"4";"650";"654"
"8";"Barcelona";"1";"Barcelona";"41";"Vallès Oriental";"08115";"Martorelles";"1";"3";"A";"538";"209";"335";"415";"123";"0";"2";"413";"415"
"8";"Barcelona";"1";"Barcelona";"41";"Vallès Oriental";"08115";"Martorelles";"1";"3";"B";"604";"234";"379";"470";"134";"0";"1";"469";"470"
"8";"Barcelona";"1";"Barcelona";"21";"Maresme";"08118";"Masnou, el";"1";"1";"A";"744";"261";"496";"612";"132";"2";"2";"608";"610"
"8";"Barcelona";"1";"Barcelona";"21";"Maresme";"08118";"Masnou, el";"1";"1";"B";"701";"248";"466";"561";"140";"1";"4";"556";"560"
"8";"Barcelona";"1";"Barcelona";"21";"Maresme";"08118";"Masnou, el";"1";"10";"A";"643";"234";"431";"528";"115";"0";"4";"524";"528"
"8";"Barcelona";"1";"Barcelona";"21";"Maresme";"08118";"Masnou, el";"1";"10";"B";"696";"261";"472";"555";"141";"2";"3";"550";"553"
"8";"Barcelona";"1";"Barcelona";"21";"Maresme";"08118";"Masnou, el";"1";"2";"A";"734";"267";"488";"581";"153";"0";"3";"578";"581"
"8";"Barcelona";"1";"Barcelona";"21";"Maresme";"08118";"Masnou, el";"1";"2";"B";"827";"314";"654";"654";"173";"1";"5";"648";"653"
"8";"Barcelona";"1";"Barcelona";"21";"Maresme";"08118";"Masnou, el";"1";"3";"A";"458";"205";"320";"382";"76";"4";"0";"378";"378"
"8";"Barcelona";"1";"Barcelona";"21";"Maresme";"08118";"Masnou, el";"1";"3";"B";"472";"190";"328";"395";"77";"1";"1";"393";"394"
"8";"Barcelona";"1";"Barcelona";"21";"Maresme";"08118";"Masnou, el";"1";"4";"A";"640";"282";"458";"559";"81";"1";"3";"555";"558"
"8";"Barcelona";"1";"Barcelona";"21";"Maresme";"08118";"Masnou, el";"1";"4";"B";"764";"298";"539";"646";"118";"3";"6";"637";"643"
"8";"Barcelona";"1";"Barcelona";"21";"Maresme";"08118";"Masnou, el";"1";"5";"A";"690";"276";"459";"530";"160";"2";"9";"519";"528"
"8";"Barcelona";"1";"Barcelona";"21";"Maresme";"08118";"Masnou, el";"1";"5";"B";"741";"291";"505";"595";"146";"3";"2";"590";"592"
"8";"Barcelona";"1";"Barcelona";"21";"Maresme";"08118";"Masnou, el";"1";"6";"A";"614";"247";"402";"482";"132";"2";"2";"478";"480"
"8";"Barcelona";"1";"Barcelona";"21";"Maresme";"08118";"Masnou, el";"1";"6";"B";"764";"283";"517";"608";"156";"8";"8";"592";"600"
"8";"Barcelona";"1";"Barcelona";"21";"Maresme";"08118";"Masnou, el";"1";"7";"A";"573";"271";"409";"479";"94";"1";"4";"474";"478"
"8";"Barcelona";"1";"Barcelona";"21";"Maresme";"08118";"Masnou, el";"1";"7";"B";"651";"268";"431";"533";"118";"4";"3";"526";"529"
"8";"Barcelona";"1";"Barcelona";"21";"Maresme";"08118";"Masnou, el";"1";"8";"A";"476";"196";"303";"377";"99";"2";"2";"373";"375"
"8";"Barcelona";"1";"Barcelona";"21";"Maresme";"08118";"Masnou, el";"1";"8";"B";"606";"260";"405";"491";"115";"0";"3";"488";"491"
"8";"Barcelona";"1";"Barcelona";"21";"Maresme";"08118";"Masnou, el";"1";"9";"U";"647";"255";"424";"533";"114";"2";"0";"531";"531"
"8";"Barcelona";"1";"Barcelona";"21";"Maresme";"08118";"Masnou, el";"2";"1";"A";"667";"272";"482";"560";"107";"3";"2";"555";"557"
"8";"Barcelona";"1";"Barcelona";"21";"Maresme";"08118";"Masnou, el";"2";"1";"B";"705";"297";"515";"584";"121";"2";"0";"582";"582"
"8";"Barcelona";"1";"Barcelona";"21";"Maresme";"08118";"Masnou, el";"2";"2";"U";"952";"289";"656";"803";"149";"1";"4";"798";"802"
"8";"Barcelona";"1";"Barcelona";"21";"Maresme";"08118";"Masnou, el";"2";"3";"A";"567";"238";"378";"455";"112";"2";"0";"453";"453"
"8";"Barcelona";"1";"Barcelona";"21";"Maresme";"08118";"Masnou, el";"2";"3";"B";"558";"246";"384";"448";"110";"0";"0";"448";"448"
"8";"Barcelona";"1";"Barcelona";"21";"Maresme";"08118";"Masnou, el";"2";"4";"A";"753";"306";"500";"605";"148";"0";"4";"601";"605"
"8";"Barcelona";"1";"Barcelona";"21";"Maresme";"08118";"Masnou, el";"2";"4";"B";"853";"345";"573";"704";"149";"0";"1";"703";"704"
"8";"Barcelona";"1";"Barcelona";"40";"Vallès Occidental";"08120";"Matadepera";"1";"1";"A";"885";"248";"627";"780";"105";"3";"7";"770";"777"
"8";"Barcelona";"1";"Barcelona";"40";"Vallès Occidental";"08120";"Matadepera";"1";"1";"B";"919";"301";"650";"792";"127";"1";"5";"786";"791"
"8";"Barcelona";"1";"Barcelona";"40";"Vallès Occidental";"08120";"Matadepera";"1";"2";"A";"892";"356";"704";"766";"126";"1";"4";"761";"765"
"8";"Barcelona";"1";"Barcelona";"40";"Vallès Occidental";"08120";"Matadepera";"1";"2";"B";"931";"287";"650";"807";"124";"0";"8";"799";"807"
"8";"Barcelona";"1";"Barcelona";"40";"Vallès Occidental";"08120";"Matadepera";"1";"3";"A";"807";"257";"569";"710";"97";"1";"3";"706";"709"
"8";"Barcelona";"1";"Barcelona";"40";"Vallès Occidental";"08120";"Matadepera";"1";"3";"B";"979";"320";"691";"856";"123";"2";"1";"853";"854"
"8";"Barcelona";"1";"Barcelona";"40";"Vallès Occidental";"08120";"Matadepera";"1";"4";"A";"647";"239";"471";"576";"71";"2";"2";"572";"574"
"8";"Barcelona";"1";"Barcelona";"40";"Vallès Occidental";"08120";"Matadepera";"1";"4";"B";"719";"267";"513";"608";"111";"1";"1";"606";"607"
"8";"Barcelona";"1";"Barcelona";"21";"Maresme";"08121";"Mataró";"1";"1";"A";"591";"267";"425";"485";"106";"1";"3";"481";"484"
"8";"Barcelona";"1";"Barcelona";"21";"Maresme";"08121";"Mataró";"1";"1";"B";"636";"294";"460";"530";"106";"3";"1";"526";"527"
"8";"Barcelona";"1";"Barcelona";"21";"Maresme";"08121";"Mataró";"1";"2";"A";"586";"267";"415";"476";"110";"0";"3";"473";"476"
"8";"Barcelona";"1";"Barcelona";"21";"Maresme";"08121";"Mataró";"1";"2";"B";"642";"283";"411";"525";"117";"0";"3";"522";"525"
"8";"Barcelona";"1";"Barcelona";"21";"Maresme";"08121";"Mataró";"1";"3";"U";"1059";"423";"773";"886";"173";"3";"4";"879";"883"
"8";"Barcelona";"1";"Barcelona";"21";"Maresme";"08121";"Mataró";"1";"4";"A";"507";"217";"369";"425";"82";"1";"3";"421";"424"
"8";"Barcelona";"1";"Barcelona";"21";"Maresme";"08121";"Mataró";"1";"4";"B";"550";"254";"409";"474";"76";"0";"2";"472";"474"
"8";"Barcelona";"1";"Barcelona";"21";"Maresme";"08121";"Mataró";"1";"5";"A";"604";"271";"444";"515";"89";"1";"1";"513";"514"
"8";"Barcelona";"1";"Barcelona";"21";"Maresme";"08121";"Mataró";"1";"5";"B";"632";"305";"479";"530";"102";"2";"5";"523";"528"
"8";"Barcelona";"1";"Barcelona";"21";"Maresme";"08121";"Mataró";"1";"6";"A";"602";"283";"442";"518";"84";"2";"4";"512";"516"
"8";"Barcelona";"1";"Barcelona";"21";"Maresme";"08121";"Mataró";"1";"6";"B";"648";"310";"483";"554";"94";"0";"3";"551";"554"
"8";"Barcelona";"1";"Barcelona";"21";"Maresme";"08121";"Mataró";"1";"7";"A";"641";"265";"451";"537";"104";"1";"3";"533";"536"
"8";"Barcelona";"1";"Barcelona";"21";"Maresme";"08121";"Mataró";"1";"7";"B";"733";"348";"554";"629";"104";"5";"2";"622";"624"
"8";"Barcelona";"1";"Barcelona";"21";"Maresme";"08121";"Mataró";"1";"9";"U";"1017";"364";"721";"851";"166";"1";"8";"842";"850"
"8";"Barcelona";"1";"Barcelona";"21";"Maresme";"08121";"Mataró";"2";"1";"A";"785";"320";"566";"673";"112";"1";"7";"665";"672"
"8";"Barcelona";"1";"Barcelona";"21";"Maresme";"08121";"Mataró";"2";"1";"B";"916";"394";"667";"773";"143";"1";"4";"768";"772"
"8";"Barcelona";"1";"Barcelona";"21";"Maresme";"08121";"Mataró";"2";"10";"A";"531";"227";"357";"417";"114";"1";"2";"414";"416"
"8";"Barcelona";"1";"Barcelona";"21";"Maresme";"08121";"Mataró";"2";"10";"B";"562";"227";"379";"445";"117";"0";"2";"443";"445"
"8";"Barcelona";"1";"Barcelona";"21";"Maresme";"08121";"Mataró";"2";"11";"A";"598";"256";"446";"518";"80";"0";"1";"517";"518"
"8";"Barcelona";"1";"Barcelona";"21";"Maresme";"08121";"Mataró";"2";"11";"B";"599";"249";"402";"491";"108";"5";"4";"482";"486"
"8";"Barcelona";"1";"Barcelona";"21";"Maresme";"08121";"Mataró";"2";"12";"U";"972";"422";"673";"764";"208";"4";"4";"756";"760"
"8";"Barcelona";"1";"Barcelona";"21";"Maresme";"08121";"Mataró";"2";"2";"U";"785";"348";"577";"643";"142";"1";"1";"641";"642"
"8";"Barcelona";"1";"Barcelona";"21";"Maresme";"08121";"Mataró";"2";"3";"U";"856";"314";"554";"669";"187";"2";"2";"665";"667"
"8";"Barcelona";"1";"Barcelona";"21";"Maresme";"08121";"Mataró";"2";"4";"A";"728";"234";"384";"464";"264";"3";"1";"460";"461"
"8";"Barcelona";"1";"Barcelona";"21";"Maresme";"08121";"Mataró";"2";"4";"B";"743";"246";"403";"483";"260";"3";"3";"477";"480"
"8";"Barcelona";"1";"Barcelona";"21";"Maresme";"08121";"Mataró";"2";"5";"A";"705";"240";"444";"530";"175";"1";"2";"527";"529"
"8";"Barcelona";"1";"Barcelona";"21";"Maresme";"08121";"Mataró";"2";"5";"B";"809";"290";"547";"629";"180";"5";"5";"619";"624"
"8";"Barcelona";"1";"Barcelona";"21";"Maresme";"08121";"Mataró";"2";"7";"A";"548";"252";"375";"433";"115";"3";"7";"423";"430"
"8";"Barcelona";"1";"Barcelona";"21";"Maresme";"08121";"Mataró";"2";"7";"B";"669";"305";"483";"558";"111";"1";"1";"556";"557"
"8";"Barcelona";"1";"Barcelona";"21";"Maresme";"08121";"Mataró";"2";"8";"A";"556";"239";"375";"445";"111";"1";"1";"443";"444"
"8";"Barcelona";"1";"Barcelona";"21";"Maresme";"08121";"Mataró";"2";"8";"B";"595";"269";"426";"482";"113";"3";"4";"475";"479"
"8";"Barcelona";"1";"Barcelona";"21";"Maresme";"08121";"Mataró";"2";"9";"A";"521";"212";"371";"436";"85";"0";"1";"435";"436"
"8";"Barcelona";"1";"Barcelona";"21";"Maresme";"08121";"Mataró";"2";"9";"B";"648";"279";"466";"559";"89";"1";"2";"556";"558"
"8";"Barcelona";"1";"Barcelona";"21";"Maresme";"08121";"Mataró";"3";"1";"U";"897";"305";"574";"661";"236";"2";"6";"653";"659"
"8";"Barcelona";"1";"Barcelona";"21";"Maresme";"08121";"Mataró";"3";"10";"U";"558";"241";"415";"466";"92";"2";"1";"463";"464"
"8";"Barcelona";"1";"Barcelona";"21";"Maresme";"08121";"Mataró";"3";"11";"A";"543";"216";"361";"426";"117";"0";"1";"425";"426"
"8";"Barcelona";"1";"Barcelona";"21";"Maresme";"08121";"Mataró";"3";"11";"B";"654";"253";"437";"537";"117";"1";"2";"534";"536"
"8";"Barcelona";"1";"Barcelona";"21";"Maresme";"08121";"Mataró";"3";"12";"A";"562";"196";"358";"436";"126";"0";"2";"434";"436"
"8";"Barcelona";"1";"Barcelona";"21";"Maresme";"08121";"Mataró";"3";"12";"B";"694";"268";"467";"565";"129";"0";"1";"564";"565"
"8";"Barcelona";"1";"Barcelona";"21";"Maresme";"08121";"Mataró";"3";"13";"A";"652";"225";"432";"539";"113";"2";"4";"533";"537"
"8";"Barcelona";"1";"Barcelona";"21";"Maresme";"08121";"Mataró";"3";"13";"B";"793";"284";"530";"645";"148";"0";"0";"645";"645"
"8";"Barcelona";"1";"Barcelona";"21";"Maresme";"08121";"Mataró";"3";"13";"C";"680";"227";"421";"547";"133";"3";"3";"541";"544"
"8";"Barcelona";"1";"Barcelona";"21";"Maresme";"08121";"Mataró";"3";"14";"U";"953";"305";"645";"795";"158";"0";"6";"789";"795"
"8";"Barcelona";"1";"Barcelona";"21";"Maresme";"08121";"Mataró";"3";"2";"U";"812";"233";"449";"522";"290";"8";"6";"508";"514"
"8";"Barcelona";"1";"Barcelona";"21";"Maresme";"08121";"Mataró";"3";"3";"U";"883";"313";"538";"615";"268";"1";"2";"612";"614"
"8";"Barcelona";"1";"Barcelona";"21";"Maresme";"08121";"Mataró";"3";"4";"A";"549";"195";"296";"371";"178";"1";"1";"369";"370"
"8";"Barcelona";"1";"Barcelona";"21";"Maresme";"08121";"Mataró";"3";"4";"B";"637";"239";"384";"461";"176";"4";"0";"457";"457"
"8";"Barcelona";"1";"Barcelona";"21";"Maresme";"08121";"Mataró";"3";"5";"U";"982";"362";"564";"676";"306";"2";"4";"670";"674"
"8";"Barcelona";"1";"Barcelona";"21";"Maresme";"08121";"Mataró";"3";"6";"A";"545";"173";"324";"438";"107";"1";"4";"433";"437"
"8";"Barcelona";"1";"Barcelona";"21";"Maresme";"08121";"Mataró";"3";"6";"B";"638";"260";"426";"518";"120";"1";"1";"516";"517"
"8";"Barcelona";"1";"Barcelona";"21";"Maresme";"08121";"Mataró";"3";"7";"U";"1002";"325";"595";"733";"269";"6";"4";"723";"727"
"8";"Barcelona";"1";"Barcelona";"21";"Maresme";"08121";"Mataró";"3";"8";"U";"834";"295";"525";"620";"214";"1";"7";"612";"619"
"8";"Barcelona";"1";"Barcelona";"21";"Maresme";"08121";"Mataró";"3";"9";"A";"757";"296";"490";"605";"152";"2";"0";"603";"603"
"8";"Barcelona";"1";"Barcelona";"21";"Maresme";"08121";"Mataró";"3";"9";"B";"897";"327";"563";"697";"200";"0";"1";"696";"697"
"8";"Barcelona";"1";"Barcelona";"21";"Maresme";"08121";"Mataró";"4";"1";"U";"892";"325";"606";"753";"139";"3";"3";"747";"750"
"8";"Barcelona";"1";"Barcelona";"21";"Maresme";"08121";"Mataró";"4";"2";"U";"1013";"373";"637";"743";"270";"4";"3";"736";"739"
"8";"Barcelona";"1";"Barcelona";"21";"Maresme";"08121";"Mataró";"4";"3";"U";"711";"230";"432";"526";"185";"1";"5";"520";"525"
"8";"Barcelona";"1";"Barcelona";"21";"Maresme";"08121";"Mataró";"4";"4";"A";"964";"305";"575";"727";"237";"3";"3";"721";"724"
"8";"Barcelona";"1";"Barcelona";"21";"Maresme";"08121";"Mataró";"4";"4";"B";"1110";"279";"672";"844";"266";"4";"5";"835";"840"
"8";"Barcelona";"1";"Barcelona";"21";"Maresme";"08121";"Mataró";"4";"5";"A";"854";"302";"571";"678";"176";"2";"1";"675";"676"
"8";"Barcelona";"1";"Barcelona";"21";"Maresme";"08121";"Mataró";"4";"5";"B";"1142";"297";"722";"909";"233";"4";"2";"903";"905"
"8";"Barcelona";"1";"Barcelona";"21";"Maresme";"08121";"Mataró";"4";"6";"A";"563";"216";"387";"475";"88";"2";"2";"471";"473"
"8";"Barcelona";"1";"Barcelona";"21";"Maresme";"08121";"Mataró";"4";"6";"B";"664";"229";"443";"548";"116";"1";"2";"545";"547"
"8";"Barcelona";"1";"Barcelona";"21";"Maresme";"08121";"Mataró";"4";"7";"U";"950";"298";"590";"726";"224";"1";"4";"721";"725"
"8";"Barcelona";"1";"Barcelona";"21";"Maresme";"08121";"Mataró";"4";"8";"U";"984";"356";"653";"807";"177";"0";"8";"799";"807"
"8";"Barcelona";"1";"Barcelona";"21";"Maresme";"08121";"Mataró";"4";"9";"A";"719";"254";"433";"551";"168";"1";"6";"544";"550"
"8";"Barcelona";"1";"Barcelona";"21";"Maresme";"08121";"Mataró";"4";"9";"B";"806";"307";"510";"620";"186";"3";"5";"612";"617"
"8";"Barcelona";"1";"Barcelona";"21";"Maresme";"08121";"Mataró";"5";"1";"A";"963";"272";"588";"735";"228";"6";"5";"724";"729"
"8";"Barcelona";"1";"Barcelona";"21";"Maresme";"08121";"Mataró";"5";"1";"B";"1071";"344";"673";"825";"246";"3";"4";"818";"822"
"8";"Barcelona";"1";"Barcelona";"21";"Maresme";"08121";"Mataró";"5";"10";"A";"558";"176";"287";"338";"220";"3";"1";"334";"335"
"8";"Barcelona";"1";"Barcelona";"21";"Maresme";"08121";"Mataró";"5";"10";"B";"578";"194";"321";"378";"200";"2";"2";"374";"376"
"8";"Barcelona";"1";"Barcelona";"21";"Maresme";"08121";"Mataró";"5";"11";"U";"1025";"326";"604";"632";"393";"4";"0";"628";"628"
"8";"Barcelona";"1";"Barcelona";"21";"Maresme";"08121";"Mataró";"5";"12";"U";"895";"345";"584";"707";"188";"1";"4";"702";"706"
"8";"Barcelona";"1";"Barcelona";"21";"Maresme";"08121";"Mataró";"5";"13";"A";"634";"242";"391";"450";"184";"2";"1";"447";"448"
"8";"Barcelona";"1";"Barcelona";"21";"Maresme";"08121";"Mataró";"5";"13";"B";"688";"277";"418";"489";"199";"0";"1";"488";"489"
"8";"Barcelona";"1";"Barcelona";"21";"Maresme";"08121";"Mataró";"5";"15";"U";"807";"251";"481";"587";"220";"2";"2";"583";"585"
"8";"Barcelona";"1";"Barcelona";"21";"Maresme";"08121";"Mataró";"5";"16";"U";"982";"330";"553";"673";"309";"2";"4";"667";"671"
"8";"Barcelona";"1";"Barcelona";"21";"Maresme";"08121";"Mataró";"5";"17";"U";"723";"288";"444";"526";"197";"1";"5";"520";"525"
"8";"Barcelona";"1";"Barcelona";"21";"Maresme";"08121";"Mataró";"5";"19";"U";"620";"226";"375";"436";"184";"0";"4";"432";"436"
"8";"Barcelona";"1";"Barcelona";"21";"Maresme";"08121";"Mataró";"5";"2";"A";"654";"296";"403";"468";"186";"5";"1";"462";"463"
"8";"Barcelona";"1";"Barcelona";"21";"Maresme";"08121";"Mataró";"5";"2";"B";"692";"296";"438";"520";"172";"1";"0";"519";"519"
"8";"Barcelona";"1";"Barcelona";"21";"Maresme";"08121";"Mataró";"5";"20";"U";"1018";"296";"570";"697";"321";"2";"5";"690";"695"
"8";"Barcelona";"1";"Barcelona";"21";"Maresme";"08121";"Mataró";"5";"21";"U";"697";"286";"474";"573";"124";"4";"0";"569";"569"
"8";"Barcelona";"1";"Barcelona";"21";"Maresme";"08121";"Mataró";"5";"3";"A";"553";"269";"371";"432";"121";"2";"2";"428";"430"
"8";"Barcelona";"1";"Barcelona";"21";"Maresme";"08121";"Mataró";"5";"3";"B";"680";"326";"441";"513";"167";"5";"2";"506";"508"
"8";"Barcelona";"1";"Barcelona";"21";"Maresme";"08121";"Mataró";"5";"4";"U";"990";"300";"632";"753";"237";"7";"2";"744";"746"
"8";"Barcelona";"1";"Barcelona";"21";"Maresme";"08121";"Mataró";"5";"5";"U";"667";"193";"426";"503";"164";"2";"3";"498";"501"
"8";"Barcelona";"1";"Barcelona";"21";"Maresme";"08121";"Mataró";"5";"6";"U";"1020";"255";"534";"709";"311";"2";"10";"697";"707"
"8";"Barcelona";"1";"Barcelona";"21";"Maresme";"08121";"Mataró";"5";"7";"A";"551";"220";"344";"429";"122";"1";"2";"426";"428"
"8";"Barcelona";"1";"Barcelona";"21";"Maresme";"08121";"Mataró";"5";"7";"B";"609";"255";"377";"484";"125";"2";"3";"479";"482"
"8";"Barcelona";"1";"Barcelona";"21";"Maresme";"08121";"Mataró";"5";"8";"U";"889";"303";"486";"603";"286";"2";"2";"599";"601"
"8";"Barcelona";"1";"Barcelona";"21";"Maresme";"08121";"Mataró";"5";"9";"U";"751";"291";"451";"537";"214";"0";"0";"537";"537"
"8";"Barcelona";"1";"Barcelona";"21";"Maresme";"08121";"Mataró";"6";"1";"A";"782";"310";"537";"634";"148";"1";"3";"630";"633"
"8";"Barcelona";"1";"Barcelona";"21";"Maresme";"08121";"Mataró";"6";"1";"B";"935";"356";"628";"740";"195";"3";"5";"732";"737"
"8";"Barcelona";"1";"Barcelona";"21";"Maresme";"08121";"Mataró";"6";"10";"A";"874";"275";"549";"674";"200";"3";"4";"667";"671"
"8";"Barcelona";"1";"Barcelona";"21";"Maresme";"08121";"Mataró";"6";"10";"B";"948";"275";"666";"703";"245";"2";"8";"693";"701"
"8";"Barcelona";"1";"Barcelona";"21";"Maresme";"08121";"Mataró";"6";"11";"U";"989";"396";"688";"791";"198";"1";"2";"788";"790"
"8";"Barcelona";"1";"Barcelona";"21";"Maresme";"08121";"Mataró";"6";"12";"A";"621";"191";"349";"442";"179";"1";"1";"440";"441"
"8";"Barcelona";"1";"Barcelona";"21";"Maresme";"08121";"Mataró";"6";"12";"B";"658";"200";"398";"497";"161";"4";"0";"493";"493"
"8";"Barcelona";"1";"Barcelona";"21";"Maresme";"08121";"Mataró";"6";"13";"U";"746";"293";"462";"524";"222";"0";"0";"524";"524"
"8";"Barcelona";"1";"Barcelona";"21";"Maresme";"08121";"Mataró";"6";"14";"A";"610";"210";"399";"491";"119";"2";"1";"488";"489"
"8";"Barcelona";"1";"Barcelona";"21";"Maresme";"08121";"Mataró";"6";"14";"B";"758";"303";"526";"612";"146";"2";"5";"605";"610"
"8";"Barcelona";"1";"Barcelona";"21";"Maresme";"08121";"Mataró";"6";"2";"U";"655";"245";"440";"520";"135";"3";"1";"516";"517"
"8";"Barcelona";"1";"Barcelona";"21";"Maresme";"08121";"Mataró";"6";"3";"A";"751";"283";"529";"616";"135";"3";"3";"610";"613"
"8";"Barcelona";"1";"Barcelona";"21";"Maresme";"08121";"Mataró";"6";"3";"B";"738";"255";"510";"623";"115";"5";"1";"617";"618"
"8";"Barcelona";"1";"Barcelona";"21";"Maresme";"08121";"Mataró";"6";"4";"A";"554";"263";"393";"457";"97";"4";"4";"449";"453"
"8";"Barcelona";"1";"Barcelona";"21";"Maresme";"08121";"Mataró";"6";"4";"B";"590";"252";"421";"490";"100";"3";"4";"483";"487"
"8";"Barcelona";"1";"Barcelona";"21";"Maresme";"08121";"Mataró";"6";"5";"A";"698";"211";"454";"550";"148";"1";"4";"545";"549"
"8";"Barcelona";"1";"Barcelona";"21";"Maresme";"08121";"Mataró";"6";"5";"B";"701";"260";"444";"544";"157";"0";"4";"540";"544"
"8";"Barcelona";"1";"Barcelona";"21";"Maresme";"08121";"Mataró";"6";"6";"A";"660";"293";"472";"546";"114";"6";"5";"535";"540"
"8";"Barcelona";"1";"Barcelona";"21";"Maresme";"08121";"Mataró";"6";"6";"B";"700";"306";"471";"555";"145";"2";"3";"550";"553"
"8";"Barcelona";"1";"Barcelona";"21";"Maresme";"08121";"Mataró";"6";"7";"A";"544";"236";"363";"436";"108";"0";"2";"434";"436"
"8";"Barcelona";"1";"Barcelona";"21";"Maresme";"08121";"Mataró";"6";"7";"B";"601";"248";"395";"467";"134";"1";"0";"466";"466"
"8";"Barcelona";"1";"Barcelona";"21";"Maresme";"08121";"Mataró";"6";"8";"A";"656";"218";"487";"538";"118";"5";"0";"533";"533"
"8";"Barcelona";"1";"Barcelona";"21";"Maresme";"08121";"Mataró";"6";"8";"B";"717";"229";"439";"576";"141";"1";"1";"574";"575"
"8";"Barcelona";"1";"Barcelona";"21";"Maresme";"08121";"Mataró";"6";"9";"U";"930";"275";"477";"577";"353";"2";"3";"572";"575"
"8";"Barcelona";"1";"Barcelona";"3";"Alt Penedès";"08122";"Mediona";"1";"1";"A";"726";"268";"515";"596";"130";"2";"4";"590";"594"
"8";"Barcelona";"1";"Barcelona";"3";"Alt Penedès";"08122";"Mediona";"1";"1";"B";"966";"350";"576";"678";"288";"2";"3";"673";"676"
"8";"Barcelona";"1";"Barcelona";"11";"Baix Llobregat";"08123";"Molins de Rei";"1";"1";"A";"407";"177";"267";"314";"93";"1";"1";"312";"313"
"8";"Barcelona";"1";"Barcelona";"11";"Baix Llobregat";"08123";"Molins de Rei";"1";"1";"B";"509";"213";"359";"410";"99";"4";"2";"404";"406"
"8";"Barcelona";"1";"Barcelona";"11";"Baix Llobregat";"08123";"Molins de Rei";"1";"2";"A";"696";"207";"433";"558";"138";"0";"2";"556";"558"
"8";"Barcelona";"1";"Barcelona";"11";"Baix Llobregat";"08123";"Molins de Rei";"1";"2";"B";"807";"257";"540";"653";"154";"3";"3";"647";"650"
"8";"Barcelona";"1";"Barcelona";"11";"Baix Llobregat";"08123";"Molins de Rei";"1";"3";"A";"627";"242";"422";"509";"118";"3";"3";"503";"506"
"8";"Barcelona";"1";"Barcelona";"11";"Baix Llobregat";"08123";"Molins de Rei";"1";"3";"B";"696";"246";"475";"559";"137";"4";"3";"552";"555"
"8";"Barcelona";"1";"Barcelona";"11";"Baix Llobregat";"08123";"Molins de Rei";"2";"1";"A";"697";"234";"459";"586";"111";"1";"0";"585";"585"
"8";"Barcelona";"1";"Barcelona";"11";"Baix Llobregat";"08123";"Molins de Rei";"2";"1";"B";"700";"222";"485";"586";"114";"1";"1";"584";"585"
"8";"Barcelona";"1";"Barcelona";"11";"Baix Llobregat";"08123";"Molins de Rei";"2";"1";"C";"820";"276";"549";"684";"136";"2";"2";"680";"682"
"8";"Barcelona";"1";"Barcelona";"11";"Baix Llobregat";"08123";"Molins de Rei";"2";"2";"A";"568";"199";"385";"475";"93";"2";"1";"472";"473"
"8";"Barcelona";"1";"Barcelona";"11";"Baix Llobregat";"08123";"Molins de Rei";"2";"2";"B";"649";"265";"445";"548";"101";"0";"3";"545";"548"
"8";"Barcelona";"1";"Barcelona";"11";"Baix Llobregat";"08123";"Molins de Rei";"2";"3";"A";"485";"198";"302";"371";"114";"2";"3";"366";"369"
"8";"Barcelona";"1";"Barcelona";"11";"Baix Llobregat";"08123";"Molins de Rei";"2";"3";"B";"510";"180";"318";"403";"107";"4";"3";"396";"399"
"8";"Barcelona";"1";"Barcelona";"11";"Baix Llobregat";"08123";"Molins de Rei";"2";"3";"C";"562";"238";"385";"454";"108";"2";"0";"452";"452"
"8";"Barcelona";"1";"Barcelona";"11";"Baix Llobregat";"08123";"Molins de Rei";"2";"4";"A";"611";"235";"401";"508";"103";"2";"2";"504";"506"
"8";"Barcelona";"1";"Barcelona";"11";"Baix Llobregat";"08123";"Molins de Rei";"2";"4";"B";"719";"274";"456";"591";"128";"1";"4";"586";"590"
"8";"Barcelona";"1";"Barcelona";"11";"Baix Llobregat";"08123";"Molins de Rei";"3";"1";"A";"634";"233";"442";"547";"87";"2";"2";"543";"545"
"8";"Barcelona";"1";"Barcelona";"11";"Baix Llobregat";"08123";"Molins de Rei";"3";"1";"B";"521";"174";"335";"429";"92";"1";"1";"427";"428"
"8";"Barcelona";"1";"Barcelona";"11";"Baix Llobregat";"08123";"Molins de Rei";"3";"1";"C";"800";"290";"538";"681";"119";"2";"2";"677";"679"
"8";"Barcelona";"1";"Barcelona";"11";"Baix Llobregat";"08123";"Molins de Rei";"3";"1";"D";"597";"230";"402";"495";"102";"1";"1";"493";"494"
"8";"Barcelona";"1";"Barcelona";"11";"Baix Llobregat";"08123";"Molins de Rei";"3";"2";"A";"885";"282";"600";"760";"125";"1";"7";"752";"759"
"8";"Barcelona";"1";"Barcelona";"11";"Baix Llobregat";"08123";"Molins de Rei";"3";"2";"B";"799";"272";"562";"677";"122";"3";"5";"669";"674"
"8";"Barcelona";"1";"Barcelona";"11";"Baix Llobregat";"08123";"Molins de Rei";"3";"2";"C";"921";"290";"640";"798";"123";"7";"3";"788";"791"
"8";"Barcelona";"1";"Barcelona";"11";"Baix Llobregat";"08123";"Molins de Rei";"3";"3";"A";"643";"263";"459";"546";"97";"2";"2";"542";"544"
"8";"Barcelona";"1";"Barcelona";"11";"Baix Llobregat";"08123";"Molins de Rei";"3";"3";"B";"768";"301";"518";"653";"115";"3";"3";"647";"650"
"8";"Barcelona";"1";"Barcelona";"11";"Baix Llobregat";"08123";"Molins de Rei";"3";"4";"A";"524";"202";"345";"440";"84";"2";"1";"437";"438"
"8";"Barcelona";"1";"Barcelona";"11";"Baix Llobregat";"08123";"Molins de Rei";"3";"4";"B";"548";"201";"364";"442";"106";"2";"2";"438";"440"
"8";"Barcelona";"1";"Barcelona";"11";"Baix Llobregat";"08123";"Molins de Rei";"3";"4";"C";"605";"230";"391";"494";"111";"2";"3";"489";"492"
"8";"Barcelona";"1";"Barcelona";"11";"Baix Llobregat";"08123";"Molins de Rei";"4";"1";"A";"361";"114";"215";"264";"97";"1";"3";"260";"263"
"8";"Barcelona";"1";"Barcelona";"11";"Baix Llobregat";"08123";"Molins de Rei";"4";"1";"B";"436";"171";"278";"337";"99";"1";"4";"332";"336"
"8";"Barcelona";"1";"Barcelona";"41";"Vallès Oriental";"08124";"Mollet del Vallès";"1";"1";"U";"615";"204";"392";"472";"143";"2";"1";"469";"470"
"8";"Barcelona";"1";"Barcelona";"41";"Vallès Oriental";"08124";"Mollet del Vallès";"1";"2";"A";"597";"225";"364";"438";"159";"0";"0";"438";"438"
"8";"Barcelona";"1";"Barcelona";"41";"Vallès Oriental";"08124";"Mollet del Vallès";"1";"2";"B";"656";"215";"364";"466";"190";"0";"3";"463";"466"
"8";"Barcelona";"1";"Barcelona";"41";"Vallès Oriental";"08124";"Mollet del Vallès";"1";"3";"A";"387";"115";"220";"276";"111";"2";"2";"272";"274"
"8";"Barcelona";"1";"Barcelona";"41";"Vallès Oriental";"08124";"Mollet del Vallès";"1";"3";"B";"421";"143";"263";"319";"102";"2";"1";"316";"317"
"8";"Barcelona";"1";"Barcelona";"41";"Vallès Oriental";"08124";"Mollet del Vallès";"1";"3";"C";"487";"194";"300";"367";"120";"2";"1";"364";"365"
"8";"Barcelona";"1";"Barcelona";"41";"Vallès Oriental";"08124";"Mollet del Vallès";"1";"4";"A";"722";"266";"486";"587";"135";"1";"4";"582";"586"
"8";"Barcelona";"1";"Barcelona";"41";"Vallès Oriental";"08124";"Mollet del Vallès";"1";"4";"B";"806";"296";"496";"665";"141";"2";"0";"663";"663"
"8";"Barcelona";"1";"Barcelona";"41";"Vallès Oriental";"08124";"Mollet del Vallès";"1";"5";"A";"581";"204";"374";"455";"126";"1";"1";"453";"454"
"8";"Barcelona";"1";"Barcelona";"41";"Vallès Oriental";"08124";"Mollet del Vallès";"1";"5";"B";"706";"276";"432";"538";"168";"2";"3";"533";"536"
"8";"Barcelona";"1";"Barcelona";"41";"Vallès Oriental";"08124";"Mollet del Vallès";"1";"6";"A";"526";"223";"353";"398";"128";"6";"0";"392";"392"
"8";"Barcelona";"1";"Barcelona";"41";"Vallès Oriental";"08124";"Mollet del Vallès";"1";"6";"B";"502";"184";"310";"383";"119";"0";"1";"382";"383"
"8";"Barcelona";"1";"Barcelona";"41";"Vallès Oriental";"08124";"Mollet del Vallès";"1";"6";"C";"475";"165";"288";"342";"133";"0";"1";"341";"342"
"8";"Barcelona";"1";"Barcelona";"41";"Vallès Oriental";"08124";"Mollet del Vallès";"1";"7";"A";"538";"197";"332";"414";"124";"3";"1";"410";"411"
"8";"Barcelona";"1";"Barcelona";"41";"Vallès Oriental";"08124";"Mollet del Vallès";"1";"7";"B";"640";"236";"398";"491";"149";"1";"2";"488";"490"
"8";"Barcelona";"1";"Barcelona";"41";"Vallès Oriental";"08124";"Mollet del Vallès";"2";"1";"A";"454";"179";"297";"352";"102";"0";"1";"351";"352"
"8";"Barcelona";"1";"Barcelona";"41";"Vallès Oriental";"08124";"Mollet del Vallès";"2";"1";"B";"470";"187";"284";"353";"117";"1";"1";"351";"352"
"8";"Barcelona";"1";"Barcelona";"41";"Vallès Oriental";"08124";"Mollet del Vallès";"2";"1";"C";"547";"222";"347";"427";"120";"5";"4";"418";"422"
"8";"Barcelona";"1";"Barcelona";"41";"Vallès Oriental";"08124";"Mollet del Vallès";"2";"2";"A";"624";"234";"419";"519";"105";"3";"6";"510";"516"
"8";"Barcelona";"1";"Barcelona";"41";"Vallès Oriental";"08124";"Mollet del Vallès";"2";"2";"B";"654";"235";"418";"532";"122";"5";"3";"524";"527"
"8";"Barcelona";"1";"Barcelona";"41";"Vallès Oriental";"08124";"Mollet del Vallès";"2";"3";"A";"743";"274";"435";"541";"202";"1";"2";"538";"540"
"8";"Barcelona";"1";"Barcelona";"41";"Vallès Oriental";"08124";"Mollet del Vallès";"2";"3";"B";"828";"337";"529";"623";"205";"1";"3";"619";"622"
"8";"Barcelona";"1";"Barcelona";"41";"Vallès Oriental";"08124";"Mollet del Vallès";"2";"4";"A";"500";"181";"302";"387";"113";"0";"0";"387";"387"
"8";"Barcelona";"1";"Barcelona";"41";"Vallès Oriental";"08124";"Mollet del Vallès";"2";"4";"B";"567";"225";"345";"444";"123";"1";"2";"441";"443"
"8";"Barcelona";"1";"Barcelona";"41";"Vallès Oriental";"08124";"Mollet del Vallès";"2";"5";"A";"482";"209";"314";"393";"89";"1";"1";"391";"392"
"8";"Barcelona";"1";"Barcelona";"41";"Vallès Oriental";"08124";"Mollet del Vallès";"2";"5";"B";"609";"246";"405";"483";"126";"1";"1";"481";"482"
"8";"Barcelona";"1";"Barcelona";"41";"Vallès Oriental";"08124";"Mollet del Vallès";"2";"6";"A";"441";"156";"258";"324";"117";"3";"2";"319";"321"
"8";"Barcelona";"1";"Barcelona";"41";"Vallès Oriental";"08124";"Mollet del Vallès";"2";"6";"B";"557";"201";"333";"399";"158";"2";"5";"392";"397"
"8";"Barcelona";"1";"Barcelona";"41";"Vallès Oriental";"08124";"Mollet del Vallès";"2";"7";"A";"689";"215";"414";"539";"150";"4";"4";"531";"535"
"8";"Barcelona";"1";"Barcelona";"41";"Vallès Oriental";"08124";"Mollet del Vallès";"2";"7";"B";"851";"287";"516";"662";"189";"2";"3";"657";"660"
"8";"Barcelona";"1";"Barcelona";"41";"Vallès Oriental";"08124";"Mollet del Vallès";"2";"8";"A";"554";"217";"379";"478";"76";"1";"3";"474";"477"
"8";"Barcelona";"1";"Barcelona";"41";"Vallès Oriental";"08124";"Mollet del Vallès";"2";"8";"B";"606";"265";"410";"537";"69";"2";"2";"533";"535"
"8";"Barcelona";"1";"Barcelona";"41";"Vallès Oriental";"08124";"Mollet del Vallès";"2";"9";"U";"797";"290";"526";"693";"104";"3";"0";"690";"690"
"8";"Barcelona";"1";"Barcelona";"41";"Vallès Oriental";"08124";"Mollet del Vallès";"3";"1";"A";"512";"193";"305";"372";"140";"1";"0";"371";"371"
"8";"Barcelona";"1";"Barcelona";"41";"Vallès Oriental";"08124";"Mollet del Vallès";"3";"1";"B";"539";"207";"340";"410";"129";"3";"4";"403";"407"
"8";"Barcelona";"1";"Barcelona";"41";"Vallès Oriental";"08124";"Mollet del Vallès";"3";"1";"C";"534";"186";"321";"398";"136";"2";"4";"392";"396"
"8";"Barcelona";"1";"Barcelona";"41";"Vallès Oriental";"08124";"Mollet del Vallès";"3";"10";"A";"469";"181";"273";"349";"120";"2";"1";"346";"347"
"8";"Barcelona";"1";"Barcelona";"41";"Vallès Oriental";"08124";"Mollet del Vallès";"3";"10";"B";"564";"210";"348";"426";"138";"2";"4";"420";"424"
"8";"Barcelona";"1";"Barcelona";"41";"Vallès Oriental";"08124";"Mollet del Vallès";"3";"11";"A";"599";"203";"363";"486";"113";"2";"8";"476";"484"
"8";"Barcelona";"1";"Barcelona";"41";"Vallès Oriental";"08124";"Mollet del Vallès";"3";"11";"B";"672";"246";"409";"540";"132";"1";"4";"535";"539"
"8";"Barcelona";"1";"Barcelona";"41";"Vallès Oriental";"08124";"Mollet del Vallès";"3";"12";"A";"585";"186";"336";"431";"154";"1";"1";"429";"430"
"8";"Barcelona";"1";"Barcelona";"41";"Vallès Oriental";"08124";"Mollet del Vallès";"3";"12";"B";"693";"216";"422";"531";"162";"1";"0";"530";"530"
"8";"Barcelona";"1";"Barcelona";"41";"Vallès Oriental";"08124";"Mollet del Vallès";"3";"13";"A";"354";"128";"224";"285";"69";"0";"1";"284";"285"
"8";"Barcelona";"1";"Barcelona";"41";"Vallès Oriental";"08124";"Mollet del Vallès";"3";"13";"B";"379";"138";"253";"315";"64";"0";"1";"314";"315"
"8";"Barcelona";"1";"Barcelona";"41";"Vallès Oriental";"08124";"Mollet del Vallès";"3";"13";"C";"395";"145";"253";"332";"63";"0";"1";"331";"332"
"8";"Barcelona";"1";"Barcelona";"41";"Vallès Oriental";"08124";"Mollet del Vallès";"3";"14";"A";"505";"172";"297";"387";"118";"1";"2";"384";"386"
"8";"Barcelona";"1";"Barcelona";"41";"Vallès Oriental";"08124";"Mollet del Vallès";"3";"14";"B";"572";"212";"365";"465";"107";"1";"3";"461";"464"
"8";"Barcelona";"1";"Barcelona";"41";"Vallès Oriental";"08124";"Mollet del Vallès";"3";"15";"A";"430";"135";"260";"326";"104";"1";"1";"324";"325"
"8";"Barcelona";"1";"Barcelona";"41";"Vallès Oriental";"08124";"Mollet del Vallès";"3";"15";"B";"498";"135";"281";"371";"127";"0";"3";"368";"371"
"8";"Barcelona";"1";"Barcelona";"41";"Vallès Oriental";"08124";"Mollet del Vallès";"3";"2";"A";"604";"218";"354";"453";"151";"2";"2";"449";"451"
"8";"Barcelona";"1";"Barcelona";"41";"Vallès Oriental";"08124";"Mollet del Vallès";"3";"2";"B";"691";"284";"440";"542";"149";"0";"2";"540";"542"
"8";"Barcelona";"1";"Barcelona";"41";"Vallès Oriental";"08124";"Mollet del Vallès";"3";"3";"A";"440";"146";"258";"320";"120";"2";"3";"315";"318"
"8";"Barcelona";"1";"Barcelona";"41";"Vallès Oriental";"08124";"Mollet del Vallès";"3";"3";"B";"429";"167";"292";"335";"94";"0";"2";"333";"335"
"8";"Barcelona";"1";"Barcelona";"41";"Vallès Oriental";"08124";"Mollet del Vallès";"3";"4";"A";"637";"255";"410";"511";"126";"1";"0";"510";"510"
"8";"Barcelona";"1";"Barcelona";"41";"Vallès Oriental";"08124";"Mollet del Vallès";"3";"4";"B";"740";"302";"478";"590";"150";"1";"2";"587";"589"
"8";"Barcelona";"1";"Barcelona";"41";"Vallès Oriental";"08124";"Mollet del Vallès";"3";"5";"A";"684";"233";"444";"554";"130";"1";"1";"552";"553"
"8";"Barcelona";"1";"Barcelona";"41";"Vallès Oriental";"08124";"Mollet del Vallès";"3";"5";"B";"897";"330";"573";"719";"178";"0";"2";"717";"719"
"8";"Barcelona";"1";"Barcelona";"41";"Vallès Oriental";"08124";"Mollet del Vallès";"3";"6";"A";"404";"130";"193";"244";"160";"4";"0";"240";"240"
"8";"Barcelona";"1";"Barcelona";"41";"Vallès Oriental";"08124";"Mollet del Vallès";"3";"6";"B";"474";"155";"232";"267";"207";"1";"0";"266";"266"
"8";"Barcelona";"1";"Barcelona";"41";"Vallès Oriental";"08124";"Mollet del Vallès";"3";"7";"A";"429";"148";"233";"294";"135";"2";"6";"286";"292"
"8";"Barcelona";"1";"Barcelona";"41";"Vallès Oriental";"08124";"Mollet del Vallès";"3";"7";"B";"476";"186";"272";"337";"139";"3";"1";"333";"334"
"8";"Barcelona";"1";"Barcelona";"41";"Vallès Oriental";"08124";"Mollet del Vallès";"3";"7";"C";"530";"190";"316";"375";"155";"3";"3";"369";"372"
"8";"Barcelona";"1";"Barcelona";"41";"Vallès Oriental";"08124";"Mollet del Vallès";"3";"8";"U";"655";"252";"385";"504";"151";"2";"4";"498";"502"
"8";"Barcelona";"1";"Barcelona";"41";"Vallès Oriental";"08124";"Mollet del Vallès";"3";"9";"A";"335";"135";"193";"238";"97";"2";"0";"236";"236"
"8";"Barcelona";"1";"Barcelona";"41";"Vallès Oriental";"08124";"Mollet del Vallès";"3";"9";"B";"400";"161";"253";"307";"93";"2";"1";"304";"305"
"8";"Barcelona";"1";"Barcelona";"40";"Vallès Occidental";"08125";"Montcada i Reixac";"1";"1";"U";"840";"282";"540";"659";"181";"2";"5";"652";"657"
"8";"Barcelona";"1";"Barcelona";"40";"Vallès Occidental";"08125";"Montcada i Reixac";"1";"2";"U";"1096";"411";"702";"874";"222";"3";"6";"865";"871"
"8";"Barcelona";"1";"Barcelona";"40";"Vallès Occidental";"08125";"Montcada i Reixac";"1";"4";"A";"604";"217";"366";"446";"158";"0";"5";"441";"446"
"8";"Barcelona";"1";"Barcelona";"40";"Vallès Occidental";"08125";"Montcada i Reixac";"1";"4";"B";"674";"212";"385";"489";"185";"1";"2";"486";"488"
"8";"Barcelona";"1";"Barcelona";"40";"Vallès Occidental";"08125";"Montcada i Reixac";"1";"5";"U";"1144";"420";"750";"907";"237";"6";"6";"895";"901"
"8";"Barcelona";"1";"Barcelona";"40";"Vallès Occidental";"08125";"Montcada i Reixac";"2";"1";"U";"931";"329";"474";"592";"339";"2";"1";"589";"590"
"8";"Barcelona";"1";"Barcelona";"40";"Vallès Occidental";"08125";"Montcada i Reixac";"2";"2";"A";"832";"315";"560";"670";"162";"1";"3";"666";"669"
"8";"Barcelona";"1";"Barcelona";"40";"Vallès Occidental";"08125";"Montcada i Reixac";"2";"2";"B";"1003";"350";"610";"757";"246";"1";"5";"751";"756"
"8";"Barcelona";"1";"Barcelona";"40";"Vallès Occidental";"08125";"Montcada i Reixac";"2";"3";"A";"806";"362";"520";"651";"155";"1";"5";"645";"650"
"8";"Barcelona";"1";"Barcelona";"40";"Vallès Occidental";"08125";"Montcada i Reixac";"2";"3";"B";"976";"239";"596";"778";"198";"3";"4";"771";"775"
"8";"Barcelona";"1";"Barcelona";"40";"Vallès Occidental";"08125";"Montcada i Reixac";"3";"1";"A";"791";"294";"477";"603";"188";"0";"4";"599";"603"
"8";"Barcelona";"1";"Barcelona";"40";"Vallès Occidental";"08125";"Montcada i Reixac";"3";"1";"B";"927";"304";"559";"700";"227";"0";"7";"693";"700"
"8";"Barcelona";"1";"Barcelona";"40";"Vallès Occidental";"08125";"Montcada i Reixac";"3";"2";"U";"841";"328";"541";"682";"159";"1";"4";"677";"681"
"8";"Barcelona";"1";"Barcelona";"40";"Vallès Occidental";"08125";"Montcada i Reixac";"3";"3";"A";"793";"252";"443";"624";"169";"0";"1";"623";"624"
"8";"Barcelona";"1";"Barcelona";"40";"Vallès Occidental";"08125";"Montcada i Reixac";"3";"3";"B";"898";"269";"570";"703";"195";"5";"4";"694";"698"
"8";"Barcelona";"1";"Barcelona";"40";"Vallès Occidental";"08125";"Montcada i Reixac";"3";"4";"A";"702";"210";"436";"592";"110";"1";"1";"590";"591"
"8";"Barcelona";"1";"Barcelona";"40";"Vallès Occidental";"08125";"Montcada i Reixac";"3";"4";"B";"733";"243";"452";"599";"134";"2";"4";"593";"597"
"8";"Barcelona";"1";"Barcelona";"40";"Vallès Occidental";"08125";"Montcada i Reixac";"3";"5";"A";"670";"203";"409";"524";"146";"0";"8";"516";"524"
"8";"Barcelona";"1";"Barcelona";"40";"Vallès Occidental";"08125";"Montcada i Reixac";"3";"5";"B";"782";"238";"478";"599";"183";"0";"1";"598";"599"
"8";"Barcelona";"1";"Barcelona";"40";"Vallès Occidental";"08125";"Montcada i Reixac";"3";"6";"U";"757";"243";"496";"608";"149";"3";"4";"601";"605"
"8";"Barcelona";"1";"Barcelona";"40";"Vallès Occidental";"08125";"Montcada i Reixac";"4";"1";"U";"772";"289";"503";"597";"175";"4";"5";"588";"593"
"8";"Barcelona";"1";"Barcelona";"40";"Vallès Occidental";"08125";"Montcada i Reixac";"4";"2";"U";"759";"249";"454";"578";"181";"4";"2";"572";"574"
"8";"Barcelona";"1";"Barcelona";"40";"Vallès Occidental";"08125";"Montcada i Reixac";"4";"3";"U";"930";"312";"551";"692";"238";"3";"3";"686";"689"
"8";"Barcelona";"1";"Barcelona";"40";"Vallès Occidental";"08125";"Montcada i Reixac";"5";"1";"A";"743";"206";"391";"495";"248";"2";"3";"490";"493"
"8";"Barcelona";"1";"Barcelona";"40";"Vallès Occidental";"08125";"Montcada i Reixac";"5";"1";"B";"841";"253";"439";"573";"268";"3";"5";"565";"570"
"8";"Barcelona";"1";"Barcelona";"40";"Vallès Occidental";"08125";"Montcada i Reixac";"5";"2";"U";"964";"323";"562";"705";"259";"2";"1";"702";"703"
"8";"Barcelona";"1";"Barcelona";"40";"Vallès Occidental";"08125";"Montcada i Reixac";"5";"3";"U";"961";"286";"489";"613";"348";"1";"1";"611";"612"
"8";"Barcelona";"1";"Barcelona";"40";"Vallès Occidental";"08125";"Montcada i Reixac";"6";"1";"U";"681";"210";"433";"556";"125";"1";"2";"553";"555"
"8";"Barcelona";"1";"Barcelona";"40";"Vallès Occidental";"08125";"Montcada i Reixac";"6";"2";"U";"632";"186";"423";"526";"106";"3";"3";"520";"523"
"8";"Barcelona";"1";"Barcelona";"40";"Vallès Occidental";"08125";"Montcada i Reixac";"6";"3";"U";"936";"292";"562";"679";"257";"2";"7";"670";"677"
"8";"Barcelona";"1";"Barcelona";"21";"Maresme";"08126";"Montgat";"1";"1";"A";"672";"227";"457";"573";"99";"3";"3";"567";"570"
"8";"Barcelona";"1";"Barcelona";"21";"Maresme";"08126";"Montgat";"1";"1";"B";"562";"196";"349";"469";"93";"1";"2";"466";"468"
"8";"Barcelona";"1";"Barcelona";"21";"Maresme";"08126";"Montgat";"1";"1";"C";"779";"244";"492";"639";"140";"2";"3";"634";"637"
"8";"Barcelona";"1";"Barcelona";"21";"Maresme";"08126";"Montgat";"1";"1";"D";"632";"212";"396";"513";"119";"1";"2";"510";"512"
"8";"Barcelona";"1";"Barcelona";"21";"Maresme";"08126";"Montgat";"1";"2";"A";"581";"242";"390";"469";"112";"2";"2";"465";"467"
"8";"Barcelona";"1";"Barcelona";"21";"Maresme";"08126";"Montgat";"1";"2";"B";"523";"204";"331";"406";"117";"1";"3";"402";"405"
"8";"Barcelona";"1";"Barcelona";"21";"Maresme";"08126";"Montgat";"1";"2";"C";"724";"233";"457";"567";"157";"1";"5";"561";"566"
"8";"Barcelona";"1";"Barcelona";"21";"Maresme";"08126";"Montgat";"1";"2";"D";"546";"208";"340";"418";"128";"0";"1";"417";"418"
"8";"Barcelona";"1";"Barcelona";"21";"Maresme";"08126";"Montgat";"1";"3";"A";"531";"222";"363";"452";"79";"2";"3";"447";"450"
"8";"Barcelona";"1";"Barcelona";"21";"Maresme";"08126";"Montgat";"1";"3";"B";"589";"200";"377";"482";"107";"2";"4";"476";"480"
"8";"Barcelona";"1";"Barcelona";"21";"Maresme";"08126";"Montgat";"1";"3";"C";"594";"240";"406";"487";"107";"3";"3";"481";"484"
"8";"Barcelona";"1";"Barcelona";"21";"Maresme";"08126";"Montgat";"1";"3";"D";"530";"209";"353";"429";"101";"1";"1";"427";"428"
"8";"Barcelona";"1";"Barcelona";"21";"Maresme";"08126";"Montgat";"1";"4";"A";"659";"216";"439";"536";"123";"1";"1";"534";"535"
"8";"Barcelona";"1";"Barcelona";"21";"Maresme";"08126";"Montgat";"1";"4";"B";"774";"268";"497";"620";"154";"0";"1";"619";"620"
"8";"Barcelona";"1";"Barcelona";"41";"Vallès Oriental";"08135";"Montmeló";"1";"1";"A";"612";"237";"404";"516";"96";"5";"2";"509";"511"
"8";"Barcelona";"1";"Barcelona";"41";"Vallès Oriental";"08135";"Montmeló";"1";"1";"B";"741";"235";"451";"600";"141";"6";"3";"591";"594"
"8";"Barcelona";"1";"Barcelona";"41";"Vallès Oriental";"08135";"Montmeló";"1";"1";"C";"618";"238";"402";"531";"87";"3";"0";"528";"528"
"8";"Barcelona";"1";"Barcelona";"41";"Vallès Oriental";"08135";"Montmeló";"1";"2";"A";"499";"199";"322";"387";"112";"0";"1";"386";"387"
"8";"Barcelona";"1";"Barcelona";"41";"Vallès Oriental";"08135";"Montmeló";"1";"2";"B";"645";"266";"429";"516";"129";"2";"2";"512";"514"
"8";"Barcelona";"1";"Barcelona";"41";"Vallès Oriental";"08135";"Montmeló";"1";"3";"A";"801";"298";"507";"635";"166";"0";"6";"629";"635"
"8";"Barcelona";"1";"Barcelona";"41";"Vallès Oriental";"08135";"Montmeló";"1";"3";"B";"941";"315";"597";"756";"185";"4";"7";"745";"752"
"8";"Barcelona";"1";"Barcelona";"41";"Vallès Oriental";"08135";"Montmeló";"1";"4";"U";"899";"346";"576";"705";"194";"3";"6";"696";"702"
"8";"Barcelona";"1";"Barcelona";"41";"Vallès Oriental";"08135";"Montmeló";"1";"5";"U";"970";"373";"665";"796";"174";"1";"3";"792";"795"
"8";"Barcelona";"1";"Barcelona";"41";"Vallès Oriental";"08136";"Montornès del Vallès";"1";"1";"A";"632";"209";"431";"500";"132";"3";"4";"493";"497"
"8";"Barcelona";"1";"Barcelona";"41";"Vallès Oriental";"08136";"Montornès del Vallès";"1";"1";"B";"754";"236";"379";"573";"181";"2";"4";"567";"571"
"8";"Barcelona";"1";"Barcelona";"41";"Vallès Oriental";"08136";"Montornès del Vallès";"1";"2";"A";"384";"155";"257";"305";"79";"2";"1";"302";"303"
"8";"Barcelona";"1";"Barcelona";"41";"Vallès Oriental";"08136";"Montornès del Vallès";"1";"2";"B";"470";"174";"293";"372";"98";"1";"2";"369";"371"
"8";"Barcelona";"1";"Barcelona";"41";"Vallès Oriental";"08136";"Montornès del Vallès";"1";"2";"C";"360";"131";"222";"275";"85";"0";"1";"274";"275"
"8";"Barcelona";"1";"Barcelona";"41";"Vallès Oriental";"08136";"Montornès del Vallès";"1";"3";"A";"571";"237";"379";"465";"106";"1";"3";"461";"464"
"8";"Barcelona";"1";"Barcelona";"41";"Vallès Oriental";"08136";"Montornès del Vallès";"1";"3";"B";"682";"219";"403";"524";"158";"1";"9";"514";"523"
"8";"Barcelona";"1";"Barcelona";"41";"Vallès Oriental";"08136";"Montornès del Vallès";"1";"3";"C";"531";"171";"302";"397";"134";"0";"3";"394";"397"
"8";"Barcelona";"1";"Barcelona";"41";"Vallès Oriental";"08136";"Montornès del Vallès";"1";"4";"A";"406";"158";"244";"325";"81";"4";"3";"318";"321"
"8";"Barcelona";"1";"Barcelona";"41";"Vallès Oriental";"08136";"Montornès del Vallès";"1";"4";"B";"582";"239";"382";"482";"100";"2";"3";"477";"480"
"8";"Barcelona";"1";"Barcelona";"41";"Vallès Oriental";"08136";"Montornès del Vallès";"1";"4";"C";"452";"198";"306";"374";"78";"1";"1";"372";"373"
"8";"Barcelona";"1";"Barcelona";"41";"Vallès Oriental";"08136";"Montornès del Vallès";"1";"5";"A";"542";"220";"335";"443";"99";"3";"1";"439";"440"
"8";"Barcelona";"1";"Barcelona";"41";"Vallès Oriental";"08136";"Montornès del Vallès";"1";"5";"B";"646";"261";"403";"499";"147";"5";"5";"489";"494"
"8";"Barcelona";"1";"Barcelona";"41";"Vallès Oriental";"08136";"Montornès del Vallès";"1";"5";"C";"554";"241";"378";"470";"84";"0";"1";"469";"470"
"8";"Barcelona";"1";"Barcelona";"41";"Vallès Oriental";"08136";"Montornès del Vallès";"1";"6";"A";"528";"215";"346";"445";"83";"0";"5";"440";"445"
"8";"Barcelona";"1";"Barcelona";"41";"Vallès Oriental";"08136";"Montornès del Vallès";"1";"6";"B";"552";"222";"370";"461";"91";"3";"2";"456";"458"
"8";"Barcelona";"1";"Barcelona";"41";"Vallès Oriental";"08136";"Montornès del Vallès";"1";"7";"U";"749";"298";"479";"613";"136";"1";"3";"609";"612"
"8";"Barcelona";"1";"Barcelona";"41";"Vallès Oriental";"08136";"Montornès del Vallès";"2";"1";"U";"533";"147";"255";"301";"232";"0";"1";"300";"301"
"8";"Barcelona";"1";"Barcelona";"41";"Vallès Oriental";"08136";"Montornès del Vallès";"2";"2";"U";"667";"227";"398";"493";"174";"3";"1";"489";"490"
"8";"Barcelona";"1";"Barcelona";"41";"Vallès Oriental";"08136";"Montornès del Vallès";"2";"3";"U";"785";"229";"399";"502";"283";"5";"4";"493";"497"
"8";"Barcelona";"1";"Barcelona";"41";"Vallès Oriental";"08137";"Montseny";"1";"1";"U";"263";"100";"171";"232";"31";"1";"0";"231";"231"
"8";"Barcelona";"1";"Barcelona";"3";"Alt Penedès";"08146";"Olesa de Bonesvalls";"1";"1";"U";"606";"275";"416";"498";"108";"2";"4";"492";"496"
"8";"Barcelona";"1";"Barcelona";"3";"Alt Penedès";"08146";"Olesa de Bonesvalls";"1";"2";"U";"692";"272";"491";"557";"135";"2";"3";"552";"555"
"8";"Barcelona";"1";"Barcelona";"11";"Baix Llobregat";"08147";"Olesa de Montserrat";"1";"1";"A";"700";"268";"412";"499";"201";"0";"0";"499";"499"
"8";"Barcelona";"1";"Barcelona";"11";"Baix Llobregat";"08147";"Olesa de Montserrat";"1";"1";"B";"763";"255";"458";"572";"191";"8";"4";"560";"564"
"8";"Barcelona";"1";"Barcelona";"11";"Baix Llobregat";"08147";"Olesa de Montserrat";"1";"10";"A";"703";"251";"424";"521";"182";"5";"4";"512";"516"
"8";"Barcelona";"1";"Barcelona";"11";"Baix Llobregat";"08147";"Olesa de Montserrat";"1";"10";"B";"822";"304";"514";"652";"170";"5";"4";"643";"647"
"8";"Barcelona";"1";"Barcelona";"11";"Baix Llobregat";"08147";"Olesa de Montserrat";"1";"11";"A";"504";"162";"291";"380";"124";"0";"0";"380";"380"
"8";"Barcelona";"1";"Barcelona";"11";"Baix Llobregat";"08147";"Olesa de Montserrat";"1";"11";"B";"627";"202";"368";"480";"147";"1";"1";"478";"479"
"8";"Barcelona";"1";"Barcelona";"11";"Baix Llobregat";"08147";"Olesa de Montserrat";"1";"11";"C";"533";"171";"316";"404";"129";"2";"4";"398";"402"
"8";"Barcelona";"1";"Barcelona";"11";"Baix Llobregat";"08147";"Olesa de Montserrat";"1";"2";"A";"709";"264";"455";"561";"148";"3";"3";"555";"558"
"8";"Barcelona";"1";"Barcelona";"11";"Baix Llobregat";"08147";"Olesa de Montserrat";"1";"2";"B";"768";"242";"447";"584";"184";"2";"5";"577";"582"
"8";"Barcelona";"1";"Barcelona";"11";"Baix Llobregat";"08147";"Olesa de Montserrat";"1";"3";"A";"464";"204";"322";"376";"88";"1";"3";"372";"375"
"8";"Barcelona";"1";"Barcelona";"11";"Baix Llobregat";"08147";"Olesa de Montserrat";"1";"3";"B";"477";"186";"305";"377";"100";"1";"0";"376";"376"
"8";"Barcelona";"1";"Barcelona";"11";"Baix Llobregat";"08147";"Olesa de Montserrat";"1";"4";"A";"561";"219";"350";"481";"80";"3";"3";"475";"478"
"8";"Barcelona";"1";"Barcelona";"11";"Baix Llobregat";"08147";"Olesa de Montserrat";"1";"4";"B";"534";"210";"342";"434";"100";"2";"3";"429";"432"
"8";"Barcelona";"1";"Barcelona";"11";"Baix Llobregat";"08147";"Olesa de Montserrat";"1";"4";"C";"517";"193";"333";"424";"93";"1";"4";"419";"423"
"8";"Barcelona";"1";"Barcelona";"11";"Baix Llobregat";"08147";"Olesa de Montserrat";"1";"5";"A";"582";"215";"382";"471";"111";"1";"0";"470";"470"
"8";"Barcelona";"1";"Barcelona";"11";"Baix Llobregat";"08147";"Olesa de Montserrat";"1";"5";"B";"718";"236";"455";"573";"145";"3";"2";"568";"570"
"8";"Barcelona";"1";"Barcelona";"11";"Baix Llobregat";"08147";"Olesa de Montserrat";"1";"5";"C";"657";"225";"403";"518";"139";"4";"0";"514";"514"
"8";"Barcelona";"1";"Barcelona";"11";"Baix Llobregat";"08147";"Olesa de Montserrat";"1";"6";"A";"630";"234";"382";"478";"152";"3";"3";"472";"475"
"8";"Barcelona";"1";"Barcelona";"11";"Baix Llobregat";"08147";"Olesa de Montserrat";"1";"6";"B";"684";"209";"415";"523";"161";"5";"5";"513";"518"
"8";"Barcelona";"1";"Barcelona";"11";"Baix Llobregat";"08147";"Olesa de Montserrat";"1";"6";"C";"576";"220";"367";"452";"124";"1";"1";"450";"451"
"8";"Barcelona";"1";"Barcelona";"11";"Baix Llobregat";"08147";"Olesa de Montserrat";"1";"7";"A";"636";"213";"375";"473";"163";"0";"3";"470";"473"
"8";"Barcelona";"1";"Barcelona";"11";"Baix Llobregat";"08147";"Olesa de Montserrat";"1";"7";"B";"726";"229";"428";"537";"189";"1";"1";"535";"536"
"8";"Barcelona";"1";"Barcelona";"11";"Baix Llobregat";"08147";"Olesa de Montserrat";"1";"8";"A";"530";"206";"335";"432";"98";"2";"1";"429";"430"
"8";"Barcelona";"1";"Barcelona";"11";"Baix Llobregat";"08147";"Olesa de Montserrat";"1";"8";"B";"618";"212";"383";"489";"129";"1";"1";"487";"488"
"8";"Barcelona";"1";"Barcelona";"11";"Baix Llobregat";"08147";"Olesa de Montserrat";"1";"8";"C";"557";"219";"363";"432";"125";"0";"2";"430";"432"
"8";"Barcelona";"1";"Barcelona";"11";"Baix Llobregat";"08147";"Olesa de Montserrat";"1";"9";"A";"681";"281";"502";"578";"103";"4";"5";"569";"574"
"8";"Barcelona";"1";"Barcelona";"11";"Baix Llobregat";"08147";"Olesa de Montserrat";"1";"9";"B";"714";"262";"481";"596";"118";"5";"1";"590";"591"
"8";"Barcelona";"1";"Barcelona";"17";"Garraf";"08148";"Olivella";"1";"1";"U";"1038";"392";"666";"809";"229";"0";"4";"805";"809"
"8";"Barcelona";"1";"Barcelona";"17";"Garraf";"08148";"Olivella";"1";"2";"A";"975";"334";"629";"749";"226";"2";"4";"743";"747"
"8";"Barcelona";"1";"Barcelona";"17";"Garraf";"08148";"Olivella";"1";"2";"B";"220";"85";"121";"158";"62";"0";"0";"158";"158"
"8";"Barcelona";"1";"Barcelona";"3";"Alt Penedès";"08145";"Olèrdola";"1";"1";"A";"777";"295";"483";"609";"168";"0";"2";"607";"609"
"8";"Barcelona";"1";"Barcelona";"3";"Alt Penedès";"08145";"Olèrdola";"1";"1";"B";"766";"297";"518";"613";"153";"1";"2";"610";"612"
"8";"Barcelona";"1";"Barcelona";"3";"Alt Penedès";"08145";"Olèrdola";"1";"2";"A";"515";"185";"361";"446";"69";"6";"1";"439";"440"
"8";"Barcelona";"1";"Barcelona";"3";"Alt Penedès";"08145";"Olèrdola";"1";"2";"B";"528";"249";"400";"466";"62";"5";"6";"455";"461"
"8";"Barcelona";"1";"Barcelona";"3";"Alt Penedès";"08154";"Pacs del Penedès";"1";"1";"U";"694";"232";"485";"592";"102";"4";"4";"584";"588"
"8";"Barcelona";"1";"Barcelona";"21";"Maresme";"08155";"Palafolls";"1";"1";"A";"560";"217";"400";"472";"88";"1";"4";"467";"471"
"8";"Barcelona";"1";"Barcelona";"21";"Maresme";"08155";"Palafolls";"1";"1";"B";"717";"287";"475";"576";"141";"2";"7";"567";"574"
"8";"Barcelona";"1";"Barcelona";"21";"Maresme";"08155";"Palafolls";"1";"1";"C";"706";"303";"511";"589";"117";"0";"4";"585";"589"
"8";"Barcelona";"1";"Barcelona";"21";"Maresme";"08155";"Palafolls";"1";"2";"A";"450";"166";"309";"367";"83";"1";"1";"365";"366"
"8";"Barcelona";"1";"Barcelona";"21";"Maresme";"08155";"Palafolls";"1";"2";"B";"562";"234";"387";"458";"104";"4";"3";"451";"454"
"8";"Barcelona";"1";"Barcelona";"21";"Maresme";"08155";"Palafolls";"1";"3";"A";"764";"248";"452";"547";"217";"3";"4";"540";"544"
"8";"Barcelona";"1";"Barcelona";"21";"Maresme";"08155";"Palafolls";"1";"3";"B";"822";"294";"509";"600";"222";"2";"2";"596";"598"
"8";"Barcelona";"1";"Barcelona";"21";"Maresme";"08155";"Palafolls";"1";"4";"A";"572";"205";"372";"459";"113";"2";"7";"450";"457"
"8";"Barcelona";"1";"Barcelona";"21";"Maresme";"08155";"Palafolls";"1";"4";"B";"686";"235";"439";"524";"162";"1";"0";"523";"523"
"8";"Barcelona";"1";"Barcelona";"21";"Maresme";"08155";"Palafolls";"1";"5";"U";"890";"237";"515";"633";"257";"5";"3";"625";"628"
"8";"Barcelona";"1";"Barcelona";"40";"Vallès Occidental";"08156";"Palau-solità i Plegamans";"1";"1";"A";"341";"116";"192";"243";"98";"0";"1";"242";"243"
"8";"Barcelona";"1";"Barcelona";"40";"Vallès Occidental";"08156";"Palau-solità i Plegamans";"1";"1";"B";"427";"129";"235";"296";"131";"0";"2";"294";"296"
"8";"Barcelona";"1";"Barcelona";"40";"Vallès Occidental";"08156";"Palau-solità i Plegamans";"1";"1";"C";"376";"123";"198";"257";"119";"1";"1";"255";"256"
"8";"Barcelona";"1";"Barcelona";"40";"Vallès Occidental";"08156";"Palau-solità i Plegamans";"1";"2";"A";"590";"235";"390";"471";"119";"2";"3";"466";"469"
"8";"Barcelona";"1";"Barcelona";"40";"Vallès Occidental";"08156";"Palau-solità i Plegamans";"1";"2";"B";"682";"266";"459";"535";"147";"5";"3";"527";"530"
"8";"Barcelona";"1";"Barcelona";"40";"Vallès Occidental";"08156";"Palau-solità i Plegamans";"1";"2";"C";"577";"222";"368";"465";"112";"1";"2";"462";"464"
"8";"Barcelona";"1";"Barcelona";"40";"Vallès Occidental";"08156";"Palau-solità i Plegamans";"1";"3";"A";"617";"228";"460";"486";"131";"1";"1";"484";"485"
"8";"Barcelona";"1";"Barcelona";"40";"Vallès Occidental";"08156";"Palau-solità i Plegamans";"1";"3";"B";"738";"256";"389";"569";"169";"3";"3";"563";"566"
"8";"Barcelona";"1";"Barcelona";"40";"Vallès Occidental";"08156";"Palau-solità i Plegamans";"1";"4";"A";"546";"195";"332";"448";"98";"3";"4";"441";"445"
"8";"Barcelona";"1";"Barcelona";"40";"Vallès Occidental";"08156";"Palau-solità i Plegamans";"1";"4";"B";"673";"242";"441";"559";"114";"2";"1";"556";"557"
"8";"Barcelona";"1";"Barcelona";"40";"Vallès Occidental";"08156";"Palau-solità i Plegamans";"1";"4";"C";"646";"226";"438";"545";"101";"4";"1";"540";"541"
"8";"Barcelona";"1";"Barcelona";"40";"Vallès Occidental";"08156";"Palau-solità i Plegamans";"1";"5";"U";"849";"355";"589";"733";"116";"0";"4";"729";"733"
"8";"Barcelona";"1";"Barcelona";"40";"Vallès Occidental";"08156";"Palau-solità i Plegamans";"1";"6";"A";"759";"262";"489";"619";"140";"3";"3";"613";"616"
"8";"Barcelona";"1";"Barcelona";"40";"Vallès Occidental";"08156";"Palau-solità i Plegamans";"1";"6";"B";"764";"318";"545";"625";"139";"0";"4";"621";"625"
"8";"Barcelona";"1";"Barcelona";"40";"Vallès Occidental";"08156";"Palau-solità i Plegamans";"1";"7";"A";"506";"214";"347";"415";"91";"5";"1";"409";"410"
"8";"Barcelona";"1";"Barcelona";"40";"Vallès Occidental";"08156";"Palau-solità i Plegamans";"1";"7";"B";"649";"258";"435";"524";"125";"2";"5";"517";"522"
"8";"Barcelona";"1";"Barcelona";"40";"Vallès Occidental";"08156";"Palau-solità i Plegamans";"1";"8";"A";"567";"206";"347";"430";"137";"2";"1";"427";"428"
"8";"Barcelona";"1";"Barcelona";"40";"Vallès Occidental";"08156";"Palau-solità i Plegamans";"1";"8";"B";"610";"250";"396";"486";"124";"3";"1";"482";"483"
"8";"Barcelona";"1";"Barcelona";"11";"Baix Llobregat";"08157";"Pallejà";"1";"1";"A";"590";"233";"373";"472";"118";"1";"2";"469";"471"
"8";"Barcelona";"1";"Barcelona";"11";"Baix Llobregat";"08157";"Pallejà";"1";"1";"B";"718";"263";"426";"558";"160";"2";"1";"555";"556"
"8";"Barcelona";"1";"Barcelona";"11";"Baix Llobregat";"08157";"Pallejà";"1";"1";"C";"588";"246";"374";"483";"105";"6";"2";"475";"477"
"8";"Barcelona";"1";"Barcelona";"11";"Baix Llobregat";"08157";"Pallejà";"1";"2";"A";"530";"175";"282";"394";"136";"1";"2";"391";"393"
"8";"Barcelona";"1";"Barcelona";"11";"Baix Llobregat";"08157";"Pallejà";"1";"2";"B";"672";"227";"398";"513";"159";"1";"7";"505";"512"
"8";"Barcelona";"1";"Barcelona";"11";"Baix Llobregat";"08157";"Pallejà";"1";"2";"C";"548";"187";"345";"431";"117";"0";"4";"427";"431"
"8";"Barcelona";"1";"Barcelona";"11";"Baix Llobregat";"08157";"Pallejà";"1";"3";"A";"760";"276";"491";"622";"138";"0";"3";"619";"622"
"8";"Barcelona";"1";"Barcelona";"11";"Baix Llobregat";"08157";"Pallejà";"1";"3";"B";"824";"311";"537";"638";"186";"0";"4";"634";"638"
"8";"Barcelona";"1";"Barcelona";"11";"Baix Llobregat";"08157";"Pallejà";"1";"4";"A";"641";"225";"430";"520";"121";"1";"1";"518";"519"
"8";"Barcelona";"1";"Barcelona";"11";"Baix Llobregat";"08157";"Pallejà";"1";"4";"B";"701";"242";"459";"555";"146";"2";"1";"552";"553"
"8";"Barcelona";"1";"Barcelona";"11";"Baix Llobregat";"08157";"Pallejà";"1";"5";"A";"563";"204";"365";"464";"99";"2";"7";"455";"462"
"8";"Barcelona";"1";"Barcelona";"11";"Baix Llobregat";"08157";"Pallejà";"1";"5";"B";"665";"290";"457";"552";"113";"2";"3";"547";"550"
"8";"Barcelona";"1";"Barcelona";"11";"Baix Llobregat";"08157";"Pallejà";"1";"5";"C";"563";"245";"393";"467";"96";"3";"1";"463";"464"
"8";"Barcelona";"1";"Barcelona";"11";"Baix Llobregat";"08905";"Palma de Cervelló, la";"1";"1";"A";"599";"245";"419";"512";"87";"5";"4";"503";"507"
"8";"Barcelona";"1";"Barcelona";"11";"Baix Llobregat";"08905";"Palma de Cervelló, la";"1";"1";"B";"629";"227";"431";"527";"102";"1";"5";"521";"526"
"8";"Barcelona";"1";"Barcelona";"11";"Baix Llobregat";"08905";"Palma de Cervelló, la";"1";"2";"A";"486";"192";"330";"411";"75";"0";"4";"407";"411"
"8";"Barcelona";"1";"Barcelona";"11";"Baix Llobregat";"08905";"Palma de Cervelló, la";"1";"2";"B";"593";"209";"408";"507";"86";"2";"2";"503";"505"
"8";"Barcelona";"1";"Barcelona";"11";"Baix Llobregat";"08158";"Papiol, el";"1";"1";"A";"830";"230";"531";"680";"150";"3";"3";"674";"677"
"8";"Barcelona";"1";"Barcelona";"11";"Baix Llobregat";"08158";"Papiol, el";"1";"1";"B";"928";"262";"563";"716";"212";"5";"6";"705";"711"
"8";"Barcelona";"1";"Barcelona";"11";"Baix Llobregat";"08158";"Papiol, el";"1";"2";"A";"636";"181";"372";"481";"155";"2";"5";"474";"479"
"8";"Barcelona";"1";"Barcelona";"11";"Baix Llobregat";"08158";"Papiol, el";"1";"2";"B";"710";"214";"434";"554";"156";"2";"1";"551";"552"
"8";"Barcelona";"1";"Barcelona";"41";"Vallès Oriental";"08159";"Parets del Vallès";"1";"1";"A";"602";"196";"368";"479";"123";"3";"5";"471";"476"
"8";"Barcelona";"1";"Barcelona";"41";"Vallès Oriental";"08159";"Parets del Vallès";"1";"1";"B";"634";"177";"377";"483";"151";"3";"6";"474";"480"
"8";"Barcelona";"1";"Barcelona";"41";"Vallès Oriental";"08159";"Parets del Vallès";"1";"2";"A";"704";"217";"419";"567";"137";"0";"4";"563";"567"
"8";"Barcelona";"1";"Barcelona";"41";"Vallès Oriental";"08159";"Parets del Vallès";"1";"2";"B";"883";"270";"550";"708";"175";"4";"5";"699";"704"
"8";"Barcelona";"1";"Barcelona";"41";"Vallès Oriental";"08159";"Parets del Vallès";"1";"3";"U";"1032";"333";"665";"804";"228";"4";"3";"797";"800"
"8";"Barcelona";"1";"Barcelona";"41";"Vallès Oriental";"08159";"Parets del Vallès";"1";"4";"U";"917";"278";"556";"716";"201";"4";"4";"708";"712"
"8";"Barcelona";"1";"Barcelona";"41";"Vallès Oriental";"08159";"Parets del Vallès";"2";"1";"U";"1001";"265";"613";"757";"244";"1";"1";"755";"756"
"8";"Barcelona";"1";"Barcelona";"41";"Vallès Oriental";"08159";"Parets del Vallès";"2";"2";"U";"906";"275";"532";"703";"203";"1";"5";"697";"702"
"8";"Barcelona";"1";"Barcelona";"41";"Vallès Oriental";"08159";"Parets del Vallès";"2";"3";"A";"843";"263";"500";"651";"192";"5";"1";"645";"646"
"8";"Barcelona";"1";"Barcelona";"41";"Vallès Oriental";"08159";"Parets del Vallès";"2";"3";"B";"927";"273";"515";"683";"244";"1";"3";"679";"682"
"8";"Barcelona";"1";"Barcelona";"41";"Vallès Oriental";"08159";"Parets del Vallès";"2";"4";"A";"548";"189";"333";"422";"126";"2";"2";"418";"420"
"8";"Barcelona";"1";"Barcelona";"41";"Vallès Oriental";"08159";"Parets del Vallès";"2";"4";"B";"693";"244";"436";"542";"151";"3";"5";"534";"539"
"8";"Barcelona";"1";"Barcelona";"41";"Vallès Oriental";"08159";"Parets del Vallès";"2";"5";"A";"455";"181";"307";"379";"76";"2";"0";"377";"377"
"8";"Barcelona";"1";"Barcelona";"41";"Vallès Oriental";"08159";"Parets del Vallès";"2";"5";"B";"534";"207";"369";"447";"87";"2";"0";"445";"445"
"8";"Barcelona";"1";"Barcelona";"41";"Vallès Oriental";"08159";"Parets del Vallès";"2";"6";"A";"851";"255";"601";"656";"195";"2";"4";"650";"654"
"8";"Barcelona";"1";"Barcelona";"41";"Vallès Oriental";"08159";"Parets del Vallès";"2";"6";"B";"988";"252";"516";"787";"201";"1";"1";"785";"786"
"8";"Barcelona";"1";"Barcelona";"41";"Vallès Oriental";"08159";"Parets del Vallès";"2";"7";"A";"695";"223";"465";"575";"120";"0";"1";"574";"575"
"8";"Barcelona";"1";"Barcelona";"41";"Vallès Oriental";"08159";"Parets del Vallès";"2";"7";"B";"850";"296";"573";"710";"140";"2";"3";"705";"708"
"8";"Barcelona";"1";"Barcelona";"21";"Maresme";"08163";"Pineda de Mar";"1";"1";"A";"730";"365";"449";"545";"185";"2";"3";"540";"543"
"8";"Barcelona";"1";"Barcelona";"21";"Maresme";"08163";"Pineda de Mar";"1";"1";"B";"846";"318";"544";"643";"203";"1";"2";"640";"642"
"8";"Barcelona";"1";"Barcelona";"21";"Maresme";"08163";"Pineda de Mar";"1";"10";"A";"482";"182";"297";"366";"116";"0";"2";"364";"366"
"8";"Barcelona";"1";"Barcelona";"21";"Maresme";"08163";"Pineda de Mar";"1";"10";"B";"570";"197";"345";"409";"161";"0";"0";"409";"409"
"8";"Barcelona";"1";"Barcelona";"21";"Maresme";"08163";"Pineda de Mar";"1";"11";"A";"482";"194";"298";"373";"109";"1";"5";"367";"372"
"8";"Barcelona";"1";"Barcelona";"21";"Maresme";"08163";"Pineda de Mar";"1";"11";"B";"607";"245";"384";"478";"129";"1";"3";"474";"477"
"8";"Barcelona";"1";"Barcelona";"21";"Maresme";"08163";"Pineda de Mar";"1";"12";"A";"493";"173";"281";"348";"145";"1";"1";"346";"347"
"8";"Barcelona";"1";"Barcelona";"21";"Maresme";"08163";"Pineda de Mar";"1";"12";"B";"552";"204";"328";"401";"151";"1";"0";"400";"400"
"8";"Barcelona";"1";"Barcelona";"21";"Maresme";"08163";"Pineda de Mar";"1";"13";"A";"604";"240";"391";"462";"142";"1";"3";"458";"461"
"8";"Barcelona";"1";"Barcelona";"21";"Maresme";"08163";"Pineda de Mar";"1";"13";"B";"771";"318";"511";"606";"165";"5";"2";"599";"601"
"8";"Barcelona";"1";"Barcelona";"21";"Maresme";"08163";"Pineda de Mar";"1";"14";"A";"579";"227";"350";"411";"168";"1";"3";"407";"410"
"8";"Barcelona";"1";"Barcelona";"21";"Maresme";"08163";"Pineda de Mar";"1";"14";"B";"715";"272";"424";"512";"203";"6";"1";"505";"506"
"8";"Barcelona";"1";"Barcelona";"21";"Maresme";"08163";"Pineda de Mar";"1";"2";"A";"776";"298";"516";"567";"209";"3";"2";"562";"564"
"8";"Barcelona";"1";"Barcelona";"21";"Maresme";"08163";"Pineda de Mar";"1";"2";"B";"793";"295";"506";"601";"192";"3";"0";"598";"598"
"8";"Barcelona";"1";"Barcelona";"21";"Maresme";"08163";"Pineda de Mar";"1";"3";"A";"551";"204";"347";"414";"137";"2";"1";"411";"412"
"8";"Barcelona";"1";"Barcelona";"21";"Maresme";"08163";"Pineda de Mar";"1";"3";"B";"671";"260";"432";"521";"150";"0";"3";"518";"521"
"8";"Barcelona";"1";"Barcelona";"21";"Maresme";"08163";"Pineda de Mar";"1";"4";"A";"648";"223";"365";"475";"173";"0";"4";"471";"475"
"8";"Barcelona";"1";"Barcelona";"21";"Maresme";"08163";"Pineda de Mar";"1";"4";"B";"726";"279";"449";"526";"200";"1";"2";"523";"525"
"8";"Barcelona";"1";"Barcelona";"21";"Maresme";"08163";"Pineda de Mar";"1";"4";"C";"683";"260";"419";"497";"186";"0";"1";"496";"497"
"8";"Barcelona";"1";"Barcelona";"21";"Maresme";"08163";"Pineda de Mar";"1";"5";"A";"510";"180";"306";"391";"119";"2";"3";"386";"389"
"8";"Barcelona";"1";"Barcelona";"21";"Maresme";"08163";"Pineda de Mar";"1";"5";"B";"613";"215";"357";"438";"175";"2";"0";"436";"436"
"8";"Barcelona";"1";"Barcelona";"21";"Maresme";"08163";"Pineda de Mar";"1";"6";"A";"493";"206";"300";"354";"139";"0";"2";"352";"354"
"8";"Barcelona";"1";"Barcelona";"21";"Maresme";"08163";"Pineda de Mar";"1";"6";"B";"608";"245";"386";"447";"161";"1";"1";"445";"446"
"8";"Barcelona";"1";"Barcelona";"21";"Maresme";"08163";"Pineda de Mar";"1";"7";"A";"749";"287";"473";"561";"188";"0";"3";"558";"561"
"8";"Barcelona";"1";"Barcelona";"21";"Maresme";"08163";"Pineda de Mar";"1";"7";"B";"886";"364";"571";"690";"196";"1";"3";"686";"689"
"8";"Barcelona";"1";"Barcelona";"21";"Maresme";"08163";"Pineda de Mar";"1";"8";"A";"449";"157";"256";"323";"126";"0";"4";"319";"323"
"8";"Barcelona";"1";"Barcelona";"21";"Maresme";"08163";"Pineda de Mar";"1";"8";"B";"533";"210";"328";"408";"125";"3";"3";"402";"405"
"8";"Barcelona";"1";"Barcelona";"21";"Maresme";"08163";"Pineda de Mar";"1";"9";"A";"731";"242";"412";"539";"192";"0";"3";"536";"539"
"8";"Barcelona";"1";"Barcelona";"21";"Maresme";"08163";"Pineda de Mar";"1";"9";"B";"726";"249";"440";"541";"185";"0";"3";"538";"541"
"8";"Barcelona";"1";"Barcelona";"3";"Alt Penedès";"08164";"Pla del Penedès, el";"1";"1";"U";"911";"343";"701";"770";"141";"1";"2";"767";"769"
"8";"Barcelona";"1";"Barcelona";"40";"Vallès Occidental";"08167";"Polinyà";"1";"1";"A";"424";"164";"283";"354";"70";"4";"3";"347";"350"
"8";"Barcelona";"1";"Barcelona";"40";"Vallès Occidental";"08167";"Polinyà";"1";"1";"B";"463";"171";"294";"365";"98";"0";"2";"363";"365"
"8";"Barcelona";"1";"Barcelona";"40";"Vallès Occidental";"08167";"Polinyà";"1";"1";"C";"601";"213";"366";"467";"134";"1";"2";"464";"466"
"8";"Barcelona";"1";"Barcelona";"40";"Vallès Occidental";"08167";"Polinyà";"1";"1";"D";"546";"237";"367";"449";"97";"0";"2";"447";"449"
"8";"Barcelona";"1";"Barcelona";"40";"Vallès Occidental";"08167";"Polinyà";"1";"2";"A";"471";"167";"268";"346";"125";"1";"0";"345";"345"
"8";"Barcelona";"1";"Barcelona";"40";"Vallès Occidental";"08167";"Polinyà";"1";"2";"B";"655";"233";"376";"470";"185";"3";"4";"463";"467"
"8";"Barcelona";"1";"Barcelona";"40";"Vallès Occidental";"08167";"Polinyà";"1";"3";"A";"637";"279";"379";"523";"114";"1";"6";"516";"522"
"8";"Barcelona";"1";"Barcelona";"40";"Vallès Occidental";"08167";"Polinyà";"1";"3";"B";"744";"264";"476";"623";"121";"2";"8";"613";"621"
"8";"Barcelona";"1";"Barcelona";"40";"Vallès Occidental";"08167";"Polinyà";"1";"4";"A";"608";"204";"377";"491";"117";"0";"2";"489";"491"
"8";"Barcelona";"1";"Barcelona";"40";"Vallès Occidental";"08167";"Polinyà";"1";"4";"B";"720";"258";"478";"603";"117";"1";"4";"598";"602"
"8";"Barcelona";"1";"Barcelona";"3";"Alt Penedès";"08168";"Pontons";"1";"1";"U";"380";"137";"237";"282";"98";"2";"3";"277";"280"
"8";"Barcelona";"1";"Barcelona";"11";"Baix Llobregat";"08169";"Prat de Llobregat, el";"1";"1";"A";"613";"211";"372";"488";"125";"3";"2";"483";"485"
"8";"Barcelona";"1";"Barcelona";"11";"Baix Llobregat";"08169";"Prat de Llobregat, el";"1";"1";"B";"779";"257";"475";"605";"174";"2";"1";"602";"603"
"8";"Barcelona";"1";"Barcelona";"11";"Baix Llobregat";"08169";"Prat de Llobregat, el";"1";"2";"A";"672";"227";"423";"532";"140";"0";"3";"529";"532"
"8";"Barcelona";"1";"Barcelona";"11";"Baix Llobregat";"08169";"Prat de Llobregat, el";"1";"2";"B";"733";"285";"481";"589";"144";"3";"2";"584";"586"
"8";"Barcelona";"1";"Barcelona";"11";"Baix Llobregat";"08169";"Prat de Llobregat, el";"1";"3";"A";"433";"152";"287";"349";"84";"1";"2";"346";"348"
"8";"Barcelona";"1";"Barcelona";"11";"Baix Llobregat";"08169";"Prat de Llobregat, el";"1";"3";"B";"560";"187";"351";"440";"120";"1";"2";"437";"439"
"8";"Barcelona";"1";"Barcelona";"11";"Baix Llobregat";"08169";"Prat de Llobregat, el";"1";"4";"A";"627";"241";"393";"448";"179";"1";"6";"441";"447"
"8";"Barcelona";"1";"Barcelona";"11";"Baix Llobregat";"08169";"Prat de Llobregat, el";"1";"4";"B";"710";"279";"447";"540";"170";"3";"5";"532";"537"
"8";"Barcelona";"1";"Barcelona";"11";"Baix Llobregat";"08169";"Prat de Llobregat, el";"1";"5";"A";"552";"201";"297";"401";"151";"1";"2";"398";"400"
"8";"Barcelona";"1";"Barcelona";"11";"Baix Llobregat";"08169";"Prat de Llobregat, el";"1";"5";"B";"614";"198";"336";"437";"177";"2";"4";"431";"435"
"8";"Barcelona";"1";"Barcelona";"11";"Baix Llobregat";"08169";"Prat de Llobregat, el";"2";"1";"A";"583";"225";"426";"449";"134";"1";"2";"446";"448"
"8";"Barcelona";"1";"Barcelona";"11";"Baix Llobregat";"08169";"Prat de Llobregat, el";"2";"1";"B";"673";"280";"380";"507";"166";"1";"2";"504";"506"
"8";"Barcelona";"1";"Barcelona";"11";"Baix Llobregat";"08169";"Prat de Llobregat, el";"2";"2";"A";"717";"276";"454";"572";"145";"3";"6";"563";"569"
"8";"Barcelona";"1";"Barcelona";"11";"Baix Llobregat";"08169";"Prat de Llobregat, el";"2";"2";"B";"832";"272";"502";"649";"183";"1";"8";"640";"648"
"8";"Barcelona";"1";"Barcelona";"11";"Baix Llobregat";"08169";"Prat de Llobregat, el";"2";"3";"A";"465";"153";"285";"332";"133";"0";"0";"332";"332"
"8";"Barcelona";"1";"Barcelona";"11";"Baix Llobregat";"08169";"Prat de Llobregat, el";"2";"3";"B";"515";"177";"317";"387";"128";"0";"4";"383";"387"
"8";"Barcelona";"1";"Barcelona";"11";"Baix Llobregat";"08169";"Prat de Llobregat, el";"2";"4";"A";"632";"195";"356";"475";"157";"1";"0";"474";"474"
"8";"Barcelona";"1";"Barcelona";"11";"Baix Llobregat";"08169";"Prat de Llobregat, el";"2";"4";"B";"746";"221";"428";"557";"189";"4";"4";"549";"553"
"8";"Barcelona";"1";"Barcelona";"11";"Baix Llobregat";"08169";"Prat de Llobregat, el";"2";"5";"A";"653";"219";"396";"482";"171";"1";"0";"481";"481"
"8";"Barcelona";"1";"Barcelona";"11";"Baix Llobregat";"08169";"Prat de Llobregat, el";"2";"5";"B";"682";"212";"412";"507";"175";"0";"2";"505";"507"
"8";"Barcelona";"1";"Barcelona";"11";"Baix Llobregat";"08169";"Prat de Llobregat, el";"2";"6";"A";"822";"287";"560";"683";"139";"0";"5";"678";"683"
"8";"Barcelona";"1";"Barcelona";"11";"Baix Llobregat";"08169";"Prat de Llobregat, el";"2";"6";"B";"869";"329";"590";"728";"141";"4";"2";"722";"724"
"8";"Barcelona";"1";"Barcelona";"11";"Baix Llobregat";"08169";"Prat de Llobregat, el";"2";"7";"A";"707";"261";"450";"575";"132";"4";"1";"570";"571"
"8";"Barcelona";"1";"Barcelona";"11";"Baix Llobregat";"08169";"Prat de Llobregat, el";"2";"7";"B";"728";"289";"470";"606";"122";"3";"4";"599";"603"
"8";"Barcelona";"1";"Barcelona";"11";"Baix Llobregat";"08169";"Prat de Llobregat, el";"3";"1";"A";"536";"184";"354";"425";"111";"1";"5";"419";"424"
"8";"Barcelona";"1";"Barcelona";"11";"Baix Llobregat";"08169";"Prat de Llobregat, el";"3";"1";"B";"569";"225";"396";"471";"98";"1";"3";"467";"470"
"8";"Barcelona";"1";"Barcelona";"11";"Baix Llobregat";"08169";"Prat de Llobregat, el";"3";"10";"A";"696";"227";"410";"537";"159";"2";"0";"535";"535"
"8";"Barcelona";"1";"Barcelona";"11";"Baix Llobregat";"08169";"Prat de Llobregat, el";"3";"10";"B";"671";"232";"403";"512";"159";"0";"4";"508";"512"
"8";"Barcelona";"1";"Barcelona";"11";"Baix Llobregat";"08169";"Prat de Llobregat, el";"3";"11";"U";"918";"254";"556";"725";"193";"3";"3";"719";"722"
"8";"Barcelona";"1";"Barcelona";"11";"Baix Llobregat";"08169";"Prat de Llobregat, el";"3";"12";"U";"513";"184";"311";"419";"94";"1";"0";"418";"418"
"8";"Barcelona";"1";"Barcelona";"11";"Baix Llobregat";"08169";"Prat de Llobregat, el";"3";"13";"U";"595";"174";"350";"466";"129";"1";"3";"462";"465"
"8";"Barcelona";"1";"Barcelona";"11";"Baix Llobregat";"08169";"Prat de Llobregat, el";"3";"2";"U";"771";"238";"426";"587";"184";"1";"4";"582";"586"
"8";"Barcelona";"1";"Barcelona";"11";"Baix Llobregat";"08169";"Prat de Llobregat, el";"3";"3";"A";"603";"213";"367";"462";"141";"2";"1";"459";"460"
"8";"Barcelona";"1";"Barcelona";"11";"Baix Llobregat";"08169";"Prat de Llobregat, el";"3";"3";"B";"632";"208";"382";"484";"148";"2";"2";"480";"482"
"8";"Barcelona";"1";"Barcelona";"11";"Baix Llobregat";"08169";"Prat de Llobregat, el";"3";"4";"A";"520";"174";"292";"376";"144";"4";"0";"372";"372"
"8";"Barcelona";"1";"Barcelona";"11";"Baix Llobregat";"08169";"Prat de Llobregat, el";"3";"4";"B";"598";"212";"346";"432";"166";"4";"1";"427";"428"
"8";"Barcelona";"1";"Barcelona";"11";"Baix Llobregat";"08169";"Prat de Llobregat, el";"3";"5";"A";"783";"228";"467";"597";"186";"4";"6";"587";"593"
"8";"Barcelona";"1";"Barcelona";"11";"Baix Llobregat";"08169";"Prat de Llobregat, el";"3";"5";"B";"799";"374";"520";"619";"180";"5";"4";"610";"614"
"8";"Barcelona";"1";"Barcelona";"11";"Baix Llobregat";"08169";"Prat de Llobregat, el";"3";"6";"A";"488";"164";"267";"364";"124";"0";"2";"362";"364"
"8";"Barcelona";"1";"Barcelona";"11";"Baix Llobregat";"08169";"Prat de Llobregat, el";"3";"6";"B";"555";"199";"330";"418";"137";"0";"2";"416";"418"
"8";"Barcelona";"1";"Barcelona";"11";"Baix Llobregat";"08169";"Prat de Llobregat, el";"3";"7";"A";"700";"360";"450";"559";"141";"2";"3";"554";"557"
"8";"Barcelona";"1";"Barcelona";"11";"Baix Llobregat";"08169";"Prat de Llobregat, el";"3";"7";"B";"808";"279";"493";"642";"166";"1";"2";"639";"641"
"8";"Barcelona";"1";"Barcelona";"11";"Baix Llobregat";"08169";"Prat de Llobregat, el";"3";"8";"A";"744";"231";"433";"538";"206";"1";"0";"537";"537"
"8";"Barcelona";"1";"Barcelona";"11";"Baix Llobregat";"08169";"Prat de Llobregat, el";"3";"8";"B";"916";"275";"498";"646";"270";"1";"6";"639";"645"
"8";"Barcelona";"1";"Barcelona";"11";"Baix Llobregat";"08169";"Prat de Llobregat, el";"3";"9";"A";"846";"279";"515";"647";"199";"2";"4";"641";"645"
"8";"Barcelona";"1";"Barcelona";"11";"Baix Llobregat";"08169";"Prat de Llobregat, el";"3";"9";"B";"851";"260";"493";"632";"219";"1";"1";"630";"631"
"8";"Barcelona";"1";"Barcelona";"11";"Baix Llobregat";"08169";"Prat de Llobregat, el";"4";"1";"U";"737";"204";"400";"530";"207";"0";"1";"529";"530"
"8";"Barcelona";"1";"Barcelona";"11";"Baix Llobregat";"08169";"Prat de Llobregat, el";"4";"2";"A";"690";"221";"359";"446";"244";"0";"1";"445";"446"
"8";"Barcelona";"1";"Barcelona";"11";"Baix Llobregat";"08169";"Prat de Llobregat, el";"4";"2";"B";"817";"239";"416";"514";"303";"2";"2";"510";"512"
"8";"Barcelona";"1";"Barcelona";"11";"Baix Llobregat";"08169";"Prat de Llobregat, el";"4";"3";"A";"473";"137";"233";"282";"191";"1";"0";"281";"281"
"8";"Barcelona";"1";"Barcelona";"11";"Baix Llobregat";"08169";"Prat de Llobregat, el";"4";"3";"B";"550";"189";"308";"366";"184";"0";"2";"364";"366"
"8";"Barcelona";"1";"Barcelona";"11";"Baix Llobregat";"08169";"Prat de Llobregat, el";"4";"4";"U";"944";"271";"422";"535";"409";"0";"0";"535";"535"
"8";"Barcelona";"1";"Barcelona";"11";"Baix Llobregat";"08169";"Prat de Llobregat, el";"4";"5";"A";"464";"140";"228";"272";"192";"0";"1";"271";"272"
"8";"Barcelona";"1";"Barcelona";"11";"Baix Llobregat";"08169";"Prat de Llobregat, el";"4";"5";"B";"501";"143";"259";"313";"188";"1";"0";"312";"312"
"8";"Barcelona";"1";"Barcelona";"11";"Baix Llobregat";"08169";"Prat de Llobregat, el";"4";"6";"U";"806";"79";"153";"215";"591";"1";"0";"214";"214"
"8";"Barcelona";"1";"Barcelona";"11";"Baix Llobregat";"08169";"Prat de Llobregat, el";"5";"1";"A";"467";"176";"291";"347";"120";"1";"3";"343";"346"
"8";"Barcelona";"1";"Barcelona";"11";"Baix Llobregat";"08169";"Prat de Llobregat, el";"5";"1";"B";"478";"179";"295";"367";"111";"0";"2";"365";"367"
"8";"Barcelona";"1";"Barcelona";"11";"Baix Llobregat";"08169";"Prat de Llobregat, el";"5";"2";"A";"453";"162";"273";"355";"98";"0";"0";"355";"355"
"8";"Barcelona";"1";"Barcelona";"11";"Baix Llobregat";"08169";"Prat de Llobregat, el";"5";"2";"B";"511";"173";"307";"402";"109";"1";"0";"401";"401"
"8";"Barcelona";"1";"Barcelona";"11";"Baix Llobregat";"08169";"Prat de Llobregat, el";"5";"3";"A";"441";"139";"247";"321";"120";"0";"2";"319";"321"
"8";"Barcelona";"1";"Barcelona";"11";"Baix Llobregat";"08169";"Prat de Llobregat, el";"5";"3";"B";"494";"179";"272";"351";"143";"0";"0";"351";"351"
"8";"Barcelona";"1";"Barcelona";"11";"Baix Llobregat";"08169";"Prat de Llobregat, el";"5";"4";"A";"653";"233";"428";"556";"97";"0";"1";"555";"556"
"8";"Barcelona";"1";"Barcelona";"11";"Baix Llobregat";"08169";"Prat de Llobregat, el";"5";"4";"B";"733";"270";"480";"593";"140";"0";"2";"591";"593"
"8";"Barcelona";"1";"Barcelona";"11";"Baix Llobregat";"08169";"Prat de Llobregat, el";"5";"5";"A";"639";"227";"375";"491";"148";"1";"2";"488";"490"
"8";"Barcelona";"1";"Barcelona";"11";"Baix Llobregat";"08169";"Prat de Llobregat, el";"5";"5";"B";"721";"254";"463";"578";"143";"2";"2";"574";"576"
"8";"Barcelona";"1";"Barcelona";"11";"Baix Llobregat";"08169";"Prat de Llobregat, el";"5";"6";"A";"707";"242";"422";"538";"169";"1";"4";"533";"537"
"8";"Barcelona";"1";"Barcelona";"11";"Baix Llobregat";"08169";"Prat de Llobregat, el";"5";"6";"B";"776";"263";"456";"607";"169";"3";"4";"600";"604"
"8";"Barcelona";"1";"Barcelona";"11";"Baix Llobregat";"08169";"Prat de Llobregat, el";"5";"7";"A";"738";"312";"454";"551";"187";"2";"4";"545";"549"
"8";"Barcelona";"1";"Barcelona";"11";"Baix Llobregat";"08169";"Prat de Llobregat, el";"5";"7";"B";"796";"296";"471";"592";"204";"5";"4";"583";"587"
"8";"Barcelona";"1";"Barcelona";"11";"Baix Llobregat";"08169";"Prat de Llobregat, el";"5";"8";"A";"754";"275";"474";"601";"153";"0";"0";"601";"601"
"8";"Barcelona";"1";"Barcelona";"11";"Baix Llobregat";"08169";"Prat de Llobregat, el";"5";"8";"B";"871";"303";"518";"712";"159";"2";"2";"708";"710"
"8";"Barcelona";"1";"Barcelona";"11";"Baix Llobregat";"08169";"Prat de Llobregat, el";"5";"9";"U";"619";"196";"368";"479";"140";"1";"7";"471";"478"
"8";"Barcelona";"1";"Barcelona";"21";"Maresme";"08230";"Premià de Dalt";"1";"1";"A";"863";"278";"621";"755";"108";"1";"7";"747";"754"
"8";"Barcelona";"1";"Barcelona";"21";"Maresme";"08230";"Premià de Dalt";"1";"1";"B";"961";"308";"661";"822";"139";"2";"3";"817";"820"
"8";"Barcelona";"1";"Barcelona";"21";"Maresme";"08230";"Premià de Dalt";"1";"2";"A";"633";"258";"449";"525";"108";"1";"6";"518";"524"
"8";"Barcelona";"1";"Barcelona";"21";"Maresme";"08230";"Premià de Dalt";"1";"2";"B";"832";"356";"609";"693";"139";"1";"2";"690";"692"
"8";"Barcelona";"1";"Barcelona";"21";"Maresme";"08230";"Premià de Dalt";"1";"3";"A";"484";"188";"316";"359";"125";"1";"2";"356";"358"
"8";"Barcelona";"1";"Barcelona";"21";"Maresme";"08230";"Premià de Dalt";"1";"3";"B";"588";"222";"345";"428";"160";"3";"1";"424";"425"
"8";"Barcelona";"1";"Barcelona";"21";"Maresme";"08230";"Premià de Dalt";"1";"4";"A";"695";"253";"453";"572";"123";"0";"2";"570";"572"
"8";"Barcelona";"1";"Barcelona";"21";"Maresme";"08230";"Premià de Dalt";"1";"4";"B";"629";"247";"429";"527";"102";"2";"1";"524";"525"
"8";"Barcelona";"1";"Barcelona";"21";"Maresme";"08230";"Premià de Dalt";"1";"5";"U";"697";"254";"426";"525";"172";"0";"3";"522";"525"
"8";"Barcelona";"1";"Barcelona";"21";"Maresme";"08230";"Premià de Dalt";"1";"6";"A";"533";"228";"380";"459";"74";"0";"0";"459";"459"
"8";"Barcelona";"1";"Barcelona";"21";"Maresme";"08230";"Premià de Dalt";"1";"6";"B";"693";"274";"471";"591";"102";"0";"1";"590";"591"
"8";"Barcelona";"1";"Barcelona";"21";"Maresme";"08172";"Premià de Mar";"1";"1";"A";"908";"371";"618";"758";"150";"1";"4";"753";"757"
"8";"Barcelona";"1";"Barcelona";"21";"Maresme";"08172";"Premià de Mar";"1";"1";"B";"927";"370";"612";"757";"170";"3";"1";"753";"754"
"8";"Barcelona";"1";"Barcelona";"21";"Maresme";"08172";"Premià de Mar";"1";"2";"A";"779";"310";"554";"644";"135";"1";"3";"640";"643"
"8";"Barcelona";"1";"Barcelona";"21";"Maresme";"08172";"Premià de Mar";"1";"2";"B";"871";"295";"602";"737";"134";"2";"5";"730";"735"
"8";"Barcelona";"1";"Barcelona";"21";"Maresme";"08172";"Premià de Mar";"1";"3";"A";"893";"321";"567";"712";"181";"4";"7";"701";"708"
"8";"Barcelona";"1";"Barcelona";"21";"Maresme";"08172";"Premià de Mar";"1";"3";"B";"1024";"294";"650";"814";"210";"2";"4";"808";"812"
"8";"Barcelona";"1";"Barcelona";"21";"Maresme";"08172";"Premià de Mar";"2";"1";"A";"654";"247";"461";"544";"110";"2";"2";"540";"542"
"8";"Barcelona";"1";"Barcelona";"21";"Maresme";"08172";"Premià de Mar";"2";"1";"B";"822";"303";"579";"678";"144";"5";"1";"672";"673"
"8";"Barcelona";"1";"Barcelona";"21";"Maresme";"08172";"Premià de Mar";"2";"2";"A";"676";"223";"420";"473";"203";"2";"3";"468";"471"
"8";"Barcelona";"1";"Barcelona";"21";"Maresme";"08172";"Premià de Mar";"2";"2";"B";"832";"301";"536";"631";"201";"3";"2";"626";"628"
"8";"Barcelona";"1";"Barcelona";"21";"Maresme";"08172";"Premià de Mar";"2";"3";"A";"571";"230";"363";"432";"139";"4";"1";"427";"428"
"8";"Barcelona";"1";"Barcelona";"21";"Maresme";"08172";"Premià de Mar";"2";"3";"B";"678";"255";"440";"526";"152";"3";"1";"522";"523"
"8";"Barcelona";"1";"Barcelona";"21";"Maresme";"08172";"Premià de Mar";"2";"4";"A";"540";"160";"310";"377";"163";"0";"2";"375";"377"
"8";"Barcelona";"1";"Barcelona";"21";"Maresme";"08172";"Premià de Mar";"2";"4";"B";"599";"198";"343";"417";"182";"3";"2";"412";"414"
"8";"Barcelona";"1";"Barcelona";"21";"Maresme";"08172";"Premià de Mar";"3";"1";"A";"549";"174";"362";"434";"115";"0";"0";"434";"434"
"8";"Barcelona";"1";"Barcelona";"21";"Maresme";"08172";"Premià de Mar";"3";"1";"B";"653";"211";"422";"506";"147";"0";"0";"506";"506"
"8";"Barcelona";"1";"Barcelona";"21";"Maresme";"08172";"Premià de Mar";"3";"2";"A";"511";"158";"287";"373";"138";"4";"2";"367";"369"
"8";"Barcelona";"1";"Barcelona";"21";"Maresme";"08172";"Premià de Mar";"3";"2";"B";"546";"177";"316";"399";"147";"0";"4";"395";"399"
"8";"Barcelona";"1";"Barcelona";"21";"Maresme";"08172";"Premià de Mar";"3";"3";"U";"913";"401";"617";"711";"202";"1";"1";"709";"710"
"8";"Barcelona";"1";"Barcelona";"21";"Maresme";"08172";"Premià de Mar";"3";"4";"A";"597";"246";"363";"454";"143";"1";"1";"452";"453"
"8";"Barcelona";"1";"Barcelona";"21";"Maresme";"08172";"Premià de Mar";"3";"4";"B";"690";"273";"463";"560";"130";"0";"1";"559";"560"
"8";"Barcelona";"1";"Barcelona";"21";"Maresme";"08172";"Premià de Mar";"3";"5";"U";"962";"295";"548";"669";"293";"6";"7";"656";"663"
"8";"Barcelona";"1";"Barcelona";"21";"Maresme";"08172";"Premià de Mar";"3";"6";"A";"508";"184";"334";"398";"110";"3";"1";"394";"395"
"8";"Barcelona";"1";"Barcelona";"21";"Maresme";"08172";"Premià de Mar";"3";"6";"B";"651";"252";"457";"539";"112";"3";"1";"535";"536"
"8";"Barcelona";"1";"Barcelona";"21";"Maresme";"08172";"Premià de Mar";"3";"7";"U";"1092";"235";"494";"874";"218";"4";"7";"863";"870"
"8";"Barcelona";"1";"Barcelona";"21";"Maresme";"08172";"Premià de Mar";"3";"8";"U";"857";"275";"646";"693";"164";"2";"4";"687";"691"
"8";"Barcelona";"1";"Barcelona";"21";"Maresme";"08172";"Premià de Mar";"3";"9";"A";"501";"198";"333";"412";"89";"0";"0";"412";"412"
"8";"Barcelona";"1";"Barcelona";"21";"Maresme";"08172";"Premià de Mar";"3";"9";"B";"599";"234";"411";"483";"116";"0";"1";"482";"483"
"8";"Barcelona";"1";"Barcelona";"3";"Alt Penedès";"08174";"Puigdàlber";"1";"1";"U";"398";"170";"282";"341";"57";"1";"2";"338";"340"
"8";"Barcelona";"1";"Barcelona";"40";"Vallès Occidental";"08179";"Rellinars";"1";"1";"U";"583";"193";"387";"475";"108";"1";"4";"470";"474"
"8";"Barcelona";"1";"Barcelona";"40";"Vallès Occidental";"08180";"Ripollet";"1";"1";"A";"649";"200";"405";"500";"149";"1";"8";"491";"499"
"8";"Barcelona";"1";"Barcelona";"40";"Vallès Occidental";"08180";"Ripollet";"1";"1";"B";"771";"245";"470";"606";"165";"1";"2";"603";"605"
"8";"Barcelona";"1";"Barcelona";"40";"Vallès Occidental";"08180";"Ripollet";"1";"10";"A";"469";"143";"306";"386";"83";"1";"0";"385";"385"
"8";"Barcelona";"1";"Barcelona";"40";"Vallès Occidental";"08180";"Ripollet";"1";"10";"B";"498";"154";"324";"403";"95";"2";"4";"397";"401"
"8";"Barcelona";"1";"Barcelona";"40";"Vallès Occidental";"08180";"Ripollet";"1";"11";"A";"695";"221";"433";"586";"109";"1";"6";"579";"585"
"8";"Barcelona";"1";"Barcelona";"40";"Vallès Occidental";"08180";"Ripollet";"1";"11";"B";"880";"273";"558";"731";"149";"3";"3";"725";"728"
"8";"Barcelona";"1";"Barcelona";"40";"Vallès Occidental";"08180";"Ripollet";"1";"12";"A";"528";"170";"358";"444";"84";"0";"3";"441";"444"
"8";"Barcelona";"1";"Barcelona";"40";"Vallès Occidental";"08180";"Ripollet";"1";"12";"B";"631";"216";"421";"518";"113";"3";"1";"514";"515"
"8";"Barcelona";"1";"Barcelona";"40";"Vallès Occidental";"08180";"Ripollet";"1";"13";"A";"713";"260";"480";"604";"109";"0";"3";"601";"604"
"8";"Barcelona";"1";"Barcelona";"40";"Vallès Occidental";"08180";"Ripollet";"1";"13";"B";"835";"278";"523";"694";"141";"1";"3";"690";"693"
"8";"Barcelona";"1";"Barcelona";"40";"Vallès Occidental";"08180";"Ripollet";"1";"2";"A";"640";"287";"395";"506";"134";"2";"1";"503";"504"
"8";"Barcelona";"1";"Barcelona";"40";"Vallès Occidental";"08180";"Ripollet";"1";"2";"B";"788";"380";"540";"642";"146";"2";"4";"636";"640"
"8";"Barcelona";"1";"Barcelona";"40";"Vallès Occidental";"08180";"Ripollet";"1";"3";"A";"569";"250";"364";"443";"126";"0";"1";"442";"443"
"8";"Barcelona";"1";"Barcelona";"40";"Vallès Occidental";"08180";"Ripollet";"1";"3";"B";"727";"301";"436";"546";"181";"3";"5";"538";"543"
"8";"Barcelona";"1";"Barcelona";"40";"Vallès Occidental";"08180";"Ripollet";"1";"4";"A";"656";"262";"372";"473";"183";"2";"5";"466";"471"
"8";"Barcelona";"1";"Barcelona";"40";"Vallès Occidental";"08180";"Ripollet";"1";"4";"B";"747";"281";"445";"573";"174";"0";"5";"568";"573"
"8";"Barcelona";"1";"Barcelona";"40";"Vallès Occidental";"08180";"Ripollet";"1";"5";"A";"685";"204";"382";"506";"179";"2";"2";"502";"504"
"8";"Barcelona";"1";"Barcelona";"40";"Vallès Occidental";"08180";"Ripollet";"1";"5";"B";"862";"216";"460";"648";"214";"1";"3";"644";"647"
"8";"Barcelona";"1";"Barcelona";"40";"Vallès Occidental";"08180";"Ripollet";"1";"6";"A";"526";"187";"296";"378";"148";"1";"2";"375";"377"
"8";"Barcelona";"1";"Barcelona";"40";"Vallès Occidental";"08180";"Ripollet";"1";"6";"B";"638";"223";"374";"459";"179";"1";"1";"457";"458"
"8";"Barcelona";"1";"Barcelona";"40";"Vallès Occidental";"08180";"Ripollet";"1";"7";"A";"754";"264";"443";"534";"220";"0";"1";"533";"534"
"8";"Barcelona";"1";"Barcelona";"40";"Vallès Occidental";"08180";"Ripollet";"1";"7";"B";"855";"306";"524";"637";"218";"3";"0";"634";"634"
"8";"Barcelona";"1";"Barcelona";"40";"Vallès Occidental";"08180";"Ripollet";"1";"8";"A";"530";"174";"304";"392";"138";"3";"2";"387";"389"
"8";"Barcelona";"1";"Barcelona";"40";"Vallès Occidental";"08180";"Ripollet";"1";"8";"B";"663";"237";"395";"487";"176";"1";"0";"486";"486"
"8";"Barcelona";"1";"Barcelona";"40";"Vallès Occidental";"08180";"Ripollet";"1";"8";"C";"579";"213";"328";"434";"145";"0";"5";"429";"434"
"8";"Barcelona";"1";"Barcelona";"40";"Vallès Occidental";"08180";"Ripollet";"1";"9";"A";"574";"223";"370";"459";"115";"2";"3";"454";"457"
"8";"Barcelona";"1";"Barcelona";"40";"Vallès Occidental";"08180";"Ripollet";"1";"9";"B";"662";"241";"446";"572";"90";"3";"4";"565";"569"
"8";"Barcelona";"1";"Barcelona";"40";"Vallès Occidental";"08180";"Ripollet";"2";"1";"A";"535";"187";"323";"409";"126";"4";"0";"405";"405"
"8";"Barcelona";"1";"Barcelona";"40";"Vallès Occidental";"08180";"Ripollet";"2";"1";"B";"669";"242";"405";"523";"146";"1";"3";"519";"522"
"8";"Barcelona";"1";"Barcelona";"40";"Vallès Occidental";"08180";"Ripollet";"2";"2";"A";"705";"261";"433";"536";"169";"0";"3";"533";"536"
"8";"Barcelona";"1";"Barcelona";"40";"Vallès Occidental";"08180";"Ripollet";"2";"2";"B";"765";"268";"490";"596";"169";"0";"5";"591";"596"
"8";"Barcelona";"1";"Barcelona";"40";"Vallès Occidental";"08180";"Ripollet";"2";"3";"A";"604";"263";"361";"450";"154";"2";"1";"447";"448"
"8";"Barcelona";"1";"Barcelona";"40";"Vallès Occidental";"08180";"Ripollet";"2";"3";"B";"565";"242";"347";"434";"131";"1";"4";"429";"433"
"8";"Barcelona";"1";"Barcelona";"40";"Vallès Occidental";"08180";"Ripollet";"2";"3";"C";"414";"183";"248";"316";"98";"0";"2";"314";"316"
"8";"Barcelona";"1";"Barcelona";"40";"Vallès Occidental";"08180";"Ripollet";"2";"4";"A";"576";"186";"360";"446";"130";"0";"4";"442";"446"
"8";"Barcelona";"1";"Barcelona";"40";"Vallès Occidental";"08180";"Ripollet";"2";"4";"B";"675";"212";"422";"530";"145";"0";"2";"528";"530"
"8";"Barcelona";"1";"Barcelona";"40";"Vallès Occidental";"08180";"Ripollet";"2";"5";"A";"410";"127";"233";"268";"142";"0";"0";"268";"268"
"8";"Barcelona";"1";"Barcelona";"40";"Vallès Occidental";"08180";"Ripollet";"2";"5";"B";"447";"134";"235";"308";"139";"4";"0";"304";"304"
"8";"Barcelona";"1";"Barcelona";"40";"Vallès Occidental";"08180";"Ripollet";"2";"6";"A";"520";"213";"321";"401";"119";"2";"7";"392";"399"
"8";"Barcelona";"1";"Barcelona";"40";"Vallès Occidental";"08180";"Ripollet";"2";"6";"B";"654";"250";"390";"478";"176";"0";"1";"477";"478"
"8";"Barcelona";"1";"Barcelona";"40";"Vallès Occidental";"08180";"Ripollet";"2";"7";"A";"379";"162";"224";"273";"106";"3";"0";"270";"270"
"8";"Barcelona";"1";"Barcelona";"40";"Vallès Occidental";"08180";"Ripollet";"2";"7";"B";"504";"199";"307";"357";"147";"0";"0";"357";"357"
"8";"Barcelona";"1";"Barcelona";"41";"Vallès Oriental";"08181";"Roca del Vallès, la";"1";"1";"A";"503";"209";"350";"428";"75";"0";"5";"423";"428"
"8";"Barcelona";"1";"Barcelona";"41";"Vallès Oriental";"08181";"Roca del Vallès, la";"1";"1";"B";"556";"220";"377";"464";"92";"2";"4";"458";"462"
"8";"Barcelona";"1";"Barcelona";"41";"Vallès Oriental";"08181";"Roca del Vallès, la";"1";"2";"U";"788";"266";"520";"635";"153";"5";"4";"626";"630"
"8";"Barcelona";"1";"Barcelona";"41";"Vallès Oriental";"08181";"Roca del Vallès, la";"1";"3";"A";"621";"213";"391";"507";"114";"0";"0";"507";"507"
"8";"Barcelona";"1";"Barcelona";"41";"Vallès Oriental";"08181";"Roca del Vallès, la";"1";"3";"B";"773";"258";"494";"608";"165";"4";"5";"599";"604"
"8";"Barcelona";"1";"Barcelona";"41";"Vallès Oriental";"08181";"Roca del Vallès, la";"1";"3";"C";"677";"212";"424";"547";"130";"2";"3";"542";"545"
"8";"Barcelona";"1";"Barcelona";"41";"Vallès Oriental";"08181";"Roca del Vallès, la";"1";"4";"A";"786";"271";"500";"622";"164";"2";"5";"615";"620"
"8";"Barcelona";"1";"Barcelona";"41";"Vallès Oriental";"08181";"Roca del Vallès, la";"1";"4";"B";"815";"237";"511";"627";"188";"3";"2";"622";"624"
"8";"Barcelona";"1";"Barcelona";"41";"Vallès Oriental";"08181";"Roca del Vallès, la";"1";"5";"A";"797";"270";"512";"657";"140";"6";"6";"645";"651"
"8";"Barcelona";"1";"Barcelona";"41";"Vallès Oriental";"08181";"Roca del Vallès, la";"1";"5";"B";"801";"291";"550";"660";"141";"4";"8";"648";"656"
"8";"Barcelona";"1";"Barcelona";"41";"Vallès Oriental";"08181";"Roca del Vallès, la";"1";"5";"C";"770";"265";"579";"646";"124";"3";"6";"637";"643"
"8";"Barcelona";"1";"Barcelona";"40";"Vallès Occidental";"08184";"Rubí";"1";"1";"A";"551";"216";"372";"449";"102";"2";"2";"445";"447"
"8";"Barcelona";"1";"Barcelona";"40";"Vallès Occidental";"08184";"Rubí";"1";"1";"B";"719";"277";"496";"574";"145";"1";"2";"571";"573"
"8";"Barcelona";"1";"Barcelona";"40";"Vallès Occidental";"08184";"Rubí";"1";"2";"A";"674";"256";"414";"511";"163";"3";"4";"504";"508"
"8";"Barcelona";"1";"Barcelona";"40";"Vallès Occidental";"08184";"Rubí";"1";"2";"B";"676";"243";"367";"482";"194";"1";"2";"479";"481"
"8";"Barcelona";"1";"Barcelona";"40";"Vallès Occidental";"08184";"Rubí";"1";"3";"A";"503";"198";"329";"402";"101";"0";"3";"399";"402"
"8";"Barcelona";"1";"Barcelona";"40";"Vallès Occidental";"08184";"Rubí";"1";"3";"B";"680";"238";"417";"532";"148";"1";"3";"528";"531"
"8";"Barcelona";"1";"Barcelona";"40";"Vallès Occidental";"08184";"Rubí";"1";"4";"A";"587";"241";"386";"478";"109";"0";"0";"478";"478"
"8";"Barcelona";"1";"Barcelona";"40";"Vallès Occidental";"08184";"Rubí";"1";"4";"B";"674";"281";"447";"556";"118";"1";"0";"555";"555"
"8";"Barcelona";"1";"Barcelona";"40";"Vallès Occidental";"08184";"Rubí";"2";"1";"A";"564";"210";"338";"407";"157";"0";"2";"405";"407"
"8";"Barcelona";"1";"Barcelona";"40";"Vallès Occidental";"08184";"Rubí";"2";"1";"B";"603";"217";"369";"435";"168";"4";"3";"428";"431"
"8";"Barcelona";"1";"Barcelona";"40";"Vallès Occidental";"08184";"Rubí";"2";"1";"C";"624";"235";"403";"481";"143";"2";"5";"474";"479"
"8";"Barcelona";"1";"Barcelona";"40";"Vallès Occidental";"08184";"Rubí";"2";"3";"A";"752";"275";"491";"592";"160";"4";"1";"587";"588"
"8";"Barcelona";"1";"Barcelona";"40";"Vallès Occidental";"08184";"Rubí";"2";"3";"B";"854";"304";"535";"639";"215";"1";"2";"636";"638"
"8";"Barcelona";"1";"Barcelona";"40";"Vallès Occidental";"08184";"Rubí";"2";"4";"A";"717";"249";"470";"555";"162";"3";"3";"549";"552"
"8";"Barcelona";"1";"Barcelona";"40";"Vallès Occidental";"08184";"Rubí";"2";"4";"B";"904";"308";"593";"717";"187";"2";"4";"711";"715"
"8";"Barcelona";"1";"Barcelona";"40";"Vallès Occidental";"08184";"Rubí";"2";"5";"U";"856";"293";"521";"619";"237";"1";"4";"614";"618"
"8";"Barcelona";"1";"Barcelona";"40";"Vallès Occidental";"08184";"Rubí";"2";"6";"A";"687";"213";"426";"493";"194";"3";"2";"488";"490"
"8";"Barcelona";"1";"Barcelona";"40";"Vallès Occidental";"08184";"Rubí";"2";"6";"B";"810";"276";"479";"592";"218";"0";"5";"587";"592"
"8";"Barcelona";"1";"Barcelona";"40";"Vallès Occidental";"08184";"Rubí";"3";"1";"A";"583";"194";"375";"458";"125";"0";"1";"457";"458"
"8";"Barcelona";"1";"Barcelona";"40";"Vallès Occidental";"08184";"Rubí";"3";"1";"B";"745";"267";"478";"584";"161";"1";"7";"576";"583"
"8";"Barcelona";"1";"Barcelona";"40";"Vallès Occidental";"08184";"Rubí";"3";"3";"A";"592";"263";"309";"384";"208";"0";"0";"384";"384"
"8";"Barcelona";"1";"Barcelona";"40";"Vallès Occidental";"08184";"Rubí";"3";"3";"B";"717";"238";"388";"460";"257";"1";"1";"458";"459"
"8";"Barcelona";"1";"Barcelona";"40";"Vallès Occidental";"08184";"Rubí";"3";"4";"A";"612";"196";"342";"428";"184";"4";"1";"423";"424"
"8";"Barcelona";"1";"Barcelona";"40";"Vallès Occidental";"08184";"Rubí";"3";"4";"B";"716";"211";"392";"492";"224";"2";"4";"486";"490"
"8";"Barcelona";"1";"Barcelona";"40";"Vallès Occidental";"08184";"Rubí";"3";"5";"A";"647";"200";"384";"485";"162";"3";"2";"480";"482"
"8";"Barcelona";"1";"Barcelona";"40";"Vallès Occidental";"08184";"Rubí";"3";"5";"B";"795";"261";"471";"570";"225";"3";"4";"563";"567"
"8";"Barcelona";"1";"Barcelona";"40";"Vallès Occidental";"08184";"Rubí";"3";"6";"A";"660";"201";"397";"468";"192";"2";"3";"463";"466"
"8";"Barcelona";"1";"Barcelona";"40";"Vallès Occidental";"08184";"Rubí";"3";"6";"B";"727";"256";"459";"544";"183";"5";"1";"538";"539"
"8";"Barcelona";"1";"Barcelona";"40";"Vallès Occidental";"08184";"Rubí";"3";"7";"A";"578";"206";"375";"452";"126";"8";"0";"444";"444"
"8";"Barcelona";"1";"Barcelona";"40";"Vallès Occidental";"08184";"Rubí";"3";"7";"B";"687";"240";"443";"531";"156";"3";"2";"526";"528"
"8";"Barcelona";"1";"Barcelona";"40";"Vallès Occidental";"08184";"Rubí";"3";"8";"A";"426";"141";"222";"267";"159";"0";"1";"266";"267"
"8";"Barcelona";"1";"Barcelona";"40";"Vallès Occidental";"08184";"Rubí";"3";"8";"B";"502";"188";"285";"343";"159";"3";"2";"338";"340"
"8";"Barcelona";"1";"Barcelona";"40";"Vallès Occidental";"08184";"Rubí";"3";"9";"A";"786";"340";"519";"651";"135";"0";"2";"649";"651"
"8";"Barcelona";"1";"Barcelona";"40";"Vallès Occidental";"08184";"Rubí";"3";"9";"B";"818";"289";"555";"689";"129";"2";"2";"685";"687"
"8";"Barcelona";"1";"Barcelona";"40";"Vallès Occidental";"08184";"Rubí";"4";"1";"A";"464";"173";"294";"353";"111";"2";"2";"349";"351"
"8";"Barcelona";"1";"Barcelona";"40";"Vallès Occidental";"08184";"Rubí";"4";"1";"B";"607";"242";"407";"470";"137";"0";"1";"469";"470"
"8";"Barcelona";"1";"Barcelona";"40";"Vallès Occidental";"08184";"Rubí";"4";"10";"A";"532";"170";"307";"377";"155";"1";"2";"374";"376"
"8";"Barcelona";"1";"Barcelona";"40";"Vallès Occidental";"08184";"Rubí";"4";"10";"B";"672";"217";"370";"462";"210";"1";"0";"461";"461"
"8";"Barcelona";"1";"Barcelona";"40";"Vallès Occidental";"08184";"Rubí";"4";"10";"C";"670";"219";"385";"490";"180";"1";"1";"488";"489"
"8";"Barcelona";"1";"Barcelona";"40";"Vallès Occidental";"08184";"Rubí";"4";"11";"A";"487";"198";"303";"359";"128";"0";"0";"359";"359"
"8";"Barcelona";"1";"Barcelona";"40";"Vallès Occidental";"08184";"Rubí";"4";"11";"B";"593";"216";"355";"440";"153";"3";"2";"435";"437"
"8";"Barcelona";"1";"Barcelona";"40";"Vallès Occidental";"08184";"Rubí";"4";"11";"C";"615";"221";"354";"446";"169";"2";"4";"440";"444"
"8";"Barcelona";"1";"Barcelona";"40";"Vallès Occidental";"08184";"Rubí";"4";"12";"A";"535";"195";"328";"403";"132";"1";"5";"397";"402"
"8";"Barcelona";"1";"Barcelona";"40";"Vallès Occidental";"08184";"Rubí";"4";"12";"B";"698";"267";"425";"521";"177";"1";"2";"518";"520"
"8";"Barcelona";"1";"Barcelona";"40";"Vallès Occidental";"08184";"Rubí";"4";"13";"A";"725";"216";"423";"532";"193";"4";"5";"523";"528"
"8";"Barcelona";"1";"Barcelona";"40";"Vallès Occidental";"08184";"Rubí";"4";"13";"B";"784";"262";"471";"581";"203";"1";"4";"576";"580"
"8";"Barcelona";"1";"Barcelona";"40";"Vallès Occidental";"08184";"Rubí";"4";"14";"A";"669";"242";"428";"528";"141";"0";"2";"526";"528"
"8";"Barcelona";"1";"Barcelona";"40";"Vallès Occidental";"08184";"Rubí";"4";"14";"B";"766";"279";"487";"582";"184";"0";"3";"579";"582"
"8";"Barcelona";"1";"Barcelona";"40";"Vallès Occidental";"08184";"Rubí";"4";"15";"A";"499";"175";"318";"381";"118";"2";"1";"378";"379"
"8";"Barcelona";"1";"Barcelona";"40";"Vallès Occidental";"08184";"Rubí";"4";"15";"B";"624";"204";"346";"443";"181";"1";"2";"440";"442"
"8";"Barcelona";"1";"Barcelona";"40";"Vallès Occidental";"08184";"Rubí";"4";"16";"A";"653";"184";"369";"494";"159";"2";"1";"491";"492"
"8";"Barcelona";"1";"Barcelona";"40";"Vallès Occidental";"08184";"Rubí";"4";"16";"B";"679";"221";"410";"525";"154";"3";"2";"520";"522"
"8";"Barcelona";"1";"Barcelona";"40";"Vallès Occidental";"08184";"Rubí";"4";"16";"C";"299";"97";"153";"175";"124";"1";"0";"174";"174"
"8";"Barcelona";"1";"Barcelona";"40";"Vallès Occidental";"08184";"Rubí";"4";"18";"A";"420";"156";"255";"318";"102";"0";"2";"316";"318"
"8";"Barcelona";"1";"Barcelona";"40";"Vallès Occidental";"08184";"Rubí";"4";"18";"B";"479";"140";"258";"340";"139";"0";"0";"340";"340"
"8";"Barcelona";"1";"Barcelona";"40";"Vallès Occidental";"08184";"Rubí";"4";"19";"A";"435";"159";"246";"303";"132";"2";"2";"299";"301"
"8";"Barcelona";"1";"Barcelona";"40";"Vallès Occidental";"08184";"Rubí";"4";"19";"B";"498";"195";"298";"346";"152";"0";"4";"342";"346"
"8";"Barcelona";"1";"Barcelona";"40";"Vallès Occidental";"08184";"Rubí";"4";"2";"U";"941";"295";"558";"706";"235";"0";"3";"703";"706"
"8";"Barcelona";"1";"Barcelona";"40";"Vallès Occidental";"08184";"Rubí";"4";"20";"A";"432";"152";"247";"314";"118";"6";"0";"308";"308"
"8";"Barcelona";"1";"Barcelona";"40";"Vallès Occidental";"08184";"Rubí";"4";"20";"B";"497";"166";"291";"361";"136";"0";"2";"359";"361"
"8";"Barcelona";"1";"Barcelona";"40";"Vallès Occidental";"08184";"Rubí";"4";"21";"A";"634";"221";"418";"506";"128";"2";"0";"504";"504"
"8";"Barcelona";"1";"Barcelona";"40";"Vallès Occidental";"08184";"Rubí";"4";"21";"B";"725";"250";"464";"577";"148";"1";"4";"572";"576"
"8";"Barcelona";"1";"Barcelona";"40";"Vallès Occidental";"08184";"Rubí";"4";"22";"A";"667";"256";"438";"536";"131";"1";"1";"534";"535"
"8";"Barcelona";"1";"Barcelona";"40";"Vallès Occidental";"08184";"Rubí";"4";"22";"B";"795";"258";"503";"622";"173";"1";"5";"616";"621"
"8";"Barcelona";"1";"Barcelona";"40";"Vallès Occidental";"08184";"Rubí";"4";"23";"U";"773";"208";"443";"553";"220";"1";"1";"551";"552"
"8";"Barcelona";"1";"Barcelona";"40";"Vallès Occidental";"08184";"Rubí";"4";"24";"U";"851";"287";"548";"558";"293";"0";"1";"557";"558"
"8";"Barcelona";"1";"Barcelona";"40";"Vallès Occidental";"08184";"Rubí";"4";"25";"U";"699";"254";"400";"493";"206";"0";"1";"492";"493"
"8";"Barcelona";"1";"Barcelona";"40";"Vallès Occidental";"08184";"Rubí";"4";"26";"A";"756";"273";"472";"580";"176";"1";"4";"575";"579"
"8";"Barcelona";"1";"Barcelona";"40";"Vallès Occidental";"08184";"Rubí";"4";"26";"B";"884";"290";"534";"647";"237";"4";"2";"641";"643"
"8";"Barcelona";"1";"Barcelona";"40";"Vallès Occidental";"08184";"Rubí";"4";"3";"A";"533";"181";"338";"399";"134";"0";"1";"398";"399"
"8";"Barcelona";"1";"Barcelona";"40";"Vallès Occidental";"08184";"Rubí";"4";"3";"B";"635";"219";"399";"484";"151";"5";"2";"477";"479"
"8";"Barcelona";"1";"Barcelona";"40";"Vallès Occidental";"08184";"Rubí";"4";"4";"A";"774";"272";"467";"567";"207";"2";"4";"561";"565"
"8";"Barcelona";"1";"Barcelona";"40";"Vallès Occidental";"08184";"Rubí";"4";"4";"B";"859";"300";"517";"641";"218";"3";"3";"635";"638"
"8";"Barcelona";"1";"Barcelona";"40";"Vallès Occidental";"08184";"Rubí";"4";"5";"A";"556";"232";"386";"454";"102";"3";"4";"447";"451"
"8";"Barcelona";"1";"Barcelona";"40";"Vallès Occidental";"08184";"Rubí";"4";"5";"B";"616";"238";"376";"464";"152";"0";"1";"463";"464"
"8";"Barcelona";"1";"Barcelona";"40";"Vallès Occidental";"08184";"Rubí";"4";"6";"A";"573";"208";"344";"426";"147";"1";"0";"425";"425"
"8";"Barcelona";"1";"Barcelona";"40";"Vallès Occidental";"08184";"Rubí";"4";"6";"B";"607";"237";"372";"443";"164";"2";"5";"436";"441"
"8";"Barcelona";"1";"Barcelona";"40";"Vallès Occidental";"08184";"Rubí";"4";"7";"A";"537";"228";"354";"418";"119";"2";"5";"411";"416"
"8";"Barcelona";"1";"Barcelona";"40";"Vallès Occidental";"08184";"Rubí";"4";"7";"B";"635";"274";"401";"480";"155";"2";"5";"473";"478"
"8";"Barcelona";"1";"Barcelona";"40";"Vallès Occidental";"08184";"Rubí";"4";"8";"U";"875";"345";"530";"603";"272";"1";"2";"600";"602"
"8";"Barcelona";"1";"Barcelona";"40";"Vallès Occidental";"08184";"Rubí";"4";"9";"A";"603";"203";"363";"437";"166";"1";"1";"435";"436"
"8";"Barcelona";"1";"Barcelona";"40";"Vallès Occidental";"08184";"Rubí";"4";"9";"B";"757";"275";"464";"557";"200";"1";"6";"550";"556"
"8";"Barcelona";"1";"Barcelona";"40";"Vallès Occidental";"08187";"Sabadell";"1";"1";"U";"526";"236";"391";"451";"75";"0";"0";"451";"451"
"8";"Barcelona";"1";"Barcelona";"40";"Vallès Occidental";"08187";"Sabadell";"1";"10";"U";"927";"343";"666";"754";"173";"0";"5";"749";"754"
"8";"Barcelona";"1";"Barcelona";"40";"Vallès Occidental";"08187";"Sabadell";"1";"11";"U";"966";"355";"698";"834";"132";"3";"6";"825";"831"
"8";"Barcelona";"1";"Barcelona";"40";"Vallès Occidental";"08187";"Sabadell";"1";"12";"U";"823";"425";"617";"716";"107";"2";"5";"709";"714"
"8";"Barcelona";"1";"Barcelona";"40";"Vallès Occidental";"08187";"Sabadell";"1";"13";"U";"819";"327";"567";"677";"142";"3";"2";"672";"674"
"8";"Barcelona";"1";"Barcelona";"40";"Vallès Occidental";"08187";"Sabadell";"1";"14";"A";"644";"272";"461";"547";"97";"3";"4";"540";"544"
"8";"Barcelona";"1";"Barcelona";"40";"Vallès Occidental";"08187";"Sabadell";"1";"14";"B";"749";"321";"585";"663";"86";"1";"1";"661";"662"
"8";"Barcelona";"1";"Barcelona";"40";"Vallès Occidental";"08187";"Sabadell";"1";"15";"A";"549";"253";"426";"492";"57";"1";"0";"491";"491"
"8";"Barcelona";"1";"Barcelona";"40";"Vallès Occidental";"08187";"Sabadell";"1";"15";"B";"657";"270";"479";"573";"84";"3";"4";"566";"570"
"8";"Barcelona";"1";"Barcelona";"40";"Vallès Occidental";"08187";"Sabadell";"1";"16";"A";"714";"295";"512";"630";"84";"0";"3";"627";"630"
"8";"Barcelona";"1";"Barcelona";"40";"Vallès Occidental";"08187";"Sabadell";"1";"16";"B";"837";"342";"626";"740";"97";"1";"3";"736";"739"
"8";"Barcelona";"1";"Barcelona";"40";"Vallès Occidental";"08187";"Sabadell";"1";"17";"A";"752";"276";"493";"602";"150";"0";"1";"601";"602"
"8";"Barcelona";"1";"Barcelona";"40";"Vallès Occidental";"08187";"Sabadell";"1";"17";"B";"913";"361";"621";"740";"173";"0";"5";"735";"740"
"8";"Barcelona";"1";"Barcelona";"40";"Vallès Occidental";"08187";"Sabadell";"1";"18";"A";"649";"254";"405";"506";"143";"0";"4";"502";"506"
"8";"Barcelona";"1";"Barcelona";"40";"Vallès Occidental";"08187";"Sabadell";"1";"18";"B";"748";"278";"483";"576";"172";"0";"4";"572";"576"
"8";"Barcelona";"1";"Barcelona";"40";"Vallès Occidental";"08187";"Sabadell";"1";"19";"A";"703";"266";"483";"578";"125";"1";"3";"574";"577"
"8";"Barcelona";"1";"Barcelona";"40";"Vallès Occidental";"08187";"Sabadell";"1";"19";"B";"793";"302";"560";"662";"131";"2";"2";"658";"660"
"8";"Barcelona";"1";"Barcelona";"40";"Vallès Occidental";"08187";"Sabadell";"1";"2";"U";"901";"373";"660";"791";"110";"2";"0";"789";"789"
"8";"Barcelona";"1";"Barcelona";"40";"Vallès Occidental";"08187";"Sabadell";"1";"20";"A";"570";"219";"410";"469";"101";"0";"1";"468";"469"
"8";"Barcelona";"1";"Barcelona";"40";"Vallès Occidental";"08187";"Sabadell";"1";"20";"B";"649";"218";"417";"532";"117";"0";"5";"527";"532"
"8";"Barcelona";"1";"Barcelona";"40";"Vallès Occidental";"08187";"Sabadell";"1";"21";"U";"889";"351";"574";"681";"208";"1";"1";"679";"680"
"8";"Barcelona";"1";"Barcelona";"40";"Vallès Occidental";"08187";"Sabadell";"1";"22";"U";"775";"310";"539";"634";"141";"4";"0";"630";"630"
"8";"Barcelona";"1";"Barcelona";"40";"Vallès Occidental";"08187";"Sabadell";"1";"23";"A";"618";"229";"417";"503";"115";"0";"3";"500";"503"
"8";"Barcelona";"1";"Barcelona";"40";"Vallès Occidental";"08187";"Sabadell";"1";"23";"B";"801";"276";"533";"660";"141";"2";"5";"653";"658"
"8";"Barcelona";"1";"Barcelona";"40";"Vallès Occidental";"08187";"Sabadell";"1";"24";"A";"559";"183";"349";"417";"142";"1";"1";"415";"416"
"8";"Barcelona";"1";"Barcelona";"40";"Vallès Occidental";"08187";"Sabadell";"1";"24";"B";"664";"242";"401";"518";"146";"3";"3";"512";"515"
"8";"Barcelona";"1";"Barcelona";"40";"Vallès Occidental";"08187";"Sabadell";"1";"25";"A";"481";"197";"332";"409";"72";"5";"1";"403";"404"
"8";"Barcelona";"1";"Barcelona";"40";"Vallès Occidental";"08187";"Sabadell";"1";"25";"B";"594";"242";"402";"487";"107";"5";"5";"477";"482"
"8";"Barcelona";"1";"Barcelona";"40";"Vallès Occidental";"08187";"Sabadell";"1";"26";"U";"666";"271";"462";"555";"111";"0";"1";"554";"555"
"8";"Barcelona";"1";"Barcelona";"40";"Vallès Occidental";"08187";"Sabadell";"1";"27";"U";"774";"273";"510";"615";"159";"0";"2";"613";"615"
"8";"Barcelona";"1";"Barcelona";"40";"Vallès Occidental";"08187";"Sabadell";"1";"28";"A";"462";"187";"312";"388";"74";"1";"0";"387";"387"
"8";"Barcelona";"1";"Barcelona";"40";"Vallès Occidental";"08187";"Sabadell";"1";"28";"B";"605";"244";"414";"531";"74";"2";"2";"527";"529"
"8";"Barcelona";"1";"Barcelona";"40";"Vallès Occidental";"08187";"Sabadell";"1";"29";"U";"945";"369";"671";"787";"158";"1";"1";"785";"786"
"8";"Barcelona";"1";"Barcelona";"40";"Vallès Occidental";"08187";"Sabadell";"1";"3";"U";"820";"344";"636";"720";"100";"1";"2";"717";"719"
"8";"Barcelona";"1";"Barcelona";"40";"Vallès Occidental";"08187";"Sabadell";"1";"30";"U";"905";"310";"675";"806";"99";"1";"9";"796";"805"
"8";"Barcelona";"1";"Barcelona";"40";"Vallès Occidental";"08187";"Sabadell";"1";"31";"U";"846";"360";"646";"758";"88";"0";"5";"753";"758"
"8";"Barcelona";"1";"Barcelona";"40";"Vallès Occidental";"08187";"Sabadell";"1";"32";"U";"926";"332";"667";"801";"125";"0";"3";"798";"801"
"8";"Barcelona";"1";"Barcelona";"40";"Vallès Occidental";"08187";"Sabadell";"1";"33";"U";"947";"285";"605";"752";"195";"3";"5";"744";"749"
"8";"Barcelona";"1";"Barcelona";"40";"Vallès Occidental";"08187";"Sabadell";"1";"34";"A";"568";"209";"414";"483";"85";"6";"2";"475";"477"
"8";"Barcelona";"1";"Barcelona";"40";"Vallès Occidental";"08187";"Sabadell";"1";"34";"B";"599";"222";"405";"485";"114";"3";"5";"477";"482"
"8";"Barcelona";"1";"Barcelona";"40";"Vallès Occidental";"08187";"Sabadell";"1";"35";"U";"744";"290";"528";"616";"128";"3";"3";"610";"613"
"8";"Barcelona";"1";"Barcelona";"40";"Vallès Occidental";"08187";"Sabadell";"1";"4";"A";"775";"322";"569";"684";"91";"1";"4";"679";"683"
"8";"Barcelona";"1";"Barcelona";"40";"Vallès Occidental";"08187";"Sabadell";"1";"4";"B";"956";"365";"707";"835";"121";"2";"2";"831";"833"
"8";"Barcelona";"1";"Barcelona";"40";"Vallès Occidental";"08187";"Sabadell";"1";"5";"A";"527";"212";"374";"445";"82";"1";"2";"442";"444"
"8";"Barcelona";"1";"Barcelona";"40";"Vallès Occidental";"08187";"Sabadell";"1";"5";"B";"607";"229";"374";"518";"89";"1";"1";"516";"517"
"8";"Barcelona";"1";"Barcelona";"40";"Vallès Occidental";"08187";"Sabadell";"1";"6";"A";"701";"278";"524";"621";"80";"3";"2";"616";"618"
"8";"Barcelona";"1";"Barcelona";"40";"Vallès Occidental";"08187";"Sabadell";"1";"6";"B";"612";"202";"447";"544";"68";"1";"0";"543";"543"
"8";"Barcelona";"1";"Barcelona";"40";"Vallès Occidental";"08187";"Sabadell";"1";"6";"C";"692";"264";"509";"606";"86";"2";"0";"604";"604"
"8";"Barcelona";"1";"Barcelona";"40";"Vallès Occidental";"08187";"Sabadell";"1";"7";"A";"747";"290";"552";"659";"88";"0";"3";"656";"659"
"8";"Barcelona";"1";"Barcelona";"40";"Vallès Occidental";"08187";"Sabadell";"1";"7";"B";"783";"365";"650";"695";"88";"1";"10";"684";"694"
"8";"Barcelona";"1";"Barcelona";"40";"Vallès Occidental";"08187";"Sabadell";"1";"8";"A";"570";"218";"409";"494";"76";"0";"2";"492";"494"
"8";"Barcelona";"1";"Barcelona";"40";"Vallès Occidental";"08187";"Sabadell";"1";"8";"B";"610";"204";"440";"537";"73";"1";"2";"534";"536"
"8";"Barcelona";"1";"Barcelona";"40";"Vallès Occidental";"08187";"Sabadell";"1";"8";"C";"639";"237";"486";"571";"68";"0";"2";"569";"571"
"8";"Barcelona";"1";"Barcelona";"40";"Vallès Occidental";"08187";"Sabadell";"1";"9";"A";"692";"262";"514";"624";"68";"2";"3";"619";"622"
"8";"Barcelona";"1";"Barcelona";"40";"Vallès Occidental";"08187";"Sabadell";"1";"9";"B";"665";"310";"503";"599";"66";"3";"1";"595";"596"
"8";"Barcelona";"1";"Barcelona";"40";"Vallès Occidental";"08187";"Sabadell";"1";"9";"C";"631";"286";"471";"559";"72";"0";"2";"557";"559"
"8";"Barcelona";"1";"Barcelona";"40";"Vallès Occidental";"08187";"Sabadell";"2";"1";"A";"546";"253";"420";"488";"58";"1";"1";"486";"487"
"8";"Barcelona";"1";"Barcelona";"40";"Vallès Occidental";"08187";"Sabadell";"2";"1";"B";"676";"291";"502";"592";"84";"0";"3";"589";"592"
"8";"Barcelona";"1";"Barcelona";"40";"Vallès Occidental";"08187";"Sabadell";"2";"10";"U";"643";"258";"461";"535";"108";"1";"3";"531";"534"
"8";"Barcelona";"1";"Barcelona";"40";"Vallès Occidental";"08187";"Sabadell";"2";"11";"U";"653";"180";"294";"367";"286";"7";"1";"359";"360"
"8";"Barcelona";"1";"Barcelona";"40";"Vallès Occidental";"08187";"Sabadell";"2";"12";"A";"554";"181";"297";"360";"194";"1";"3";"356";"359"
"8";"Barcelona";"1";"Barcelona";"40";"Vallès Occidental";"08187";"Sabadell";"2";"12";"B";"687";"256";"421";"488";"199";"6";"4";"478";"482"
"8";"Barcelona";"1";"Barcelona";"40";"Vallès Occidental";"08187";"Sabadell";"2";"13";"U";"929";"206";"473";"624";"305";"0";"7";"617";"624"
"8";"Barcelona";"1";"Barcelona";"40";"Vallès Occidental";"08187";"Sabadell";"2";"14";"U";"862";"227";"407";"496";"366";"3";"2";"491";"493"
"8";"Barcelona";"1";"Barcelona";"40";"Vallès Occidental";"08187";"Sabadell";"2";"15";"A";"448";"157";"277";"338";"110";"2";"3";"333";"336"
"8";"Barcelona";"1";"Barcelona";"40";"Vallès Occidental";"08187";"Sabadell";"2";"15";"B";"607";"207";"367";"460";"147";"0";"6";"454";"460"
"8";"Barcelona";"1";"Barcelona";"40";"Vallès Occidental";"08187";"Sabadell";"2";"16";"A";"559";"256";"440";"497";"62";"0";"3";"494";"497"
"8";"Barcelona";"1";"Barcelona";"40";"Vallès Occidental";"08187";"Sabadell";"2";"16";"B";"613";"258";"467";"522";"91";"2";"1";"519";"520"
"8";"Barcelona";"1";"Barcelona";"40";"Vallès Occidental";"08187";"Sabadell";"2";"17";"U";"715";"282";"500";"619";"96";"4";"2";"613";"615"
"8";"Barcelona";"1";"Barcelona";"40";"Vallès Occidental";"08187";"Sabadell";"2";"2";"A";"515";"200";"369";"444";"71";"1";"1";"442";"443"
"8";"Barcelona";"1";"Barcelona";"40";"Vallès Occidental";"08187";"Sabadell";"2";"2";"B";"546";"212";"375";"467";"79";"1";"1";"465";"466"
"8";"Barcelona";"1";"Barcelona";"40";"Vallès Occidental";"08187";"Sabadell";"2";"3";"A";"471";"202";"301";"374";"97";"2";"3";"369";"372"
"8";"Barcelona";"1";"Barcelona";"40";"Vallès Occidental";"08187";"Sabadell";"2";"3";"B";"573";"238";"373";"452";"121";"3";"5";"444";"449"
"8";"Barcelona";"1";"Barcelona";"40";"Vallès Occidental";"08187";"Sabadell";"2";"4";"A";"645";"244";"455";"535";"110";"1";"1";"533";"534"
"8";"Barcelona";"1";"Barcelona";"40";"Vallès Occidental";"08187";"Sabadell";"2";"4";"B";"842";"314";"609";"716";"126";"0";"3";"713";"716"
"8";"Barcelona";"1";"Barcelona";"40";"Vallès Occidental";"08187";"Sabadell";"2";"5";"A";"587";"240";"437";"502";"85";"1";"4";"497";"501"
"8";"Barcelona";"1";"Barcelona";"40";"Vallès Occidental";"08187";"Sabadell";"2";"5";"B";"777";"272";"527";"631";"146";"4";"2";"625";"627"
"8";"Barcelona";"1";"Barcelona";"40";"Vallès Occidental";"08187";"Sabadell";"2";"6";"A";"567";"186";"372";"451";"116";"2";"2";"447";"449"
"8";"Barcelona";"1";"Barcelona";"40";"Vallès Occidental";"08187";"Sabadell";"2";"6";"B";"700";"285";"480";"556";"144";"4";"4";"548";"552"
"8";"Barcelona";"1";"Barcelona";"40";"Vallès Occidental";"08187";"Sabadell";"2";"7";"A";"623";"263";"433";"512";"111";"0";"4";"508";"512"
"8";"Barcelona";"1";"Barcelona";"40";"Vallès Occidental";"08187";"Sabadell";"2";"7";"B";"676";"317";"500";"575";"101";"4";"4";"567";"571"
"8";"Barcelona";"1";"Barcelona";"40";"Vallès Occidental";"08187";"Sabadell";"2";"8";"U";"690";"277";"518";"583";"107";"2";"5";"576";"581"
"8";"Barcelona";"1";"Barcelona";"40";"Vallès Occidental";"08187";"Sabadell";"2";"9";"A";"425";"182";"301";"349";"76";"3";"4";"342";"346"
"8";"Barcelona";"1";"Barcelona";"40";"Vallès Occidental";"08187";"Sabadell";"2";"9";"B";"499";"206";"355";"419";"80";"2";"1";"416";"417"
"8";"Barcelona";"1";"Barcelona";"40";"Vallès Occidental";"08187";"Sabadell";"3";"1";"A";"516";"197";"333";"392";"124";"2";"5";"385";"390"
"8";"Barcelona";"1";"Barcelona";"40";"Vallès Occidental";"08187";"Sabadell";"3";"1";"B";"638";"275";"450";"508";"130";"3";"0";"505";"505"
"8";"Barcelona";"1";"Barcelona";"40";"Vallès Occidental";"08187";"Sabadell";"3";"10";"U";"668";"270";"414";"504";"164";"1";"3";"500";"503"
"8";"Barcelona";"1";"Barcelona";"40";"Vallès Occidental";"08187";"Sabadell";"3";"11";"A";"391";"154";"233";"269";"122";"0";"0";"269";"269"
"8";"Barcelona";"1";"Barcelona";"40";"Vallès Occidental";"08187";"Sabadell";"3";"11";"B";"519";"198";"301";"375";"144";"1";"0";"374";"374"
"8";"Barcelona";"1";"Barcelona";"40";"Vallès Occidental";"08187";"Sabadell";"3";"12";"U";"869";"304";"555";"640";"229";"4";"1";"635";"636"
"8";"Barcelona";"1";"Barcelona";"40";"Vallès Occidental";"08187";"Sabadell";"3";"13";"U";"820";"314";"514";"638";"182";"6";"5";"627";"632"
"8";"Barcelona";"1";"Barcelona";"40";"Vallès Occidental";"08187";"Sabadell";"3";"14";"A";"520";"180";"289";"356";"164";"0";"1";"355";"356"
"8";"Barcelona";"1";"Barcelona";"40";"Vallès Occidental";"08187";"Sabadell";"3";"14";"B";"660";"259";"401";"505";"155";"2";"3";"500";"503"
"8";"Barcelona";"1";"Barcelona";"40";"Vallès Occidental";"08187";"Sabadell";"3";"15";"A";"470";"166";"270";"342";"128";"0";"1";"341";"342"
"8";"Barcelona";"1";"Barcelona";"40";"Vallès Occidental";"08187";"Sabadell";"3";"15";"B";"661";"230";"399";"493";"168";"2";"6";"485";"491"
"8";"Barcelona";"1";"Barcelona";"40";"Vallès Occidental";"08187";"Sabadell";"3";"16";"U";"965";"284";"543";"655";"310";"2";"5";"648";"653"
"8";"Barcelona";"1";"Barcelona";"40";"Vallès Occidental";"08187";"Sabadell";"3";"17";"U";"778";"294";"451";"534";"244";"5";"2";"527";"529"
"8";"Barcelona";"1";"Barcelona";"40";"Vallès Occidental";"08187";"Sabadell";"3";"18";"A";"943";"325";"595";"719";"224";"5";"4";"710";"714"
"8";"Barcelona";"1";"Barcelona";"40";"Vallès Occidental";"08187";"Sabadell";"3";"18";"B";"631";"212";"438";"534";"97";"2";"6";"526";"532"
"8";"Barcelona";"1";"Barcelona";"40";"Vallès Occidental";"08187";"Sabadell";"3";"18";"C";"768";"253";"508";"646";"122";"1";"3";"642";"645"
"8";"Barcelona";"1";"Barcelona";"40";"Vallès Occidental";"08187";"Sabadell";"3";"19";"U";"718";"285";"477";"585";"133";"1";"1";"583";"584"
"8";"Barcelona";"1";"Barcelona";"40";"Vallès Occidental";"08187";"Sabadell";"3";"2";"A";"437";"163";"258";"309";"128";"3";"0";"306";"306"
"8";"Barcelona";"1";"Barcelona";"40";"Vallès Occidental";"08187";"Sabadell";"3";"2";"B";"558";"188";"307";"404";"154";"4";"1";"399";"400"
"8";"Barcelona";"1";"Barcelona";"40";"Vallès Occidental";"08187";"Sabadell";"3";"20";"U";"1003";"305";"624";"773";"230";"1";"0";"772";"772"
"8";"Barcelona";"1";"Barcelona";"40";"Vallès Occidental";"08187";"Sabadell";"3";"21";"A";"436";"159";"248";"305";"131";"2";"2";"301";"303"
"8";"Barcelona";"1";"Barcelona";"40";"Vallès Occidental";"08187";"Sabadell";"3";"21";"B";"548";"210";"339";"402";"146";"2";"2";"398";"400"
"8";"Barcelona";"1";"Barcelona";"40";"Vallès Occidental";"08187";"Sabadell";"3";"22";"U";"601";"216";"360";"435";"166";"3";"2";"430";"432"
"8";"Barcelona";"1";"Barcelona";"40";"Vallès Occidental";"08187";"Sabadell";"3";"23";"U";"507";"169";"313";"381";"126";"1";"4";"376";"380"
"8";"Barcelona";"1";"Barcelona";"40";"Vallès Occidental";"08187";"Sabadell";"3";"24";"A";"512";"167";"316";"407";"105";"1";"3";"403";"406"
"8";"Barcelona";"1";"Barcelona";"40";"Vallès Occidental";"08187";"Sabadell";"3";"24";"B";"606";"210";"388";"486";"120";"2";"2";"482";"484"
"8";"Barcelona";"1";"Barcelona";"40";"Vallès Occidental";"08187";"Sabadell";"3";"25";"U";"964";"301";"655";"808";"156";"7";"3";"798";"801"
"8";"Barcelona";"1";"Barcelona";"40";"Vallès Occidental";"08187";"Sabadell";"3";"26";"A";"544";"185";"355";"465";"79";"1";"1";"463";"464"
"8";"Barcelona";"1";"Barcelona";"40";"Vallès Occidental";"08187";"Sabadell";"3";"26";"B";"632";"228";"420";"524";"108";"2";"0";"522";"522"
"8";"Barcelona";"1";"Barcelona";"40";"Vallès Occidental";"08187";"Sabadell";"3";"27";"U";"563";"181";"338";"426";"137";"4";"4";"418";"422"
"8";"Barcelona";"1";"Barcelona";"40";"Vallès Occidental";"08187";"Sabadell";"3";"3";"A";"501";"175";"278";"357";"144";"2";"3";"352";"355"
"8";"Barcelona";"1";"Barcelona";"40";"Vallès Occidental";"08187";"Sabadell";"3";"3";"B";"644";"250";"405";"500";"144";"1";"3";"496";"499"
"8";"Barcelona";"1";"Barcelona";"40";"Vallès Occidental";"08187";"Sabadell";"3";"4";"A";"505";"206";"307";"358";"147";"0";"0";"358";"358"
"8";"Barcelona";"1";"Barcelona";"40";"Vallès Occidental";"08187";"Sabadell";"3";"4";"B";"707";"247";"422";"511";"196";"1";"5";"505";"510"
"8";"Barcelona";"1";"Barcelona";"40";"Vallès Occidental";"08187";"Sabadell";"3";"5";"U";"708";"249";"426";"524";"184";"2";"5";"517";"522"
"8";"Barcelona";"1";"Barcelona";"40";"Vallès Occidental";"08187";"Sabadell";"3";"6";"A";"481";"180";"303";"382";"99";"2";"2";"378";"380"
"8";"Barcelona";"1";"Barcelona";"40";"Vallès Occidental";"08187";"Sabadell";"3";"6";"B";"628";"233";"395";"515";"113";"2";"2";"511";"513"
"8";"Barcelona";"1";"Barcelona";"40";"Vallès Occidental";"08187";"Sabadell";"3";"7";"U";"640";"211";"412";"494";"146";"1";"0";"493";"493"
"8";"Barcelona";"1";"Barcelona";"40";"Vallès Occidental";"08187";"Sabadell";"3";"8";"U";"923";"295";"548";"680";"243";"0";"4";"676";"680"
"8";"Barcelona";"1";"Barcelona";"40";"Vallès Occidental";"08187";"Sabadell";"3";"9";"U";"687";"238";"393";"484";"203";"1";"1";"482";"483"
"8";"Barcelona";"1";"Barcelona";"40";"Vallès Occidental";"08187";"Sabadell";"4";"1";"A";"610";"256";"400";"483";"127";"3";"1";"479";"480"
"8";"Barcelona";"1";"Barcelona";"40";"Vallès Occidental";"08187";"Sabadell";"4";"1";"B";"737";"231";"464";"590";"147";"0";"3";"587";"590"
"8";"Barcelona";"1";"Barcelona";"40";"Vallès Occidental";"08187";"Sabadell";"4";"10";"A";"610";"256";"417";"470";"140";"3";"2";"465";"467"
"8";"Barcelona";"1";"Barcelona";"40";"Vallès Occidental";"08187";"Sabadell";"4";"10";"B";"705";"251";"433";"513";"192";"9";"4";"500";"504"
"8";"Barcelona";"1";"Barcelona";"40";"Vallès Occidental";"08187";"Sabadell";"4";"11";"U";"705";"244";"437";"552";"153";"7";"2";"543";"545"
"8";"Barcelona";"1";"Barcelona";"40";"Vallès Occidental";"08187";"Sabadell";"4";"12";"U";"747";"255";"451";"565";"182";"1";"1";"563";"564"
"8";"Barcelona";"1";"Barcelona";"40";"Vallès Occidental";"08187";"Sabadell";"4";"13";"A";"612";"187";"403";"486";"126";"0";"0";"486";"486"
"8";"Barcelona";"1";"Barcelona";"40";"Vallès Occidental";"08187";"Sabadell";"4";"13";"B";"732";"265";"474";"574";"158";"0";"3";"571";"574"
"8";"Barcelona";"1";"Barcelona";"40";"Vallès Occidental";"08187";"Sabadell";"4";"14";"A";"459";"195";"312";"387";"72";"3";"1";"383";"384"
"8";"Barcelona";"1";"Barcelona";"40";"Vallès Occidental";"08187";"Sabadell";"4";"14";"B";"522";"209";"356";"433";"89";"0";"1";"432";"433"
"8";"Barcelona";"1";"Barcelona";"40";"Vallès Occidental";"08187";"Sabadell";"4";"15";"U";"648";"252";"372";"438";"210";"4";"5";"429";"434"
"8";"Barcelona";"1";"Barcelona";"40";"Vallès Occidental";"08187";"Sabadell";"4";"16";"A";"652";"236";"418";"514";"138";"4";"5";"505";"510"
"8";"Barcelona";"1";"Barcelona";"40";"Vallès Occidental";"08187";"Sabadell";"4";"16";"B";"845";"284";"527";"663";"182";"4";"0";"659";"659"
"8";"Barcelona";"1";"Barcelona";"40";"Vallès Occidental";"08187";"Sabadell";"4";"17";"A";"637";"201";"377";"459";"178";"2";"5";"452";"457"
"8";"Barcelona";"1";"Barcelona";"40";"Vallès Occidental";"08187";"Sabadell";"4";"17";"B";"754";"243";"439";"561";"193";"2";"1";"558";"559"
"8";"Barcelona";"1";"Barcelona";"40";"Vallès Occidental";"08187";"Sabadell";"4";"18";"U";"562";"194";"335";"450";"112";"0";"4";"446";"450"
"8";"Barcelona";"1";"Barcelona";"40";"Vallès Occidental";"08187";"Sabadell";"4";"19";"U";"940";"310";"517";"621";"319";"2";"2";"617";"619"
"8";"Barcelona";"1";"Barcelona";"40";"Vallès Occidental";"08187";"Sabadell";"4";"2";"U";"835";"312";"509";"613";"222";"3";"3";"607";"610"
"8";"Barcelona";"1";"Barcelona";"40";"Vallès Occidental";"08187";"Sabadell";"4";"20";"U";"674";"228";"379";"486";"188";"6";"0";"480";"480"
"8";"Barcelona";"1";"Barcelona";"40";"Vallès Occidental";"08187";"Sabadell";"4";"21";"U";"838";"315";"568";"687";"151";"5";"3";"679";"682"
"8";"Barcelona";"1";"Barcelona";"40";"Vallès Occidental";"08187";"Sabadell";"4";"22";"U";"732";"281";"496";"595";"137";"0";"3";"592";"595"
"8";"Barcelona";"1";"Barcelona";"40";"Vallès Occidental";"08187";"Sabadell";"4";"23";"U";"798";"256";"459";"590";"208";"1";"2";"587";"589"
"8";"Barcelona";"1";"Barcelona";"40";"Vallès Occidental";"08187";"Sabadell";"4";"24";"U";"731";"285";"499";"649";"82";"3";"13";"633";"646"
"8";"Barcelona";"1";"Barcelona";"40";"Vallès Occidental";"08187";"Sabadell";"4";"25";"U";"865";"254";"551";"723";"142";"1";"8";"714";"722"
"8";"Barcelona";"1";"Barcelona";"40";"Vallès Occidental";"08187";"Sabadell";"4";"26";"U";"790";"201";"455";"656";"134";"2";"3";"651";"654"
"8";"Barcelona";"1";"Barcelona";"40";"Vallès Occidental";"08187";"Sabadell";"4";"27";"A";"516";"161";"344";"442";"74";"2";"6";"434";"440"
"8";"Barcelona";"1";"Barcelona";"40";"Vallès Occidental";"08187";"Sabadell";"4";"27";"B";"619";"197";"411";"528";"91";"3";"5";"520";"525"
"8";"Barcelona";"1";"Barcelona";"40";"Vallès Occidental";"08187";"Sabadell";"4";"28";"U";"923";"307";"602";"783";"140";"4";"9";"770";"779"
"8";"Barcelona";"1";"Barcelona";"40";"Vallès Occidental";"08187";"Sabadell";"4";"29";"U";"929";"280";"573";"781";"148";"1";"6";"774";"780"
"8";"Barcelona";"1";"Barcelona";"40";"Vallès Occidental";"08187";"Sabadell";"4";"3";"U";"741";"282";"500";"610";"131";"3";"2";"605";"607"
"8";"Barcelona";"1";"Barcelona";"40";"Vallès Occidental";"08187";"Sabadell";"4";"4";"A";"596";"207";"354";"457";"139";"3";"4";"450";"454"
"8";"Barcelona";"1";"Barcelona";"40";"Vallès Occidental";"08187";"Sabadell";"4";"4";"B";"711";"258";"419";"543";"168";"4";"0";"539";"539"
"8";"Barcelona";"1";"Barcelona";"40";"Vallès Occidental";"08187";"Sabadell";"4";"5";"A";"507";"201";"333";"400";"107";"0";"3";"397";"400"
"8";"Barcelona";"1";"Barcelona";"40";"Vallès Occidental";"08187";"Sabadell";"4";"5";"B";"656";"272";"435";"512";"144";"1";"3";"508";"511"
"8";"Barcelona";"1";"Barcelona";"40";"Vallès Occidental";"08187";"Sabadell";"4";"6";"A";"597";"227";"404";"482";"115";"0";"3";"479";"482"
"8";"Barcelona";"1";"Barcelona";"40";"Vallès Occidental";"08187";"Sabadell";"4";"6";"B";"730";"281";"471";"565";"165";"0";"0";"565";"565"
"8";"Barcelona";"1";"Barcelona";"40";"Vallès Occidental";"08187";"Sabadell";"4";"7";"U";"883";"285";"594";"692";"191";"4";"6";"682";"688"
"8";"Barcelona";"1";"Barcelona";"40";"Vallès Occidental";"08187";"Sabadell";"4";"8";"A";"545";"210";"368";"450";"95";"3";"2";"445";"447"
"8";"Barcelona";"1";"Barcelona";"40";"Vallès Occidental";"08187";"Sabadell";"4";"8";"B";"650";"249";"482";"537";"113";"1";"3";"533";"536"
"8";"Barcelona";"1";"Barcelona";"40";"Vallès Occidental";"08187";"Sabadell";"4";"9";"A";"459";"166";"314";"387";"72";"1";"3";"383";"386"
"8";"Barcelona";"1";"Barcelona";"40";"Vallès Occidental";"08187";"Sabadell";"4";"9";"B";"456";"171";"343";"396";"60";"2";"0";"394";"394"
"8";"Barcelona";"1";"Barcelona";"40";"Vallès Occidental";"08187";"Sabadell";"5";"1";"A";"537";"205";"359";"436";"101";"0";"2";"434";"436"
"8";"Barcelona";"1";"Barcelona";"40";"Vallès Occidental";"08187";"Sabadell";"5";"1";"B";"619";"235";"419";"485";"134";"0";"1";"484";"485"
"8";"Barcelona";"1";"Barcelona";"40";"Vallès Occidental";"08187";"Sabadell";"5";"11";"A";"426";"157";"237";"276";"150";"1";"1";"274";"275"
"8";"Barcelona";"1";"Barcelona";"40";"Vallès Occidental";"08187";"Sabadell";"5";"11";"B";"513";"200";"302";"344";"169";"2";"1";"341";"342"
"8";"Barcelona";"1";"Barcelona";"40";"Vallès Occidental";"08187";"Sabadell";"5";"12";"U";"834";"279";"502";"598";"236";"0";"0";"598";"598"
"8";"Barcelona";"1";"Barcelona";"40";"Vallès Occidental";"08187";"Sabadell";"5";"13";"A";"791";"262";"503";"615";"176";"2";"2";"611";"613"
"8";"Barcelona";"1";"Barcelona";"40";"Vallès Occidental";"08187";"Sabadell";"5";"13";"B";"942";"316";"596";"756";"186";"0";"4";"752";"756"
"8";"Barcelona";"1";"Barcelona";"40";"Vallès Occidental";"08187";"Sabadell";"5";"14";"U";"836";"344";"579";"693";"143";"1";"0";"692";"692"
"8";"Barcelona";"1";"Barcelona";"40";"Vallès Occidental";"08187";"Sabadell";"5";"15";"A";"506";"218";"361";"443";"63";"0";"0";"443";"443"
"8";"Barcelona";"1";"Barcelona";"40";"Vallès Occidental";"08187";"Sabadell";"5";"15";"B";"531";"224";"386";"449";"82";"3";"2";"444";"446"
"8";"Barcelona";"1";"Barcelona";"40";"Vallès Occidental";"08187";"Sabadell";"5";"2";"A";"622";"224";"430";"518";"104";"0";"3";"515";"518"
"8";"Barcelona";"1";"Barcelona";"40";"Vallès Occidental";"08187";"Sabadell";"5";"2";"B";"719";"235";"453";"584";"135";"1";"2";"581";"583"
"8";"Barcelona";"1";"Barcelona";"40";"Vallès Occidental";"08187";"Sabadell";"5";"3";"A";"528";"220";"386";"454";"74";"3";"0";"451";"451"
"8";"Barcelona";"1";"Barcelona";"40";"Vallès Occidental";"08187";"Sabadell";"5";"3";"B";"605";"252";"448";"519";"86";"0";"1";"518";"519"
"8";"Barcelona";"1";"Barcelona";"40";"Vallès Occidental";"08187";"Sabadell";"5";"4";"U";"671";"252";"452";"550";"121";"1";"3";"546";"549"
"8";"Barcelona";"1";"Barcelona";"40";"Vallès Occidental";"08187";"Sabadell";"5";"5";"U";"952";"233";"612";"766";"186";"3";"9";"754";"763"
"8";"Barcelona";"1";"Barcelona";"40";"Vallès Occidental";"08187";"Sabadell";"5";"6";"U";"838";"330";"595";"697";"141";"4";"5";"688";"693"
"8";"Barcelona";"1";"Barcelona";"40";"Vallès Occidental";"08187";"Sabadell";"5";"7";"U";"778";"282";"468";"567";"211";"1";"4";"562";"566"
"8";"Barcelona";"1";"Barcelona";"40";"Vallès Occidental";"08187";"Sabadell";"5";"8";"U";"776";"272";"450";"543";"233";"1";"4";"538";"542"
"8";"Barcelona";"1";"Barcelona";"40";"Vallès Occidental";"08187";"Sabadell";"5";"9";"A";"522";"176";"346";"415";"107";"1";"4";"410";"414"
"8";"Barcelona";"1";"Barcelona";"40";"Vallès Occidental";"08187";"Sabadell";"5";"9";"B";"639";"222";"399";"494";"145";"2";"2";"490";"492"
"8";"Barcelona";"1";"Barcelona";"40";"Vallès Occidental";"08187";"Sabadell";"6";"1";"U";"571";"169";"321";"388";"183";"9";"2";"377";"379"
"8";"Barcelona";"1";"Barcelona";"40";"Vallès Occidental";"08187";"Sabadell";"6";"10";"U";"637";"214";"334";"402";"235";"5";"2";"395";"397"
"8";"Barcelona";"1";"Barcelona";"40";"Vallès Occidental";"08187";"Sabadell";"6";"11";"U";"592";"175";"291";"360";"232";"1";"3";"356";"359"
"8";"Barcelona";"1";"Barcelona";"40";"Vallès Occidental";"08187";"Sabadell";"6";"12";"U";"748";"264";"429";"516";"232";"2";"1";"513";"514"
"8";"Barcelona";"1";"Barcelona";"40";"Vallès Occidental";"08187";"Sabadell";"6";"13";"U";"696";"246";"385";"470";"226";"1";"3";"466";"469"
"8";"Barcelona";"1";"Barcelona";"40";"Vallès Occidental";"08187";"Sabadell";"6";"14";"A";"677";"265";"426";"504";"173";"0";"3";"501";"504"
"8";"Barcelona";"1";"Barcelona";"40";"Vallès Occidental";"08187";"Sabadell";"6";"14";"B";"826";"314";"500";"602";"224";"1";"4";"597";"601"
"8";"Barcelona";"1";"Barcelona";"40";"Vallès Occidental";"08187";"Sabadell";"6";"16";"A";"587";"218";"362";"447";"140";"2";"3";"442";"445"
"8";"Barcelona";"1";"Barcelona";"40";"Vallès Occidental";"08187";"Sabadell";"6";"16";"B";"680";"276";"410";"513";"167";"0";"2";"511";"513"
"8";"Barcelona";"1";"Barcelona";"40";"Vallès Occidental";"08187";"Sabadell";"6";"17";"A";"465";"167";"274";"335";"130";"1";"2";"332";"334"
"8";"Barcelona";"1";"Barcelona";"40";"Vallès Occidental";"08187";"Sabadell";"6";"17";"B";"641";"248";"392";"488";"153";"2";"4";"482";"486"
"8";"Barcelona";"1";"Barcelona";"40";"Vallès Occidental";"08187";"Sabadell";"6";"18";"A";"501";"194";"278";"336";"165";"1";"2";"333";"335"
"8";"Barcelona";"1";"Barcelona";"40";"Vallès Occidental";"08187";"Sabadell";"6";"18";"B";"620";"225";"344";"418";"202";"0";"0";"418";"418"
"8";"Barcelona";"1";"Barcelona";"40";"Vallès Occidental";"08187";"Sabadell";"6";"2";"U";"651";"203";"390";"471";"180";"2";"0";"469";"469"
"8";"Barcelona";"1";"Barcelona";"40";"Vallès Occidental";"08187";"Sabadell";"6";"20";"U";"938";"307";"551";"693";"245";"2";"3";"688";"691"
"8";"Barcelona";"1";"Barcelona";"40";"Vallès Occidental";"08187";"Sabadell";"6";"21";"U";"835";"275";"502";"636";"199";"1";"0";"635";"635"
"8";"Barcelona";"1";"Barcelona";"40";"Vallès Occidental";"08187";"Sabadell";"6";"22";"A";"531";"185";"314";"377";"154";"2";"0";"375";"375"
"8";"Barcelona";"1";"Barcelona";"40";"Vallès Occidental";"08187";"Sabadell";"6";"22";"B";"709";"279";"447";"557";"152";"0";"5";"552";"557"
"8";"Barcelona";"1";"Barcelona";"40";"Vallès Occidental";"08187";"Sabadell";"6";"23";"A";"607";"235";"409";"467";"140";"3";"5";"459";"464"
"8";"Barcelona";"1";"Barcelona";"40";"Vallès Occidental";"08187";"Sabadell";"6";"23";"B";"748";"310";"504";"587";"161";"1";"1";"585";"586"
"8";"Barcelona";"1";"Barcelona";"40";"Vallès Occidental";"08187";"Sabadell";"6";"24";"U";"783";"265";"474";"600";"183";"7";"1";"592";"593"
"8";"Barcelona";"1";"Barcelona";"40";"Vallès Occidental";"08187";"Sabadell";"6";"3";"U";"698";"246";"415";"500";"198";"5";"1";"494";"495"
"8";"Barcelona";"1";"Barcelona";"40";"Vallès Occidental";"08187";"Sabadell";"6";"4";"A";"503";"182";"292";"358";"145";"1";"0";"357";"357"
"8";"Barcelona";"1";"Barcelona";"40";"Vallès Occidental";"08187";"Sabadell";"6";"4";"B";"564";"226";"352";"409";"155";"4";"3";"402";"405"
"8";"Barcelona";"1";"Barcelona";"40";"Vallès Occidental";"08187";"Sabadell";"6";"5";"U";"787";"244";"445";"537";"250";"2";"5";"530";"535"
"8";"Barcelona";"1";"Barcelona";"40";"Vallès Occidental";"08187";"Sabadell";"6";"6";"U";"803";"275";"432";"570";"233";"1";"7";"562";"569"
"8";"Barcelona";"1";"Barcelona";"40";"Vallès Occidental";"08187";"Sabadell";"6";"7";"U";"590";"190";"322";"374";"216";"3";"0";"371";"371"
"8";"Barcelona";"1";"Barcelona";"40";"Vallès Occidental";"08187";"Sabadell";"6";"8";"A";"529";"200";"332";"431";"98";"0";"1";"430";"431"
"8";"Barcelona";"1";"Barcelona";"40";"Vallès Occidental";"08187";"Sabadell";"6";"8";"B";"543";"212";"358";"435";"108";"1";"0";"434";"434"
"8";"Barcelona";"1";"Barcelona";"40";"Vallès Occidental";"08187";"Sabadell";"6";"9";"A";"574";"188";"316";"397";"177";"2";"0";"395";"395"
"8";"Barcelona";"1";"Barcelona";"40";"Vallès Occidental";"08187";"Sabadell";"6";"9";"B";"653";"221";"344";"434";"219";"4";"1";"429";"430"
"8";"Barcelona";"1";"Barcelona";"40";"Vallès Occidental";"08187";"Sabadell";"7";"1";"U";"731";"230";"393";"493";"238";"1";"3";"489";"492"
"8";"Barcelona";"1";"Barcelona";"40";"Vallès Occidental";"08187";"Sabadell";"7";"2";"U";"996";"327";"570";"706";"290";"1";"2";"703";"705"
"8";"Barcelona";"1";"Barcelona";"40";"Vallès Occidental";"08187";"Sabadell";"7";"3";"U";"633";"202";"375";"442";"191";"0";"0";"442";"442"
"8";"Barcelona";"1";"Barcelona";"40";"Vallès Occidental";"08187";"Sabadell";"7";"4";"U";"572";"213";"343";"438";"134";"1";"2";"435";"437"
"8";"Barcelona";"1";"Barcelona";"40";"Vallès Occidental";"08187";"Sabadell";"7";"5";"U";"823";"269";"499";"618";"205";"2";"1";"615";"616"
"8";"Barcelona";"1";"Barcelona";"40";"Vallès Occidental";"08187";"Sabadell";"7";"6";"U";"530";"177";"311";"407";"123";"1";"1";"405";"406"
"8";"Barcelona";"1";"Barcelona";"40";"Vallès Occidental";"08187";"Sabadell";"7";"7";"U";"952";"276";"547";"727";"225";"2";"1";"724";"725"
"8";"Barcelona";"1";"Barcelona";"40";"Vallès Occidental";"08187";"Sabadell";"7";"8";"U";"750";"217";"380";"463";"287";"3";"2";"458";"460"
"8";"Barcelona";"1";"Barcelona";"13";"Barcelonès";"08194";"Sant Adrià de Besòs";"1";"1";"A";"513";"157";"342";"361";"152";"0";"5";"356";"361"
"8";"Barcelona";"1";"Barcelona";"13";"Barcelonès";"08194";"Sant Adrià de Besòs";"1";"1";"B";"623";"211";"388";"467";"156";"1";"2";"464";"466"
"8";"Barcelona";"1";"Barcelona";"13";"Barcelonès";"08194";"Sant Adrià de Besòs";"1";"2";"A";"539";"196";"340";"405";"134";"0";"3";"402";"405"
"8";"Barcelona";"1";"Barcelona";"13";"Barcelonès";"08194";"Sant Adrià de Besòs";"1";"2";"B";"647";"255";"420";"515";"132";"4";"5";"506";"511"
"8";"Barcelona";"1";"Barcelona";"13";"Barcelonès";"08194";"Sant Adrià de Besòs";"1";"3";"A";"615";"198";"381";"466";"149";"1";"2";"463";"465"
"8";"Barcelona";"1";"Barcelona";"13";"Barcelonès";"08194";"Sant Adrià de Besòs";"1";"3";"B";"775";"243";"478";"585";"190";"6";"3";"576";"579"
"8";"Barcelona";"1";"Barcelona";"13";"Barcelonès";"08194";"Sant Adrià de Besòs";"1";"4";"A";"627";"199";"382";"489";"138";"0";"3";"486";"489"
"8";"Barcelona";"1";"Barcelona";"13";"Barcelonès";"08194";"Sant Adrià de Besòs";"1";"4";"B";"681";"228";"414";"520";"161";"1";"4";"515";"519"
"8";"Barcelona";"1";"Barcelona";"13";"Barcelonès";"08194";"Sant Adrià de Besòs";"1";"5";"A";"740";"257";"459";"573";"167";"1";"8";"564";"572"
"8";"Barcelona";"1";"Barcelona";"13";"Barcelonès";"08194";"Sant Adrià de Besòs";"1";"5";"B";"753";"261";"474";"584";"169";"0";"3";"581";"584"
"8";"Barcelona";"1";"Barcelona";"13";"Barcelonès";"08194";"Sant Adrià de Besòs";"1";"6";"A";"445";"163";"278";"339";"106";"0";"3";"336";"339"
"8";"Barcelona";"1";"Barcelona";"13";"Barcelonès";"08194";"Sant Adrià de Besòs";"1";"6";"B";"549";"183";"342";"427";"122";"0";"2";"425";"427"
"8";"Barcelona";"1";"Barcelona";"13";"Barcelonès";"08194";"Sant Adrià de Besòs";"2";"1";"A";"575";"180";"306";"397";"178";"1";"2";"394";"396"
"8";"Barcelona";"1";"Barcelona";"13";"Barcelonès";"08194";"Sant Adrià de Besòs";"2";"1";"B";"679";"218";"364";"479";"200";"0";"6";"473";"479"
"8";"Barcelona";"1";"Barcelona";"13";"Barcelonès";"08194";"Sant Adrià de Besòs";"2";"2";"A";"546";"139";"263";"358";"188";"1";"1";"356";"357"
"8";"Barcelona";"1";"Barcelona";"13";"Barcelonès";"08194";"Sant Adrià de Besòs";"2";"2";"B";"705";"219";"364";"464";"241";"6";"1";"457";"458"
"8";"Barcelona";"1";"Barcelona";"13";"Barcelonès";"08194";"Sant Adrià de Besòs";"2";"3";"A";"553";"156";"318";"407";"146";"0";"4";"403";"407"
"8";"Barcelona";"1";"Barcelona";"13";"Barcelonès";"08194";"Sant Adrià de Besòs";"2";"3";"B";"743";"200";"425";"541";"202";"4";"2";"535";"537"
"8";"Barcelona";"1";"Barcelona";"13";"Barcelonès";"08194";"Sant Adrià de Besòs";"2";"4";"A";"655";"236";"420";"506";"149";"1";"0";"505";"505"
"8";"Barcelona";"1";"Barcelona";"13";"Barcelonès";"08194";"Sant Adrià de Besòs";"2";"4";"B";"767";"277";"494";"611";"156";"0";"3";"608";"611"
"8";"Barcelona";"1";"Barcelona";"13";"Barcelonès";"08194";"Sant Adrià de Besòs";"2";"5";"A";"678";"270";"452";"578";"100";"1";"4";"573";"577"
"8";"Barcelona";"1";"Barcelona";"13";"Barcelonès";"08194";"Sant Adrià de Besòs";"2";"5";"B";"709";"263";"448";"585";"124";"0";"3";"582";"585"
"8";"Barcelona";"1";"Barcelona";"13";"Barcelonès";"08194";"Sant Adrià de Besòs";"3";"1";"U";"422";"163";"246";"285";"137";"0";"3";"282";"285"
"8";"Barcelona";"1";"Barcelona";"13";"Barcelonès";"08194";"Sant Adrià de Besòs";"4";"1";"U";"621";"206";"376";"468";"153";"0";"1";"467";"468"
"8";"Barcelona";"1";"Barcelona";"13";"Barcelonès";"08194";"Sant Adrià de Besòs";"5";"1";"A";"525";"197";"324";"403";"122";"1";"3";"399";"402"
"8";"Barcelona";"1";"Barcelona";"13";"Barcelonès";"08194";"Sant Adrià de Besòs";"5";"1";"B";"604";"207";"359";"455";"149";"1";"0";"454";"454"
"8";"Barcelona";"1";"Barcelona";"13";"Barcelonès";"08194";"Sant Adrià de Besòs";"5";"2";"A";"513";"200";"306";"375";"138";"2";"0";"373";"373"
"8";"Barcelona";"1";"Barcelona";"13";"Barcelonès";"08194";"Sant Adrià de Besòs";"5";"2";"B";"599";"215";"347";"419";"180";"5";"0";"414";"414"
"8";"Barcelona";"1";"Barcelona";"13";"Barcelonès";"08194";"Sant Adrià de Besòs";"5";"3";"U";"693";"228";"427";"513";"180";"2";"3";"508";"511"
"8";"Barcelona";"1";"Barcelona";"13";"Barcelonès";"08194";"Sant Adrià de Besòs";"5";"4";"A";"490";"153";"285";"348";"142";"6";"0";"342";"342"
"8";"Barcelona";"1";"Barcelona";"13";"Barcelonès";"08194";"Sant Adrià de Besòs";"5";"4";"B";"494";"169";"288";"344";"150";"0";"0";"344";"344"
"8";"Barcelona";"1";"Barcelona";"13";"Barcelonès";"08194";"Sant Adrià de Besòs";"6";"1";"U";"328";"82";"136";"166";"162";"1";"0";"165";"165"
"8";"Barcelona";"1";"Barcelona";"13";"Barcelonès";"08194";"Sant Adrià de Besòs";"6";"2";"A";"548";"117";"202";"253";"295";"5";"1";"247";"248"
"8";"Barcelona";"1";"Barcelona";"13";"Barcelonès";"08194";"Sant Adrià de Besòs";"6";"2";"B";"463";"104";"182";"222";"241";"3";"1";"218";"219"
"8";"Barcelona";"1";"Barcelona";"13";"Barcelonès";"08194";"Sant Adrià de Besòs";"6";"3";"U";"502";"103";"166";"215";"287";"2";"2";"211";"213"
"8";"Barcelona";"1";"Barcelona";"13";"Barcelonès";"08194";"Sant Adrià de Besòs";"6";"4";"A";"788";"112";"196";"260";"528";"0";"0";"260";"260"
"8";"Barcelona";"1";"Barcelona";"13";"Barcelonès";"08194";"Sant Adrià de Besòs";"6";"4";"B";"459";"103";"179";"218";"241";"0";"0";"218";"218"
"8";"Barcelona";"1";"Barcelona";"13";"Barcelonès";"08194";"Sant Adrià de Besòs";"6";"5";"A";"472";"163";"247";"293";"179";"2";"0";"291";"291"
"8";"Barcelona";"1";"Barcelona";"13";"Barcelonès";"08194";"Sant Adrià de Besòs";"6";"5";"B";"472";"163";"257";"312";"160";"1";"2";"309";"311"
"8";"Barcelona";"1";"Barcelona";"13";"Barcelonès";"08194";"Sant Adrià de Besòs";"6";"6";"A";"601";"133";"192";"251";"350";"0";"2";"249";"251"
"8";"Barcelona";"1";"Barcelona";"13";"Barcelonès";"08194";"Sant Adrià de Besòs";"6";"6";"B";"478";"125";"191";"249";"229";"1";"3";"245";"248"
"8";"Barcelona";"1";"Barcelona";"13";"Barcelonès";"08194";"Sant Adrià de Besòs";"6";"7";"A";"669";"213";"361";"449";"220";"0";"2";"447";"449"
"8";"Barcelona";"1";"Barcelona";"13";"Barcelonès";"08194";"Sant Adrià de Besòs";"6";"7";"B";"701";"235";"377";"468";"233";"4";"1";"463";"464"
"8";"Barcelona";"1";"Barcelona";"21";"Maresme";"08197";"Sant Andreu de Llavaneres";"1";"1";"A";"782";"297";"482";"592";"190";"6";"1";"585";"586"
"8";"Barcelona";"1";"Barcelona";"21";"Maresme";"08197";"Sant Andreu de Llavaneres";"1";"1";"B";"704";"277";"441";"540";"164";"1";"7";"532";"539"
"8";"Barcelona";"1";"Barcelona";"21";"Maresme";"08197";"Sant Andreu de Llavaneres";"1";"2";"A";"832";"292";"543";"584";"248";"3";"5";"576";"581"
"8";"Barcelona";"1";"Barcelona";"21";"Maresme";"08197";"Sant Andreu de Llavaneres";"1";"2";"B";"765";"275";"529";"642";"123";"0";"2";"640";"642"
"8";"Barcelona";"1";"Barcelona";"21";"Maresme";"08197";"Sant Andreu de Llavaneres";"1";"3";"A";"648";"235";"433";"522";"126";"2";"1";"519";"520"
"8";"Barcelona";"1";"Barcelona";"21";"Maresme";"08197";"Sant Andreu de Llavaneres";"1";"3";"B";"596";"212";"392";"475";"121";"2";"3";"470";"473"
"8";"Barcelona";"1";"Barcelona";"21";"Maresme";"08197";"Sant Andreu de Llavaneres";"2";"1";"A";"599";"193";"378";"475";"124";"2";"2";"471";"473"
"8";"Barcelona";"1";"Barcelona";"21";"Maresme";"08197";"Sant Andreu de Llavaneres";"2";"1";"B";"660";"196";"397";"504";"156";"0";"4";"500";"504"
"8";"Barcelona";"1";"Barcelona";"21";"Maresme";"08197";"Sant Andreu de Llavaneres";"2";"2";"A";"544";"204";"374";"446";"98";"1";"1";"444";"445"
"8";"Barcelona";"1";"Barcelona";"21";"Maresme";"08197";"Sant Andreu de Llavaneres";"2";"2";"B";"650";"267";"457";"535";"115";"0";"4";"531";"535"
"8";"Barcelona";"1";"Barcelona";"21";"Maresme";"08197";"Sant Andreu de Llavaneres";"2";"3";"U";"773";"333";"550";"645";"128";"0";"5";"640";"645"
"8";"Barcelona";"1";"Barcelona";"11";"Baix Llobregat";"08196";"Sant Andreu de la Barca";"1";"1";"A";"687";"231";"364";"454";"233";"1";"5";"448";"453"
"8";"Barcelona";"1";"Barcelona";"11";"Baix Llobregat";"08196";"Sant Andreu de la Barca";"1";"1";"B";"758";"260";"430";"537";"221";"2";"5";"530";"535"
"8";"Barcelona";"1";"Barcelona";"11";"Baix Llobregat";"08196";"Sant Andreu de la Barca";"1";"10";"A";"514";"176";"308";"380";"134";"3";"2";"375";"377"
"8";"Barcelona";"1";"Barcelona";"11";"Baix Llobregat";"08196";"Sant Andreu de la Barca";"1";"10";"B";"618";"189";"347";"429";"189";"1";"4";"424";"428"
"8";"Barcelona";"1";"Barcelona";"11";"Baix Llobregat";"08196";"Sant Andreu de la Barca";"1";"10";"C";"515";"178";"298";"358";"157";"1";"3";"354";"357"
"8";"Barcelona";"1";"Barcelona";"11";"Baix Llobregat";"08196";"Sant Andreu de la Barca";"1";"11";"A";"439";"171";"273";"350";"89";"2";"2";"346";"348"
"8";"Barcelona";"1";"Barcelona";"11";"Baix Llobregat";"08196";"Sant Andreu de la Barca";"1";"11";"B";"580";"225";"382";"477";"103";"0";"2";"475";"477"
"8";"Barcelona";"1";"Barcelona";"11";"Baix Llobregat";"08196";"Sant Andreu de la Barca";"1";"11";"C";"450";"169";"282";"357";"93";"0";"4";"353";"357"
"8";"Barcelona";"1";"Barcelona";"11";"Baix Llobregat";"08196";"Sant Andreu de la Barca";"1";"12";"A";"487";"167";"282";"364";"123";"1";"2";"361";"363"
"8";"Barcelona";"1";"Barcelona";"11";"Baix Llobregat";"08196";"Sant Andreu de la Barca";"1";"12";"B";"588";"214";"353";"443";"145";"2";"1";"440";"441"
"8";"Barcelona";"1";"Barcelona";"11";"Baix Llobregat";"08196";"Sant Andreu de la Barca";"1";"12";"C";"486";"180";"293";"353";"133";"0";"0";"353";"353"
"8";"Barcelona";"1";"Barcelona";"11";"Baix Llobregat";"08196";"Sant Andreu de la Barca";"1";"13";"A";"417";"159";"271";"339";"78";"1";"4";"334";"338"
"8";"Barcelona";"1";"Barcelona";"11";"Baix Llobregat";"08196";"Sant Andreu de la Barca";"1";"13";"B";"487";"187";"323";"405";"82";"0";"2";"403";"405"
"8";"Barcelona";"1";"Barcelona";"11";"Baix Llobregat";"08196";"Sant Andreu de la Barca";"1";"14";"A";"617";"184";"392";"508";"109";"1";"4";"503";"507"
"8";"Barcelona";"1";"Barcelona";"11";"Baix Llobregat";"08196";"Sant Andreu de la Barca";"1";"14";"B";"726";"204";"454";"589";"137";"5";"5";"579";"584"
"8";"Barcelona";"1";"Barcelona";"11";"Baix Llobregat";"08196";"Sant Andreu de la Barca";"1";"14";"C";"596";"172";"377";"474";"122";"1";"10";"463";"473"
"8";"Barcelona";"1";"Barcelona";"11";"Baix Llobregat";"08196";"Sant Andreu de la Barca";"1";"2";"A";"640";"207";"370";"466";"174";"2";"8";"456";"464"
"8";"Barcelona";"1";"Barcelona";"11";"Baix Llobregat";"08196";"Sant Andreu de la Barca";"1";"2";"B";"779";"242";"448";"563";"216";"1";"1";"561";"562"
"8";"Barcelona";"1";"Barcelona";"11";"Baix Llobregat";"08196";"Sant Andreu de la Barca";"1";"3";"A";"498";"179";"286";"361";"137";"3";"3";"355";"358"
"8";"Barcelona";"1";"Barcelona";"11";"Baix Llobregat";"08196";"Sant Andreu de la Barca";"1";"3";"B";"558";"193";"326";"394";"164";"0";"2";"392";"394"
"8";"Barcelona";"1";"Barcelona";"11";"Baix Llobregat";"08196";"Sant Andreu de la Barca";"1";"4";"A";"550";"178";"346";"422";"128";"1";"2";"419";"421"
"8";"Barcelona";"1";"Barcelona";"11";"Baix Llobregat";"08196";"Sant Andreu de la Barca";"1";"4";"B";"679";"231";"433";"528";"151";"1";"1";"526";"527"
"8";"Barcelona";"1";"Barcelona";"11";"Baix Llobregat";"08196";"Sant Andreu de la Barca";"1";"5";"A";"539";"190";"328";"426";"113";"3";"2";"421";"423"
"8";"Barcelona";"1";"Barcelona";"11";"Baix Llobregat";"08196";"Sant Andreu de la Barca";"1";"5";"B";"699";"266";"432";"549";"150";"0";"0";"549";"549"
"8";"Barcelona";"1";"Barcelona";"11";"Baix Llobregat";"08196";"Sant Andreu de la Barca";"1";"6";"A";"535";"182";"321";"408";"127";"0";"1";"407";"408"
"8";"Barcelona";"1";"Barcelona";"11";"Baix Llobregat";"08196";"Sant Andreu de la Barca";"1";"6";"B";"649";"203";"374";"486";"163";"1";"1";"484";"485"
"8";"Barcelona";"1";"Barcelona";"11";"Baix Llobregat";"08196";"Sant Andreu de la Barca";"1";"7";"A";"685";"228";"426";"541";"144";"3";"1";"537";"538"
"8";"Barcelona";"1";"Barcelona";"11";"Baix Llobregat";"08196";"Sant Andreu de la Barca";"1";"7";"B";"697";"250";"438";"557";"140";"3";"3";"551";"554"
"8";"Barcelona";"1";"Barcelona";"11";"Baix Llobregat";"08196";"Sant Andreu de la Barca";"1";"8";"A";"494";"158";"330";"427";"67";"1";"4";"422";"426"
"8";"Barcelona";"1";"Barcelona";"11";"Baix Llobregat";"08196";"Sant Andreu de la Barca";"1";"8";"B";"527";"185";"331";"458";"69";"2";"5";"451";"456"
"8";"Barcelona";"1";"Barcelona";"11";"Baix Llobregat";"08196";"Sant Andreu de la Barca";"1";"9";"A";"513";"165";"291";"383";"130";"0";"1";"382";"383"
"8";"Barcelona";"1";"Barcelona";"11";"Baix Llobregat";"08196";"Sant Andreu de la Barca";"1";"9";"B";"633";"220";"378";"487";"146";"2";"7";"478";"485"
"8";"Barcelona";"1";"Barcelona";"11";"Baix Llobregat";"08196";"Sant Andreu de la Barca";"1";"9";"C";"567";"209";"328";"434";"133";"3";"1";"430";"431"
"8";"Barcelona";"1";"Barcelona";"41";"Vallès Oriental";"08198";"Sant Antoni de Vilamajor";"1";"1";"A";"548";"244";"375";"453";"95";"0";"4";"449";"453"
"8";"Barcelona";"1";"Barcelona";"41";"Vallès Oriental";"08198";"Sant Antoni de Vilamajor";"1";"1";"B";"610";"242";"405";"498";"112";"1";"5";"492";"497"
"8";"Barcelona";"1";"Barcelona";"41";"Vallès Oriental";"08198";"Sant Antoni de Vilamajor";"1";"2";"A";"490";"175";"314";"384";"106";"0";"4";"380";"384"
"8";"Barcelona";"1";"Barcelona";"41";"Vallès Oriental";"08198";"Sant Antoni de Vilamajor";"1";"2";"B";"589";"235";"398";"466";"123";"1";"0";"465";"465"
"8";"Barcelona";"1";"Barcelona";"41";"Vallès Oriental";"08198";"Sant Antoni de Vilamajor";"1";"3";"A";"446";"212";"309";"372";"74";"1";"0";"371";"371"
"8";"Barcelona";"1";"Barcelona";"41";"Vallès Oriental";"08198";"Sant Antoni de Vilamajor";"1";"3";"B";"501";"230";"378";"444";"57";"0";"2";"442";"444"
"8";"Barcelona";"1";"Barcelona";"41";"Vallès Oriental";"08198";"Sant Antoni de Vilamajor";"1";"4";"A";"577";"229";"403";"475";"102";"1";"6";"468";"474"
"8";"Barcelona";"1";"Barcelona";"41";"Vallès Oriental";"08198";"Sant Antoni de Vilamajor";"1";"4";"B";"604";"214";"401";"491";"113";"0";"3";"488";"491"
"8";"Barcelona";"1";"Barcelona";"11";"Baix Llobregat";"08200";"Sant Boi de Llobregat";"1";"1";"U";"742";"221";"396";"511";"231";"3";"6";"502";"508"
"8";"Barcelona";"1";"Barcelona";"11";"Baix Llobregat";"08200";"Sant Boi de Llobregat";"1";"2";"A";"564";"187";"338";"422";"142";"1";"6";"415";"421"
"8";"Barcelona";"1";"Barcelona";"11";"Baix Llobregat";"08200";"Sant Boi de Llobregat";"1";"2";"B";"579";"148";"330";"435";"144";"2";"2";"431";"433"
"8";"Barcelona";"1";"Barcelona";"11";"Baix Llobregat";"08200";"Sant Boi de Llobregat";"1";"3";"A";"392";"131";"244";"308";"84";"0";"2";"306";"308"
"8";"Barcelona";"1";"Barcelona";"11";"Baix Llobregat";"08200";"Sant Boi de Llobregat";"1";"3";"B";"418";"131";"243";"308";"110";"2";"2";"304";"306"
"8";"Barcelona";"1";"Barcelona";"11";"Baix Llobregat";"08200";"Sant Boi de Llobregat";"1";"4";"A";"564";"172";"332";"423";"141";"2";"5";"416";"421"
"8";"Barcelona";"1";"Barcelona";"11";"Baix Llobregat";"08200";"Sant Boi de Llobregat";"1";"4";"B";"677";"213";"396";"494";"183";"2";"2";"490";"492"
"8";"Barcelona";"1";"Barcelona";"11";"Baix Llobregat";"08200";"Sant Boi de Llobregat";"1";"5";"A";"728";"197";"387";"509";"219";"1";"0";"508";"508"
"8";"Barcelona";"1";"Barcelona";"11";"Baix Llobregat";"08200";"Sant Boi de Llobregat";"1";"5";"B";"843";"202";"420";"552";"291";"5";"4";"543";"547"
"8";"Barcelona";"1";"Barcelona";"11";"Baix Llobregat";"08200";"Sant Boi de Llobregat";"1";"6";"U";"680";"246";"404";"495";"185";"2";"2";"491";"493"
"8";"Barcelona";"1";"Barcelona";"11";"Baix Llobregat";"08200";"Sant Boi de Llobregat";"1";"7";"A";"378";"117";"238";"299";"79";"0";"1";"298";"299"
"8";"Barcelona";"1";"Barcelona";"11";"Baix Llobregat";"08200";"Sant Boi de Llobregat";"1";"7";"B";"450";"158";"287";"348";"102";"2";"4";"342";"346"
"8";"Barcelona";"1";"Barcelona";"11";"Baix Llobregat";"08200";"Sant Boi de Llobregat";"2";"1";"A";"558";"177";"364";"461";"97";"3";"1";"457";"458"
"8";"Barcelona";"1";"Barcelona";"11";"Baix Llobregat";"08200";"Sant Boi de Llobregat";"2";"1";"B";"726";"242";"457";"628";"98";"2";"2";"624";"626"
"8";"Barcelona";"1";"Barcelona";"11";"Baix Llobregat";"08200";"Sant Boi de Llobregat";"2";"1";"C";"623";"186";"370";"517";"106";"1";"3";"513";"516"
"8";"Barcelona";"1";"Barcelona";"11";"Baix Llobregat";"08200";"Sant Boi de Llobregat";"2";"10";"A";"515";"187";"304";"386";"129";"2";"2";"382";"384"
"8";"Barcelona";"1";"Barcelona";"11";"Baix Llobregat";"08200";"Sant Boi de Llobregat";"2";"10";"B";"607";"203";"355";"471";"136";"0";"2";"469";"471"
"8";"Barcelona";"1";"Barcelona";"11";"Baix Llobregat";"08200";"Sant Boi de Llobregat";"2";"10";"C";"597";"204";"346";"443";"154";"2";"2";"439";"441"
"8";"Barcelona";"1";"Barcelona";"11";"Baix Llobregat";"08200";"Sant Boi de Llobregat";"2";"11";"A";"602";"213";"380";"510";"92";"3";"2";"505";"507"
"8";"Barcelona";"1";"Barcelona";"11";"Baix Llobregat";"08200";"Sant Boi de Llobregat";"2";"11";"B";"746";"275";"499";"632";"114";"4";"6";"622";"628"
"8";"Barcelona";"1";"Barcelona";"11";"Baix Llobregat";"08200";"Sant Boi de Llobregat";"2";"12";"A";"552";"188";"326";"418";"134";"0";"2";"416";"418"
"8";"Barcelona";"1";"Barcelona";"11";"Baix Llobregat";"08200";"Sant Boi de Llobregat";"2";"12";"B";"697";"236";"431";"543";"154";"4";"4";"535";"539"
"8";"Barcelona";"1";"Barcelona";"11";"Baix Llobregat";"08200";"Sant Boi de Llobregat";"2";"12";"C";"578";"210";"348";"435";"143";"0";"2";"433";"435"
"8";"Barcelona";"1";"Barcelona";"11";"Baix Llobregat";"08200";"Sant Boi de Llobregat";"2";"13";"A";"434";"163";"287";"368";"66";"1";"4";"363";"367"
"8";"Barcelona";"1";"Barcelona";"11";"Baix Llobregat";"08200";"Sant Boi de Llobregat";"2";"13";"B";"452";"147";"290";"388";"64";"0";"2";"386";"388"
"8";"Barcelona";"1";"Barcelona";"11";"Baix Llobregat";"08200";"Sant Boi de Llobregat";"2";"13";"C";"450";"168";"306";"393";"57";"0";"3";"390";"393"
"8";"Barcelona";"1";"Barcelona";"11";"Baix Llobregat";"08200";"Sant Boi de Llobregat";"2";"14";"A";"662";"207";"379";"492";"170";"5";"3";"484";"487"
"8";"Barcelona";"1";"Barcelona";"11";"Baix Llobregat";"08200";"Sant Boi de Llobregat";"2";"14";"B";"744";"213";"435";"568";"176";"1";"2";"565";"567"
"8";"Barcelona";"1";"Barcelona";"11";"Baix Llobregat";"08200";"Sant Boi de Llobregat";"2";"15";"A";"423";"139";"239";"292";"131";"3";"0";"289";"289"
"8";"Barcelona";"1";"Barcelona";"11";"Baix Llobregat";"08200";"Sant Boi de Llobregat";"2";"15";"B";"479";"162";"275";"362";"117";"2";"3";"357";"360"
"8";"Barcelona";"1";"Barcelona";"11";"Baix Llobregat";"08200";"Sant Boi de Llobregat";"2";"15";"C";"484";"144";"268";"340";"144";"1";"1";"338";"339"
"8";"Barcelona";"1";"Barcelona";"11";"Baix Llobregat";"08200";"Sant Boi de Llobregat";"2";"16";"A";"528";"201";"340";"431";"97";"0";"3";"428";"431"
"8";"Barcelona";"1";"Barcelona";"11";"Baix Llobregat";"08200";"Sant Boi de Llobregat";"2";"16";"B";"647";"253";"429";"556";"91";"2";"3";"551";"554"
"8";"Barcelona";"1";"Barcelona";"11";"Baix Llobregat";"08200";"Sant Boi de Llobregat";"2";"17";"A";"521";"147";"333";"435";"86";"2";"2";"431";"433"
"8";"Barcelona";"1";"Barcelona";"11";"Baix Llobregat";"08200";"Sant Boi de Llobregat";"2";"17";"B";"602";"166";"371";"506";"96";"3";"3";"500";"503"
"8";"Barcelona";"1";"Barcelona";"11";"Baix Llobregat";"08200";"Sant Boi de Llobregat";"2";"18";"A";"518";"163";"339";"430";"88";"1";"1";"428";"429"
"8";"Barcelona";"1";"Barcelona";"11";"Baix Llobregat";"08200";"Sant Boi de Llobregat";"2";"18";"B";"574";"179";"361";"475";"99";"1";"3";"471";"474"
"8";"Barcelona";"1";"Barcelona";"11";"Baix Llobregat";"08200";"Sant Boi de Llobregat";"2";"19";"U";"627";"233";"389";"512";"115";"4";"4";"504";"508"
"8";"Barcelona";"1";"Barcelona";"11";"Baix Llobregat";"08200";"Sant Boi de Llobregat";"2";"2";"A";"651";"218";"361";"454";"197";"0";"3";"451";"454"
"8";"Barcelona";"1";"Barcelona";"11";"Baix Llobregat";"08200";"Sant Boi de Llobregat";"2";"2";"B";"740";"244";"402";"526";"214";"1";"2";"523";"525"
"8";"Barcelona";"1";"Barcelona";"11";"Baix Llobregat";"08200";"Sant Boi de Llobregat";"2";"3";"A";"371";"103";"200";"252";"119";"0";"1";"251";"252"
"8";"Barcelona";"1";"Barcelona";"11";"Baix Llobregat";"08200";"Sant Boi de Llobregat";"2";"3";"B";"494";"163";"281";"356";"138";"3";"3";"350";"353"
"8";"Barcelona";"1";"Barcelona";"11";"Baix Llobregat";"08200";"Sant Boi de Llobregat";"2";"3";"C";"499";"160";"291";"371";"128";"3";"0";"368";"368"
"8";"Barcelona";"1";"Barcelona";"11";"Baix Llobregat";"08200";"Sant Boi de Llobregat";"2";"4";"A";"469";"151";"261";"339";"130";"3";"5";"331";"336"
"8";"Barcelona";"1";"Barcelona";"11";"Baix Llobregat";"08200";"Sant Boi de Llobregat";"2";"4";"B";"472";"143";"266";"357";"115";"1";"3";"353";"356"
"8";"Barcelona";"1";"Barcelona";"11";"Baix Llobregat";"08200";"Sant Boi de Llobregat";"2";"5";"A";"432";"134";"251";"320";"112";"1";"2";"317";"319"
"8";"Barcelona";"1";"Barcelona";"11";"Baix Llobregat";"08200";"Sant Boi de Llobregat";"2";"5";"B";"556";"160";"343";"442";"114";"0";"3";"439";"442"
"8";"Barcelona";"1";"Barcelona";"11";"Baix Llobregat";"08200";"Sant Boi de Llobregat";"2";"6";"A";"341";"115";"210";"265";"76";"2";"1";"262";"263"
"8";"Barcelona";"1";"Barcelona";"11";"Baix Llobregat";"08200";"Sant Boi de Llobregat";"2";"6";"B";"410";"131";"260";"330";"80";"0";"0";"330";"330"
"8";"Barcelona";"1";"Barcelona";"11";"Baix Llobregat";"08200";"Sant Boi de Llobregat";"2";"6";"C";"443";"160";"274";"346";"97";"2";"2";"342";"344"
"8";"Barcelona";"1";"Barcelona";"11";"Baix Llobregat";"08200";"Sant Boi de Llobregat";"2";"7";"A";"376";"137";"219";"268";"108";"1";"1";"266";"267"
"8";"Barcelona";"1";"Barcelona";"11";"Baix Llobregat";"08200";"Sant Boi de Llobregat";"2";"7";"B";"448";"153";"260";"327";"121";"6";"1";"320";"321"
"8";"Barcelona";"1";"Barcelona";"11";"Baix Llobregat";"08200";"Sant Boi de Llobregat";"2";"8";"A";"522";"178";"340";"423";"99";"1";"0";"422";"422"
"8";"Barcelona";"1";"Barcelona";"11";"Baix Llobregat";"08200";"Sant Boi de Llobregat";"2";"8";"B";"620";"227";"418";"494";"126";"2";"2";"490";"492"
"8";"Barcelona";"1";"Barcelona";"11";"Baix Llobregat";"08200";"Sant Boi de Llobregat";"2";"9";"A";"599";"189";"362";"452";"147";"1";"1";"450";"451"
"8";"Barcelona";"1";"Barcelona";"11";"Baix Llobregat";"08200";"Sant Boi de Llobregat";"2";"9";"B";"610";"179";"334";"425";"185";"1";"4";"420";"424"
"8";"Barcelona";"1";"Barcelona";"11";"Baix Llobregat";"08200";"Sant Boi de Llobregat";"3";"1";"A";"578";"181";"371";"468";"110";"5";"3";"460";"463"
"8";"Barcelona";"1";"Barcelona";"11";"Baix Llobregat";"08200";"Sant Boi de Llobregat";"3";"1";"B";"647";"211";"410";"503";"144";"1";"3";"499";"502"
"8";"Barcelona";"1";"Barcelona";"11";"Baix Llobregat";"08200";"Sant Boi de Llobregat";"3";"2";"A";"672";"243";"438";"525";"147";"2";"2";"521";"523"
"8";"Barcelona";"1";"Barcelona";"11";"Baix Llobregat";"08200";"Sant Boi de Llobregat";"3";"2";"B";"787";"301";"580";"630";"157";"3";"1";"626";"627"
"8";"Barcelona";"1";"Barcelona";"11";"Baix Llobregat";"08200";"Sant Boi de Llobregat";"3";"3";"A";"457";"169";"259";"342";"115";"4";"0";"338";"338"
"8";"Barcelona";"1";"Barcelona";"11";"Baix Llobregat";"08200";"Sant Boi de Llobregat";"3";"3";"B";"501";"192";"288";"381";"120";"0";"2";"379";"381"
"8";"Barcelona";"1";"Barcelona";"11";"Baix Llobregat";"08200";"Sant Boi de Llobregat";"3";"3";"C";"560";"203";"341";"424";"136";"3";"0";"421";"421"
"8";"Barcelona";"1";"Barcelona";"11";"Baix Llobregat";"08200";"Sant Boi de Llobregat";"3";"4";"U";"712";"257";"425";"543";"169";"0";"4";"539";"543"
"8";"Barcelona";"1";"Barcelona";"11";"Baix Llobregat";"08200";"Sant Boi de Llobregat";"3";"5";"A";"499";"170";"305";"376";"123";"5";"1";"370";"371"
"8";"Barcelona";"1";"Barcelona";"11";"Baix Llobregat";"08200";"Sant Boi de Llobregat";"3";"5";"B";"577";"193";"360";"451";"126";"1";"0";"450";"450"
"8";"Barcelona";"1";"Barcelona";"11";"Baix Llobregat";"08200";"Sant Boi de Llobregat";"3";"5";"C";"623";"216";"379";"483";"140";"1";"1";"481";"482"
"8";"Barcelona";"1";"Barcelona";"11";"Baix Llobregat";"08200";"Sant Boi de Llobregat";"3";"6";"A";"492";"223";"312";"384";"108";"1";"1";"382";"383"
"8";"Barcelona";"1";"Barcelona";"11";"Baix Llobregat";"08200";"Sant Boi de Llobregat";"3";"6";"B";"595";"198";"384";"471";"124";"0";"1";"470";"471"
"8";"Barcelona";"1";"Barcelona";"11";"Baix Llobregat";"08200";"Sant Boi de Llobregat";"3";"7";"A";"488";"185";"304";"375";"113";"1";"2";"372";"374"
"8";"Barcelona";"1";"Barcelona";"11";"Baix Llobregat";"08200";"Sant Boi de Llobregat";"3";"7";"B";"522";"200";"345";"411";"111";"2";"4";"405";"409"
"8";"Barcelona";"1";"Barcelona";"11";"Baix Llobregat";"08200";"Sant Boi de Llobregat";"3";"7";"C";"542";"212";"370";"450";"92";"0";"3";"447";"450"
"8";"Barcelona";"1";"Barcelona";"11";"Baix Llobregat";"08200";"Sant Boi de Llobregat";"3";"8";"U";"590";"218";"367";"446";"144";"0";"4";"442";"446"
"8";"Barcelona";"1";"Barcelona";"11";"Baix Llobregat";"08200";"Sant Boi de Llobregat";"3";"9";"A";"391";"141";"231";"295";"96";"1";"1";"293";"294"
"8";"Barcelona";"1";"Barcelona";"11";"Baix Llobregat";"08200";"Sant Boi de Llobregat";"3";"9";"B";"517";"178";"291";"357";"160";"0";"2";"355";"357"
"8";"Barcelona";"1";"Barcelona";"11";"Baix Llobregat";"08200";"Sant Boi de Llobregat";"4";"1";"A";"484";"177";"309";"390";"94";"2";"1";"387";"388"
"8";"Barcelona";"1";"Barcelona";"11";"Baix Llobregat";"08200";"Sant Boi de Llobregat";"4";"1";"B";"555";"188";"356";"452";"103";"0";"1";"451";"452"
"8";"Barcelona";"1";"Barcelona";"11";"Baix Llobregat";"08200";"Sant Boi de Llobregat";"4";"1";"C";"599";"194";"372";"477";"122";"1";"3";"473";"476"
"8";"Barcelona";"1";"Barcelona";"11";"Baix Llobregat";"08200";"Sant Boi de Llobregat";"4";"2";"A";"475";"173";"296";"385";"90";"0";"3";"382";"385"
"8";"Barcelona";"1";"Barcelona";"11";"Baix Llobregat";"08200";"Sant Boi de Llobregat";"4";"2";"B";"559";"202";"352";"440";"119";"2";"1";"437";"438"
"8";"Barcelona";"1";"Barcelona";"11";"Baix Llobregat";"08200";"Sant Boi de Llobregat";"4";"2";"C";"544";"189";"368";"450";"94";"0";"4";"446";"450"
"8";"Barcelona";"1";"Barcelona";"11";"Baix Llobregat";"08200";"Sant Boi de Llobregat";"4";"3";"A";"463";"168";"279";"353";"110";"4";"1";"348";"349"
"8";"Barcelona";"1";"Barcelona";"11";"Baix Llobregat";"08200";"Sant Boi de Llobregat";"4";"3";"B";"550";"170";"320";"429";"121";"2";"2";"425";"427"
"8";"Barcelona";"1";"Barcelona";"11";"Baix Llobregat";"08200";"Sant Boi de Llobregat";"4";"4";"A";"434";"172";"291";"343";"91";"0";"1";"342";"343"
"8";"Barcelona";"1";"Barcelona";"11";"Baix Llobregat";"08200";"Sant Boi de Llobregat";"4";"4";"B";"590";"229";"381";"469";"121";"1";"3";"465";"468"
"8";"Barcelona";"1";"Barcelona";"11";"Baix Llobregat";"08200";"Sant Boi de Llobregat";"4";"5";"A";"626";"233";"370";"484";"142";"0";"2";"482";"484"
"8";"Barcelona";"1";"Barcelona";"11";"Baix Llobregat";"08200";"Sant Boi de Llobregat";"4";"5";"B";"730";"262";"446";"569";"161";"0";"6";"563";"569"
"8";"Barcelona";"1";"Barcelona";"11";"Baix Llobregat";"08200";"Sant Boi de Llobregat";"4";"6";"A";"433";"162";"258";"321";"112";"1";"1";"319";"320"
"8";"Barcelona";"1";"Barcelona";"11";"Baix Llobregat";"08200";"Sant Boi de Llobregat";"4";"6";"B";"607";"189";"320";"416";"191";"2";"0";"414";"414"
"8";"Barcelona";"1";"Barcelona";"11";"Baix Llobregat";"08200";"Sant Boi de Llobregat";"4";"6";"C";"490";"164";"282";"379";"111";"2";"2";"375";"377"
"8";"Barcelona";"1";"Barcelona";"11";"Baix Llobregat";"08200";"Sant Boi de Llobregat";"4";"7";"A";"692";"222";"411";"527";"165";"1";"2";"524";"526"
"8";"Barcelona";"1";"Barcelona";"11";"Baix Llobregat";"08200";"Sant Boi de Llobregat";"4";"7";"B";"766";"243";"459";"589";"177";"0";"3";"586";"589"
"8";"Barcelona";"1";"Barcelona";"11";"Baix Llobregat";"08200";"Sant Boi de Llobregat";"4";"8";"A";"667";"211";"394";"504";"163";"2";"3";"499";"502"
"8";"Barcelona";"1";"Barcelona";"11";"Baix Llobregat";"08200";"Sant Boi de Llobregat";"4";"8";"B";"755";"253";"446";"589";"166";"2";"4";"583";"587"
"8";"Barcelona";"1";"Barcelona";"11";"Baix Llobregat";"08200";"Sant Boi de Llobregat";"4";"9";"A";"443";"211";"251";"340";"103";"0";"0";"340";"340"
"8";"Barcelona";"1";"Barcelona";"11";"Baix Llobregat";"08200";"Sant Boi de Llobregat";"4";"9";"B";"507";"149";"301";"397";"110";"0";"3";"394";"397"
"8";"Barcelona";"1";"Barcelona";"11";"Baix Llobregat";"08200";"Sant Boi de Llobregat";"5";"1";"A";"602";"192";"334";"414";"188";"1";"1";"412";"413"
"8";"Barcelona";"1";"Barcelona";"11";"Baix Llobregat";"08200";"Sant Boi de Llobregat";"5";"1";"B";"733";"263";"411";"497";"236";"2";"4";"491";"495"
"8";"Barcelona";"1";"Barcelona";"11";"Baix Llobregat";"08200";"Sant Boi de Llobregat";"5";"2";"A";"530";"159";"284";"326";"204";"3";"4";"319";"323"
"8";"Barcelona";"1";"Barcelona";"11";"Baix Llobregat";"08200";"Sant Boi de Llobregat";"5";"2";"B";"600";"193";"326";"390";"210";"0";"0";"390";"390"
"8";"Barcelona";"1";"Barcelona";"11";"Baix Llobregat";"08200";"Sant Boi de Llobregat";"5";"3";"A";"543";"164";"268";"329";"214";"0";"0";"329";"329"
"8";"Barcelona";"1";"Barcelona";"11";"Baix Llobregat";"08200";"Sant Boi de Llobregat";"5";"3";"B";"609";"204";"337";"398";"211";"0";"1";"397";"398"
"8";"Barcelona";"1";"Barcelona";"11";"Baix Llobregat";"08200";"Sant Boi de Llobregat";"6";"1";"A";"457";"136";"279";"358";"99";"0";"4";"354";"358"
"8";"Barcelona";"1";"Barcelona";"11";"Baix Llobregat";"08200";"Sant Boi de Llobregat";"6";"1";"B";"599";"216";"380";"475";"124";"4";"2";"469";"471"
"8";"Barcelona";"1";"Barcelona";"11";"Baix Llobregat";"08200";"Sant Boi de Llobregat";"6";"1";"C";"647";"218";"391";"503";"144";"1";"3";"499";"502"
"8";"Barcelona";"1";"Barcelona";"11";"Baix Llobregat";"08200";"Sant Boi de Llobregat";"6";"2";"A";"441";"149";"253";"324";"117";"0";"0";"324";"324"
"8";"Barcelona";"1";"Barcelona";"11";"Baix Llobregat";"08200";"Sant Boi de Llobregat";"6";"2";"B";"478";"180";"300";"365";"113";"1";"1";"363";"364"
"8";"Barcelona";"1";"Barcelona";"11";"Baix Llobregat";"08200";"Sant Boi de Llobregat";"6";"2";"C";"482";"176";"284";"361";"121";"0";"1";"360";"361"
"8";"Barcelona";"1";"Barcelona";"11";"Baix Llobregat";"08200";"Sant Boi de Llobregat";"6";"3";"A";"408";"131";"239";"284";"124";"0";"1";"283";"284"
"8";"Barcelona";"1";"Barcelona";"11";"Baix Llobregat";"08200";"Sant Boi de Llobregat";"6";"3";"B";"428";"125";"230";"304";"124";"1";"2";"301";"303"
"8";"Barcelona";"1";"Barcelona";"21";"Maresme";"08203";"Sant Cebrià de Vallalta";"1";"1";"A";"600";"204";"383";"473";"127";"2";"1";"470";"471"
"8";"Barcelona";"1";"Barcelona";"21";"Maresme";"08203";"Sant Cebrià de Vallalta";"1";"1";"B";"701";"233";"432";"531";"170";"2";"3";"526";"529"
"8";"Barcelona";"1";"Barcelona";"21";"Maresme";"08203";"Sant Cebrià de Vallalta";"1";"2";"A";"478";"163";"290";"355";"123";"0";"0";"355";"355"
"8";"Barcelona";"1";"Barcelona";"21";"Maresme";"08203";"Sant Cebrià de Vallalta";"1";"2";"B";"622";"219";"370";"468";"154";"1";"3";"464";"467"
"8";"Barcelona";"1";"Barcelona";"41";"Vallès Oriental";"08202";"Sant Celoni";"1";"1";"A";"653";"266";"471";"561";"92";"3";"4";"554";"558"
"8";"Barcelona";"1";"Barcelona";"41";"Vallès Oriental";"08202";"Sant Celoni";"1";"1";"B";"796";"303";"575";"681";"115";"4";"11";"666";"677"
"8";"Barcelona";"1";"Barcelona";"41";"Vallès Oriental";"08202";"Sant Celoni";"1";"2";"A";"667";"275";"513";"564";"103";"3";"5";"556";"561"
"8";"Barcelona";"1";"Barcelona";"41";"Vallès Oriental";"08202";"Sant Celoni";"1";"2";"B";"647";"264";"424";"498";"149";"0";"0";"498";"498"
"8";"Barcelona";"1";"Barcelona";"41";"Vallès Oriental";"08202";"Sant Celoni";"1";"2";"C";"657";"279";"467";"542";"115";"2";"3";"537";"540"
"8";"Barcelona";"1";"Barcelona";"41";"Vallès Oriental";"08202";"Sant Celoni";"1";"3";"A";"564";"225";"371";"448";"116";"5";"4";"439";"443"
"8";"Barcelona";"1";"Barcelona";"41";"Vallès Oriental";"08202";"Sant Celoni";"1";"3";"B";"700";"261";"443";"544";"156";"5";"6";"533";"539"
"8";"Barcelona";"1";"Barcelona";"41";"Vallès Oriental";"08202";"Sant Celoni";"1";"3";"C";"686";"242";"437";"540";"146";"3";"5";"532";"537"
"8";"Barcelona";"1";"Barcelona";"41";"Vallès Oriental";"08202";"Sant Celoni";"1";"4";"A";"255";"98";"153";"186";"69";"0";"0";"186";"186"
"8";"Barcelona";"1";"Barcelona";"41";"Vallès Oriental";"08202";"Sant Celoni";"1";"4";"B";"330";"116";"203";"247";"83";"1";"5";"241";"246"
"8";"Barcelona";"1";"Barcelona";"41";"Vallès Oriental";"08202";"Sant Celoni";"1";"5";"A";"916";"350";"616";"721";"195";"5";"6";"710";"716"
"8";"Barcelona";"1";"Barcelona";"41";"Vallès Oriental";"08202";"Sant Celoni";"1";"5";"B";"972";"370";"648";"789";"183";"4";"5";"780";"785"
"8";"Barcelona";"1";"Barcelona";"41";"Vallès Oriental";"08202";"Sant Celoni";"1";"6";"A";"570";"218";"351";"457";"113";"2";"3";"452";"455"
"8";"Barcelona";"1";"Barcelona";"41";"Vallès Oriental";"08202";"Sant Celoni";"1";"6";"B";"677";"239";"421";"529";"148";"0";"2";"527";"529"
"8";"Barcelona";"1";"Barcelona";"41";"Vallès Oriental";"08202";"Sant Celoni";"1";"7";"A";"544";"185";"345";"408";"136";"1";"2";"405";"407"
"8";"Barcelona";"1";"Barcelona";"41";"Vallès Oriental";"08202";"Sant Celoni";"1";"7";"B";"640";"232";"400";"488";"152";"2";"1";"485";"486"
"8";"Barcelona";"1";"Barcelona";"41";"Vallès Oriental";"08202";"Sant Celoni";"1";"8";"A";"361";"148";"246";"310";"51";"1";"1";"308";"309"
"8";"Barcelona";"1";"Barcelona";"41";"Vallès Oriental";"08202";"Sant Celoni";"1";"8";"B";"446";"170";"300";"383";"63";"2";"4";"377";"381"
"8";"Barcelona";"1";"Barcelona";"41";"Vallès Oriental";"08202";"Sant Celoni";"2";"1";"A";"910";"335";"580";"683";"227";"5";"0";"678";"678"
"8";"Barcelona";"1";"Barcelona";"41";"Vallès Oriental";"08202";"Sant Celoni";"2";"1";"B";"587";"237";"386";"462";"125";"1";"0";"461";"461"
"8";"Barcelona";"1";"Barcelona";"11";"Baix Llobregat";"08204";"Sant Climent de Llobregat";"1";"1";"A";"464";"164";"316";"401";"63";"0";"5";"396";"401"
"8";"Barcelona";"1";"Barcelona";"11";"Baix Llobregat";"08204";"Sant Climent de Llobregat";"1";"1";"B";"626";"188";"390";"513";"113";"2";"4";"507";"511"
"8";"Barcelona";"1";"Barcelona";"11";"Baix Llobregat";"08204";"Sant Climent de Llobregat";"1";"1";"C";"522";"171";"343";"448";"74";"3";"3";"442";"445"
"8";"Barcelona";"1";"Barcelona";"11";"Baix Llobregat";"08204";"Sant Climent de Llobregat";"1";"2";"A";"607";"184";"357";"464";"143";"4";"1";"459";"460"
"8";"Barcelona";"1";"Barcelona";"11";"Baix Llobregat";"08204";"Sant Climent de Llobregat";"1";"2";"B";"834";"254";"544";"673";"161";"1";"6";"666";"672"
"8";"Barcelona";"1";"Barcelona";"3";"Alt Penedès";"08206";"Sant Cugat Sesgarrigues";"1";"1";"U";"734";"298";"538";"634";"100";"4";"4";"626";"630"
"8";"Barcelona";"1";"Barcelona";"40";"Vallès Occidental";"08205";"Sant Cugat del Vallès";"1";"1";"A";"641";"270";"435";"522";"119";"4";"1";"517";"518"
"8";"Barcelona";"1";"Barcelona";"40";"Vallès Occidental";"08205";"Sant Cugat del Vallès";"1";"1";"B";"650";"280";"446";"520";"130";"1";"3";"516";"519"
"8";"Barcelona";"1";"Barcelona";"40";"Vallès Occidental";"08205";"Sant Cugat del Vallès";"1";"10";"U";"976";"335";"609";"738";"238";"5";"1";"732";"733"
"8";"Barcelona";"1";"Barcelona";"40";"Vallès Occidental";"08205";"Sant Cugat del Vallès";"1";"11";"A";"583";"199";"379";"481";"102";"0";"2";"479";"481"
"8";"Barcelona";"1";"Barcelona";"40";"Vallès Occidental";"08205";"Sant Cugat del Vallès";"1";"11";"B";"699";"250";"472";"570";"129";"1";"3";"566";"569"
"8";"Barcelona";"1";"Barcelona";"40";"Vallès Occidental";"08205";"Sant Cugat del Vallès";"1";"12";"A";"846";"283";"603";"717";"129";"1";"3";"713";"716"
"8";"Barcelona";"1";"Barcelona";"40";"Vallès Occidental";"08205";"Sant Cugat del Vallès";"1";"12";"B";"785";"244";"555";"674";"111";"1";"1";"672";"673"
"8";"Barcelona";"1";"Barcelona";"40";"Vallès Occidental";"08205";"Sant Cugat del Vallès";"1";"13";"A";"478";"165";"344";"434";"44";"1";"4";"429";"433"
"8";"Barcelona";"1";"Barcelona";"40";"Vallès Occidental";"08205";"Sant Cugat del Vallès";"1";"13";"B";"525";"195";"387";"472";"53";"0";"3";"469";"472"
"8";"Barcelona";"1";"Barcelona";"40";"Vallès Occidental";"08205";"Sant Cugat del Vallès";"1";"14";"U";"683";"261";"509";"619";"64";"0";"3";"616";"619"
"8";"Barcelona";"1";"Barcelona";"40";"Vallès Occidental";"08205";"Sant Cugat del Vallès";"1";"15";"A";"784";"316";"566";"709";"75";"5";"5";"699";"704"
"8";"Barcelona";"1";"Barcelona";"40";"Vallès Occidental";"08205";"Sant Cugat del Vallès";"1";"15";"B";"810";"308";"593";"726";"84";"3";"5";"718";"723"
"8";"Barcelona";"1";"Barcelona";"40";"Vallès Occidental";"08205";"Sant Cugat del Vallès";"1";"16";"U";"746";"273";"535";"668";"78";"2";"2";"664";"666"
"8";"Barcelona";"1";"Barcelona";"40";"Vallès Occidental";"08205";"Sant Cugat del Vallès";"1";"17";"A";"728";"253";"469";"598";"130";"2";"3";"593";"596"
"8";"Barcelona";"1";"Barcelona";"40";"Vallès Occidental";"08205";"Sant Cugat del Vallès";"1";"17";"B";"760";"260";"502";"634";"126";"1";"0";"633";"633"
"8";"Barcelona";"1";"Barcelona";"40";"Vallès Occidental";"08205";"Sant Cugat del Vallès";"1";"18";"A";"533";"236";"383";"454";"79";"1";"3";"450";"453"
"8";"Barcelona";"1";"Barcelona";"40";"Vallès Occidental";"08205";"Sant Cugat del Vallès";"1";"18";"B";"573";"230";"416";"500";"73";"0";"2";"498";"500"
"8";"Barcelona";"1";"Barcelona";"40";"Vallès Occidental";"08205";"Sant Cugat del Vallès";"1";"19";"U";"724";"295";"525";"644";"80";"0";"7";"637";"644"
"8";"Barcelona";"1";"Barcelona";"40";"Vallès Occidental";"08205";"Sant Cugat del Vallès";"1";"2";"A";"572";"226";"388";"479";"93";"3";"2";"474";"476"
"8";"Barcelona";"1";"Barcelona";"40";"Vallès Occidental";"08205";"Sant Cugat del Vallès";"1";"2";"B";"558";"216";"382";"461";"97";"0";"3";"458";"461"
"8";"Barcelona";"1";"Barcelona";"40";"Vallès Occidental";"08205";"Sant Cugat del Vallès";"1";"20";"U";"967";"356";"713";"839";"128";"2";"7";"830";"837"
"8";"Barcelona";"1";"Barcelona";"40";"Vallès Occidental";"08205";"Sant Cugat del Vallès";"1";"21";"U";"692";"257";"504";"583";"109";"0";"1";"582";"583"
"8";"Barcelona";"1";"Barcelona";"40";"Vallès Occidental";"08205";"Sant Cugat del Vallès";"1";"22";"U";"928";"337";"622";"704";"224";"1";"2";"701";"703"
"8";"Barcelona";"1";"Barcelona";"40";"Vallès Occidental";"08205";"Sant Cugat del Vallès";"1";"23";"A";"502";"185";"360";"451";"51";"1";"3";"447";"450"
"8";"Barcelona";"1";"Barcelona";"40";"Vallès Occidental";"08205";"Sant Cugat del Vallès";"1";"23";"B";"548";"194";"401";"494";"54";"2";"1";"491";"492"
"8";"Barcelona";"1";"Barcelona";"40";"Vallès Occidental";"08205";"Sant Cugat del Vallès";"1";"3";"U";"862";"259";"571";"709";"153";"3";"2";"704";"706"
"8";"Barcelona";"1";"Barcelona";"40";"Vallès Occidental";"08205";"Sant Cugat del Vallès";"1";"4";"A";"696";"271";"491";"600";"96";"3";"3";"594";"597"
"8";"Barcelona";"1";"Barcelona";"40";"Vallès Occidental";"08205";"Sant Cugat del Vallès";"1";"4";"B";"738";"295";"515";"635";"103";"2";"3";"630";"633"
"8";"Barcelona";"1";"Barcelona";"40";"Vallès Occidental";"08205";"Sant Cugat del Vallès";"1";"5";"A";"573";"184";"352";"469";"104";"0";"6";"463";"469"
"8";"Barcelona";"1";"Barcelona";"40";"Vallès Occidental";"08205";"Sant Cugat del Vallès";"1";"5";"B";"622";"215";"386";"501";"121";"0";"0";"501";"501"
"8";"Barcelona";"1";"Barcelona";"40";"Vallès Occidental";"08205";"Sant Cugat del Vallès";"1";"6";"A";"797";"265";"518";"627";"170";"2";"3";"622";"625"
"8";"Barcelona";"1";"Barcelona";"40";"Vallès Occidental";"08205";"Sant Cugat del Vallès";"1";"6";"B";"993";"280";"600";"774";"219";"1";"3";"770";"773"
"8";"Barcelona";"1";"Barcelona";"40";"Vallès Occidental";"08205";"Sant Cugat del Vallès";"1";"7";"U";"681";"268";"459";"534";"147";"1";"5";"528";"533"
"8";"Barcelona";"1";"Barcelona";"40";"Vallès Occidental";"08205";"Sant Cugat del Vallès";"1";"8";"A";"748";"232";"467";"593";"155";"2";"2";"589";"591"
"8";"Barcelona";"1";"Barcelona";"40";"Vallès Occidental";"08205";"Sant Cugat del Vallès";"1";"8";"B";"951";"335";"630";"772";"179";"1";"3";"768";"771"
"8";"Barcelona";"1";"Barcelona";"40";"Vallès Occidental";"08205";"Sant Cugat del Vallès";"1";"9";"A";"592";"235";"452";"534";"58";"0";"2";"532";"534"
"8";"Barcelona";"1";"Barcelona";"40";"Vallès Occidental";"08205";"Sant Cugat del Vallès";"1";"9";"B";"627";"231";"436";"533";"94";"1";"3";"529";"532"
"8";"Barcelona";"1";"Barcelona";"40";"Vallès Occidental";"08205";"Sant Cugat del Vallès";"2";"1";"A";"504";"172";"360";"448";"56";"2";"2";"444";"446"
"8";"Barcelona";"1";"Barcelona";"40";"Vallès Occidental";"08205";"Sant Cugat del Vallès";"2";"1";"B";"565";"180";"434";"501";"64";"1";"3";"497";"500"
"8";"Barcelona";"1";"Barcelona";"40";"Vallès Occidental";"08205";"Sant Cugat del Vallès";"2";"10";"A";"596";"228";"437";"531";"65";"1";"3";"527";"530"
"8";"Barcelona";"1";"Barcelona";"40";"Vallès Occidental";"08205";"Sant Cugat del Vallès";"2";"10";"B";"770";"264";"575";"689";"81";"3";"4";"682";"686"
"8";"Barcelona";"1";"Barcelona";"40";"Vallès Occidental";"08205";"Sant Cugat del Vallès";"2";"11";"A";"498";"171";"318";"418";"80";"1";"1";"416";"417"
"8";"Barcelona";"1";"Barcelona";"40";"Vallès Occidental";"08205";"Sant Cugat del Vallès";"2";"11";"B";"481";"137";"306";"400";"81";"1";"0";"399";"399"
"8";"Barcelona";"1";"Barcelona";"40";"Vallès Occidental";"08205";"Sant Cugat del Vallès";"2";"12";"A";"567";"220";"409";"494";"73";"1";"3";"490";"493"
"8";"Barcelona";"1";"Barcelona";"40";"Vallès Occidental";"08205";"Sant Cugat del Vallès";"2";"12";"B";"584";"221";"421";"523";"61";"0";"1";"522";"523"
"8";"Barcelona";"1";"Barcelona";"40";"Vallès Occidental";"08205";"Sant Cugat del Vallès";"2";"2";"A";"640";"210";"417";"520";"120";"0";"2";"518";"520"
"8";"Barcelona";"1";"Barcelona";"40";"Vallès Occidental";"08205";"Sant Cugat del Vallès";"2";"2";"B";"655";"268";"451";"553";"102";"1";"1";"551";"552"
"8";"Barcelona";"1";"Barcelona";"40";"Vallès Occidental";"08205";"Sant Cugat del Vallès";"2";"3";"A";"507";"166";"286";"347";"160";"0";"0";"347";"347"
"8";"Barcelona";"1";"Barcelona";"40";"Vallès Occidental";"08205";"Sant Cugat del Vallès";"2";"3";"B";"581";"196";"340";"429";"152";"1";"6";"422";"428"
"8";"Barcelona";"1";"Barcelona";"40";"Vallès Occidental";"08205";"Sant Cugat del Vallès";"2";"4";"U";"921";"354";"621";"771";"150";"4";"5";"762";"767"
"8";"Barcelona";"1";"Barcelona";"40";"Vallès Occidental";"08205";"Sant Cugat del Vallès";"2";"5";"U";"940";"316";"596";"733";"207";"2";"6";"725";"731"
"8";"Barcelona";"1";"Barcelona";"40";"Vallès Occidental";"08205";"Sant Cugat del Vallès";"2";"6";"A";"597";"209";"433";"518";"79";"0";"6";"512";"518"
"8";"Barcelona";"1";"Barcelona";"40";"Vallès Occidental";"08205";"Sant Cugat del Vallès";"2";"6";"B";"597";"229";"417";"513";"84";"0";"3";"510";"513"
"8";"Barcelona";"1";"Barcelona";"40";"Vallès Occidental";"08205";"Sant Cugat del Vallès";"2";"7";"A";"536";"213";"345";"436";"100";"3";"3";"430";"433"
"8";"Barcelona";"1";"Barcelona";"40";"Vallès Occidental";"08205";"Sant Cugat del Vallès";"2";"7";"B";"588";"275";"409";"495";"93";"1";"1";"493";"494"
"8";"Barcelona";"1";"Barcelona";"40";"Vallès Occidental";"08205";"Sant Cugat del Vallès";"2";"8";"A";"591";"228";"425";"504";"87";"2";"6";"496";"502"
"8";"Barcelona";"1";"Barcelona";"40";"Vallès Occidental";"08205";"Sant Cugat del Vallès";"2";"8";"B";"623";"242";"452";"538";"85";"0";"5";"533";"538"
"8";"Barcelona";"1";"Barcelona";"40";"Vallès Occidental";"08205";"Sant Cugat del Vallès";"2";"9";"A";"634";"227";"516";"632";"2";"0";"4";"628";"632"
"8";"Barcelona";"1";"Barcelona";"40";"Vallès Occidental";"08205";"Sant Cugat del Vallès";"2";"9";"B";"716";"281";"454";"552";"164";"6";"1";"545";"546"
"8";"Barcelona";"1";"Barcelona";"40";"Vallès Occidental";"08205";"Sant Cugat del Vallès";"3";"1";"A";"583";"216";"436";"453";"130";"0";"2";"451";"453"
"8";"Barcelona";"1";"Barcelona";"40";"Vallès Occidental";"08205";"Sant Cugat del Vallès";"3";"1";"B";"645";"221";"415";"506";"139";"2";"1";"503";"504"
"8";"Barcelona";"1";"Barcelona";"40";"Vallès Occidental";"08205";"Sant Cugat del Vallès";"3";"2";"A";"749";"226";"514";"655";"94";"0";"3";"652";"655"
"8";"Barcelona";"1";"Barcelona";"40";"Vallès Occidental";"08205";"Sant Cugat del Vallès";"3";"2";"B";"813";"279";"561";"689";"124";"2";"4";"683";"687"
"8";"Barcelona";"1";"Barcelona";"40";"Vallès Occidental";"08205";"Sant Cugat del Vallès";"3";"3";"A";"687";"244";"476";"578";"109";"1";"0";"577";"577"
"8";"Barcelona";"1";"Barcelona";"40";"Vallès Occidental";"08205";"Sant Cugat del Vallès";"3";"3";"B";"727";"246";"472";"590";"137";"0";"1";"589";"590"
"8";"Barcelona";"1";"Barcelona";"40";"Vallès Occidental";"08205";"Sant Cugat del Vallès";"3";"4";"A";"670";"233";"443";"548";"122";"1";"2";"545";"547"
"8";"Barcelona";"1";"Barcelona";"40";"Vallès Occidental";"08205";"Sant Cugat del Vallès";"3";"4";"B";"721";"267";"505";"610";"111";"2";"1";"607";"608"
"8";"Barcelona";"1";"Barcelona";"40";"Vallès Occidental";"08205";"Sant Cugat del Vallès";"4";"1";"U";"908";"310";"596";"726";"182";"1";"3";"722";"725"
"8";"Barcelona";"1";"Barcelona";"40";"Vallès Occidental";"08205";"Sant Cugat del Vallès";"4";"2";"U";"966";"318";"620";"764";"202";"2";"5";"757";"762"
"8";"Barcelona";"1";"Barcelona";"40";"Vallès Occidental";"08205";"Sant Cugat del Vallès";"4";"3";"A";"607";"220";"384";"473";"134";"1";"0";"472";"472"
"8";"Barcelona";"1";"Barcelona";"40";"Vallès Occidental";"08205";"Sant Cugat del Vallès";"4";"3";"B";"619";"225";"403";"500";"119";"1";"0";"499";"499"
"8";"Barcelona";"1";"Barcelona";"40";"Vallès Occidental";"08205";"Sant Cugat del Vallès";"5";"1";"A";"570";"219";"408";"494";"76";"0";"2";"492";"494"
"8";"Barcelona";"1";"Barcelona";"40";"Vallès Occidental";"08205";"Sant Cugat del Vallès";"5";"1";"B";"707";"240";"515";"616";"91";"0";"0";"616";"616"
"8";"Barcelona";"1";"Barcelona";"40";"Vallès Occidental";"08205";"Sant Cugat del Vallès";"5";"2";"U";"947";"280";"632";"792";"155";"3";"5";"784";"789"
"8";"Barcelona";"1";"Barcelona";"40";"Vallès Occidental";"08205";"Sant Cugat del Vallès";"5";"3";"A";"663";"280";"464";"572";"91";"1";"1";"570";"571"
"8";"Barcelona";"1";"Barcelona";"40";"Vallès Occidental";"08205";"Sant Cugat del Vallès";"5";"3";"B";"797";"304";"568";"697";"100";"1";"3";"693";"696"
"8";"Barcelona";"1";"Barcelona";"40";"Vallès Occidental";"08205";"Sant Cugat del Vallès";"5";"4";"A";"682";"203";"465";"604";"78";"1";"2";"601";"603"
"8";"Barcelona";"1";"Barcelona";"40";"Vallès Occidental";"08205";"Sant Cugat del Vallès";"5";"4";"B";"767";"246";"533";"669";"98";"1";"2";"666";"668"
"8";"Barcelona";"1";"Barcelona";"40";"Vallès Occidental";"08205";"Sant Cugat del Vallès";"5";"5";"A";"467";"179";"314";"394";"73";"0";"0";"394";"394"
"8";"Barcelona";"1";"Barcelona";"40";"Vallès Occidental";"08205";"Sant Cugat del Vallès";"5";"5";"B";"551";"194";"358";"449";"102";"2";"0";"447";"447"
"8";"Barcelona";"1";"Barcelona";"40";"Vallès Occidental";"08205";"Sant Cugat del Vallès";"5";"6";"A";"531";"208";"366";"460";"71";"2";"1";"457";"458"
"8";"Barcelona";"1";"Barcelona";"40";"Vallès Occidental";"08205";"Sant Cugat del Vallès";"5";"6";"B";"547";"211";"375";"475";"72";"0";"3";"472";"475"
"8";"Barcelona";"1";"Barcelona";"40";"Vallès Occidental";"08205";"Sant Cugat del Vallès";"5";"7";"A";"675";"266";"487";"606";"69";"4";"3";"599";"602"
"8";"Barcelona";"1";"Barcelona";"40";"Vallès Occidental";"08205";"Sant Cugat del Vallès";"5";"7";"B";"728";"286";"536";"644";"84";"2";"5";"637";"642"
"8";"Barcelona";"1";"Barcelona";"40";"Vallès Occidental";"08205";"Sant Cugat del Vallès";"5";"8";"U";"901";"355";"622";"770";"131";"0";"0";"770";"770"
"8";"Barcelona";"1";"Barcelona";"40";"Vallès Occidental";"08205";"Sant Cugat del Vallès";"6";"1";"U";"912";"276";"543";"648";"264";"8";"0";"640";"640"
"8";"Barcelona";"1";"Barcelona";"11";"Baix Llobregat";"08208";"Sant Esteve Sesrovires";"1";"1";"A";"518";"190";"300";"377";"141";"1";"1";"375";"376"
"8";"Barcelona";"1";"Barcelona";"11";"Baix Llobregat";"08208";"Sant Esteve Sesrovires";"1";"1";"B";"459";"153";"271";"338";"121";"3";"2";"333";"335"
"8";"Barcelona";"1";"Barcelona";"11";"Baix Llobregat";"08208";"Sant Esteve Sesrovires";"1";"1";"C";"585";"228";"378";"453";"132";"2";"1";"450";"451"
"8";"Barcelona";"1";"Barcelona";"11";"Baix Llobregat";"08208";"Sant Esteve Sesrovires";"1";"1";"D";"475";"172";"305";"379";"96";"0";"0";"379";"379"
"8";"Barcelona";"1";"Barcelona";"11";"Baix Llobregat";"08208";"Sant Esteve Sesrovires";"1";"2";"A";"464";"197";"309";"386";"78";"2";"0";"384";"384"
"8";"Barcelona";"1";"Barcelona";"11";"Baix Llobregat";"08208";"Sant Esteve Sesrovires";"1";"2";"B";"461";"178";"310";"374";"87";"1";"1";"372";"373"
"8";"Barcelona";"1";"Barcelona";"11";"Baix Llobregat";"08208";"Sant Esteve Sesrovires";"1";"2";"C";"558";"230";"371";"463";"95";"0";"1";"462";"463"
"8";"Barcelona";"1";"Barcelona";"11";"Baix Llobregat";"08208";"Sant Esteve Sesrovires";"1";"2";"D";"431";"188";"311";"370";"61";"1";"0";"369";"369"
"8";"Barcelona";"1";"Barcelona";"11";"Baix Llobregat";"08208";"Sant Esteve Sesrovires";"1";"3";"A";"365";"168";"260";"307";"58";"1";"1";"305";"306"
"8";"Barcelona";"1";"Barcelona";"11";"Baix Llobregat";"08208";"Sant Esteve Sesrovires";"1";"3";"B";"498";"178";"314";"397";"101";"2";"3";"392";"395"
"8";"Barcelona";"1";"Barcelona";"11";"Baix Llobregat";"08208";"Sant Esteve Sesrovires";"1";"4";"A";"437";"167";"273";"354";"83";"0";"1";"353";"354"
"8";"Barcelona";"1";"Barcelona";"11";"Baix Llobregat";"08208";"Sant Esteve Sesrovires";"1";"4";"B";"456";"176";"297";"366";"90";"2";"1";"363";"364"
"8";"Barcelona";"1";"Barcelona";"41";"Vallès Oriental";"08207";"Sant Esteve de Palautordera";"1";"1";"A";"616";"290";"482";"548";"68";"2";"1";"545";"546"
"8";"Barcelona";"1";"Barcelona";"41";"Vallès Oriental";"08207";"Sant Esteve de Palautordera";"1";"1";"B";"587";"270";"422";"512";"75";"2";"0";"510";"510"
"8";"Barcelona";"1";"Barcelona";"41";"Vallès Oriental";"08207";"Sant Esteve de Palautordera";"1";"1";"C";"634";"285";"475";"566";"68";"0";"1";"565";"566"
"8";"Barcelona";"1";"Barcelona";"41";"Vallès Oriental";"08210";"Sant Feliu de Codines";"1";"1";"A";"510";"178";"311";"399";"111";"3";"4";"392";"396"
"8";"Barcelona";"1";"Barcelona";"41";"Vallès Oriental";"08210";"Sant Feliu de Codines";"1";"1";"B";"584";"217";"374";"477";"107";"1";"3";"473";"476"
"8";"Barcelona";"1";"Barcelona";"41";"Vallès Oriental";"08210";"Sant Feliu de Codines";"1";"2";"A";"598";"222";"376";"453";"145";"2";"2";"449";"451"
"8";"Barcelona";"1";"Barcelona";"41";"Vallès Oriental";"08210";"Sant Feliu de Codines";"1";"2";"B";"718";"242";"464";"552";"166";"3";"2";"547";"549"
"8";"Barcelona";"1";"Barcelona";"41";"Vallès Oriental";"08210";"Sant Feliu de Codines";"2";"1";"A";"503";"180";"308";"377";"126";"2";"5";"370";"375"
"8";"Barcelona";"1";"Barcelona";"41";"Vallès Oriental";"08210";"Sant Feliu de Codines";"2";"1";"B";"597";"218";"360";"443";"154";"1";"2";"440";"442"
"8";"Barcelona";"1";"Barcelona";"41";"Vallès Oriental";"08210";"Sant Feliu de Codines";"2";"2";"A";"354";"126";"209";"269";"85";"1";"1";"267";"268"
"8";"Barcelona";"1";"Barcelona";"41";"Vallès Oriental";"08210";"Sant Feliu de Codines";"2";"2";"B";"434";"183";"285";"341";"93";"1";"1";"339";"340"
"8";"Barcelona";"1";"Barcelona";"11";"Baix Llobregat";"08211";"Sant Feliu de Llobregat";"1";"1";"A";"642";"212";"446";"549";"93";"1";"6";"542";"548"
"8";"Barcelona";"1";"Barcelona";"11";"Baix Llobregat";"08211";"Sant Feliu de Llobregat";"1";"1";"B";"653";"236";"453";"547";"106";"1";"0";"546";"546"
"8";"Barcelona";"1";"Barcelona";"11";"Baix Llobregat";"08211";"Sant Feliu de Llobregat";"1";"2";"A";"470";"184";"329";"397";"73";"3";"4";"390";"394"
"8";"Barcelona";"1";"Barcelona";"11";"Baix Llobregat";"08211";"Sant Feliu de Llobregat";"1";"2";"B";"503";"186";"356";"429";"74";"1";"6";"422";"428"
"8";"Barcelona";"1";"Barcelona";"11";"Baix Llobregat";"08211";"Sant Feliu de Llobregat";"1";"3";"A";"473";"168";"307";"396";"77";"3";"1";"392";"393"
"8";"Barcelona";"1";"Barcelona";"11";"Baix Llobregat";"08211";"Sant Feliu de Llobregat";"1";"3";"B";"574";"193";"370";"470";"104";"6";"2";"462";"464"
"8";"Barcelona";"1";"Barcelona";"11";"Baix Llobregat";"08211";"Sant Feliu de Llobregat";"1";"4";"A";"728";"232";"508";"609";"119";"2";"2";"605";"607"
"8";"Barcelona";"1";"Barcelona";"11";"Baix Llobregat";"08211";"Sant Feliu de Llobregat";"1";"4";"B";"849";"290";"585";"706";"143";"0";"3";"703";"706"
"8";"Barcelona";"1";"Barcelona";"11";"Baix Llobregat";"08211";"Sant Feliu de Llobregat";"1";"5";"A";"669";"214";"520";"528";"141";"1";"2";"525";"527"
"8";"Barcelona";"1";"Barcelona";"11";"Baix Llobregat";"08211";"Sant Feliu de Llobregat";"1";"5";"B";"828";"269";"412";"666";"162";"1";"4";"661";"665"
"8";"Barcelona";"1";"Barcelona";"11";"Baix Llobregat";"08211";"Sant Feliu de Llobregat";"1";"6";"U";"493";"165";"326";"408";"85";"0";"0";"408";"408"
"8";"Barcelona";"1";"Barcelona";"11";"Baix Llobregat";"08211";"Sant Feliu de Llobregat";"1";"7";"A";"516";"183";"345";"424";"92";"1";"1";"422";"423"
"8";"Barcelona";"1";"Barcelona";"11";"Baix Llobregat";"08211";"Sant Feliu de Llobregat";"1";"7";"B";"637";"221";"425";"533";"104";"2";"3";"528";"531"
"8";"Barcelona";"1";"Barcelona";"11";"Baix Llobregat";"08211";"Sant Feliu de Llobregat";"2";"3";"A";"482";"147";"278";"355";"127";"1";"2";"352";"354"
"8";"Barcelona";"1";"Barcelona";"11";"Baix Llobregat";"08211";"Sant Feliu de Llobregat";"2";"3";"B";"545";"166";"332";"389";"156";"0";"2";"387";"389"
"8";"Barcelona";"1";"Barcelona";"11";"Baix Llobregat";"08211";"Sant Feliu de Llobregat";"2";"4";"A";"566";"183";"385";"478";"88";"0";"3";"475";"478"
"8";"Barcelona";"1";"Barcelona";"11";"Baix Llobregat";"08211";"Sant Feliu de Llobregat";"2";"4";"B";"625";"212";"407";"514";"111";"2";"2";"510";"512"
"8";"Barcelona";"1";"Barcelona";"11";"Baix Llobregat";"08211";"Sant Feliu de Llobregat";"2";"6";"A";"487";"160";"287";"381";"106";"4";"2";"375";"377"
"8";"Barcelona";"1";"Barcelona";"11";"Baix Llobregat";"08211";"Sant Feliu de Llobregat";"2";"6";"B";"554";"196";"336";"436";"118";"3";"3";"430";"433"
"8";"Barcelona";"1";"Barcelona";"11";"Baix Llobregat";"08211";"Sant Feliu de Llobregat";"2";"7";"U";"853";"255";"536";"679";"174";"8";"5";"666";"671"
"8";"Barcelona";"1";"Barcelona";"11";"Baix Llobregat";"08211";"Sant Feliu de Llobregat";"2";"8";"A";"628";"223";"384";"497";"131";"2";"1";"494";"495"
"8";"Barcelona";"1";"Barcelona";"11";"Baix Llobregat";"08211";"Sant Feliu de Llobregat";"2";"8";"B";"659";"209";"413";"536";"123";"7";"1";"528";"529"
"8";"Barcelona";"1";"Barcelona";"11";"Baix Llobregat";"08211";"Sant Feliu de Llobregat";"3";"1";"A";"577";"187";"349";"459";"118";"0";"3";"456";"459"
"8";"Barcelona";"1";"Barcelona";"11";"Baix Llobregat";"08211";"Sant Feliu de Llobregat";"3";"1";"B";"688";"246";"432";"526";"162";"3";"0";"523";"523"
"8";"Barcelona";"1";"Barcelona";"11";"Baix Llobregat";"08211";"Sant Feliu de Llobregat";"3";"2";"A";"558";"182";"355";"452";"106";"0";"3";"449";"452"
"8";"Barcelona";"1";"Barcelona";"11";"Baix Llobregat";"08211";"Sant Feliu de Llobregat";"3";"2";"B";"643";"239";"415";"526";"117";"5";"4";"517";"521"
"8";"Barcelona";"1";"Barcelona";"11";"Baix Llobregat";"08211";"Sant Feliu de Llobregat";"3";"3";"A";"647";"245";"443";"549";"98";"3";"2";"544";"546"
"8";"Barcelona";"1";"Barcelona";"11";"Baix Llobregat";"08211";"Sant Feliu de Llobregat";"3";"3";"B";"721";"267";"491";"603";"118";"2";"2";"599";"601"
"8";"Barcelona";"1";"Barcelona";"11";"Baix Llobregat";"08211";"Sant Feliu de Llobregat";"3";"4";"A";"685";"237";"452";"579";"106";"3";"6";"570";"576"
"8";"Barcelona";"1";"Barcelona";"11";"Baix Llobregat";"08211";"Sant Feliu de Llobregat";"3";"4";"B";"779";"279";"534";"671";"108";"1";"3";"667";"670"
"8";"Barcelona";"1";"Barcelona";"11";"Baix Llobregat";"08211";"Sant Feliu de Llobregat";"3";"5";"A";"602";"228";"391";"482";"120";"2";"3";"477";"480"
"8";"Barcelona";"1";"Barcelona";"11";"Baix Llobregat";"08211";"Sant Feliu de Llobregat";"3";"5";"B";"710";"278";"478";"585";"125";"1";"2";"582";"584"
"8";"Barcelona";"1";"Barcelona";"11";"Baix Llobregat";"08211";"Sant Feliu de Llobregat";"4";"3";"U";"780";"261";"498";"616";"164";"4";"5";"607";"612"
"8";"Barcelona";"1";"Barcelona";"11";"Baix Llobregat";"08211";"Sant Feliu de Llobregat";"4";"6";"A";"635";"182";"354";"444";"191";"5";"3";"436";"439"
"8";"Barcelona";"1";"Barcelona";"11";"Baix Llobregat";"08211";"Sant Feliu de Llobregat";"4";"6";"B";"751";"236";"430";"541";"210";"1";"2";"538";"540"
"8";"Barcelona";"1";"Barcelona";"11";"Baix Llobregat";"08211";"Sant Feliu de Llobregat";"4";"7";"U";"612";"174";"342";"473";"139";"2";"1";"470";"471"
"8";"Barcelona";"1";"Barcelona";"11";"Baix Llobregat";"08211";"Sant Feliu de Llobregat";"4";"8";"U";"679";"206";"381";"517";"162";"2";"2";"513";"515"
"8";"Barcelona";"1";"Barcelona";"11";"Baix Llobregat";"08211";"Sant Feliu de Llobregat";"5";"1";"A";"365";"134";"229";"275";"90";"0";"0";"275";"275"
"8";"Barcelona";"1";"Barcelona";"11";"Baix Llobregat";"08211";"Sant Feliu de Llobregat";"5";"1";"B";"432";"138";"236";"309";"123";"2";"0";"307";"307"
"8";"Barcelona";"1";"Barcelona";"11";"Baix Llobregat";"08211";"Sant Feliu de Llobregat";"5";"2";"U";"679";"232";"396";"511";"168";"2";"1";"508";"509"
"8";"Barcelona";"1";"Barcelona";"11";"Baix Llobregat";"08211";"Sant Feliu de Llobregat";"5";"3";"A";"498";"170";"295";"363";"135";"2";"1";"360";"361"
"8";"Barcelona";"1";"Barcelona";"11";"Baix Llobregat";"08211";"Sant Feliu de Llobregat";"5";"3";"B";"624";"216";"377";"453";"171";"5";"3";"445";"448"
"8";"Barcelona";"1";"Barcelona";"11";"Baix Llobregat";"08211";"Sant Feliu de Llobregat";"5";"4";"A";"360";"122";"196";"252";"108";"0";"2";"250";"252"
"8";"Barcelona";"1";"Barcelona";"11";"Baix Llobregat";"08211";"Sant Feliu de Llobregat";"5";"4";"B";"451";"161";"259";"330";"121";"2";"2";"326";"328"
"8";"Barcelona";"1";"Barcelona";"11";"Baix Llobregat";"08211";"Sant Feliu de Llobregat";"5";"5";"A";"572";"184";"356";"461";"111";"2";"4";"455";"459"
"8";"Barcelona";"1";"Barcelona";"11";"Baix Llobregat";"08211";"Sant Feliu de Llobregat";"5";"5";"B";"641";"221";"393";"498";"143";"0";"0";"498";"498"
"8";"Barcelona";"1";"Barcelona";"11";"Baix Llobregat";"08211";"Sant Feliu de Llobregat";"6";"4";"A";"446";"113";"276";"378";"68";"1";"5";"372";"377"
"8";"Barcelona";"1";"Barcelona";"11";"Baix Llobregat";"08211";"Sant Feliu de Llobregat";"6";"4";"B";"539";"150";"363";"467";"72";"1";"0";"466";"466"
"8";"Barcelona";"1";"Barcelona";"11";"Baix Llobregat";"08211";"Sant Feliu de Llobregat";"7";"1";"A";"660";"212";"437";"562";"98";"2";"5";"555";"560"
"8";"Barcelona";"1";"Barcelona";"11";"Baix Llobregat";"08211";"Sant Feliu de Llobregat";"7";"1";"B";"786";"279";"542";"704";"82";"3";"4";"697";"701"
"8";"Barcelona";"1";"Barcelona";"11";"Baix Llobregat";"08211";"Sant Feliu de Llobregat";"7";"2";"A";"742";"240";"537";"680";"62";"0";"2";"678";"680"
"8";"Barcelona";"1";"Barcelona";"11";"Baix Llobregat";"08211";"Sant Feliu de Llobregat";"7";"2";"B";"796";"250";"552";"718";"78";"3";"1";"714";"715"
"8";"Barcelona";"1";"Barcelona";"11";"Baix Llobregat";"08211";"Sant Feliu de Llobregat";"7";"3";"U";"837";"211";"524";"700";"137";"1";"3";"696";"699"
"8";"Barcelona";"1";"Barcelona";"41";"Vallès Oriental";"08209";"Sant Fost de Campsentelles";"1";"1";"A";"511";"194";"316";"385";"126";"2";"2";"381";"383"
"8";"Barcelona";"1";"Barcelona";"41";"Vallès Oriental";"08209";"Sant Fost de Campsentelles";"1";"1";"B";"515";"177";"300";"395";"120";"1";"4";"390";"394"
"8";"Barcelona";"1";"Barcelona";"41";"Vallès Oriental";"08209";"Sant Fost de Campsentelles";"1";"1";"C";"602";"210";"361";"467";"135";"1";"1";"465";"466"
"8";"Barcelona";"1";"Barcelona";"41";"Vallès Oriental";"08209";"Sant Fost de Campsentelles";"1";"2";"A";"601";"222";"380";"468";"133";"2";"2";"464";"466"
"8";"Barcelona";"1";"Barcelona";"41";"Vallès Oriental";"08209";"Sant Fost de Campsentelles";"1";"2";"B";"763";"280";"505";"593";"170";"1";"3";"589";"592"
"8";"Barcelona";"1";"Barcelona";"41";"Vallès Oriental";"08209";"Sant Fost de Campsentelles";"1";"3";"A";"649";"220";"408";"534";"115";"1";"4";"529";"533"
"8";"Barcelona";"1";"Barcelona";"41";"Vallès Oriental";"08209";"Sant Fost de Campsentelles";"1";"3";"B";"626";"221";"386";"494";"132";"2";"4";"488";"492"
"8";"Barcelona";"1";"Barcelona";"41";"Vallès Oriental";"08209";"Sant Fost de Campsentelles";"1";"3";"C";"664";"236";"418";"509";"155";"4";"1";"504";"505"
"8";"Barcelona";"1";"Barcelona";"41";"Vallès Oriental";"08209";"Sant Fost de Campsentelles";"1";"4";"A";"550";"219";"356";"426";"124";"0";"3";"423";"426"
"8";"Barcelona";"1";"Barcelona";"41";"Vallès Oriental";"08209";"Sant Fost de Campsentelles";"1";"4";"B";"653";"237";"391";"496";"157";"2";"4";"490";"494"
"8";"Barcelona";"1";"Barcelona";"41";"Vallès Oriental";"08209";"Sant Fost de Campsentelles";"1";"4";"C";"652";"201";"364";"466";"186";"0";"1";"465";"466"
"8";"Barcelona";"1";"Barcelona";"21";"Maresme";"08193";"Sant Iscle de Vallalta";"1";"1";"A";"414";"167";"270";"333";"81";"2";"0";"331";"331"
"8";"Barcelona";"1";"Barcelona";"21";"Maresme";"08193";"Sant Iscle de Vallalta";"1";"1";"B";"536";"209";"361";"423";"113";"5";"5";"413";"418"
"8";"Barcelona";"1";"Barcelona";"11";"Baix Llobregat";"08217";"Sant Joan Despí";"1";"1";"U";"932";"325";"612";"769";"163";"3";"4";"762";"766"
"8";"Barcelona";"1";"Barcelona";"11";"Baix Llobregat";"08217";"Sant Joan Despí";"1";"10";"A";"631";"201";"420";"549";"82";"1";"3";"545";"548"
"8";"Barcelona";"1";"Barcelona";"11";"Baix Llobregat";"08217";"Sant Joan Despí";"1";"10";"B";"729";"264";"495";"615";"114";"0";"4";"611";"615"
"8";"Barcelona";"1";"Barcelona";"11";"Baix Llobregat";"08217";"Sant Joan Despí";"1";"2";"A";"443";"146";"283";"359";"84";"0";"0";"359";"359"
"8";"Barcelona";"1";"Barcelona";"11";"Baix Llobregat";"08217";"Sant Joan Despí";"1";"2";"B";"458";"159";"308";"376";"82";"0";"1";"375";"376"
"8";"Barcelona";"1";"Barcelona";"11";"Baix Llobregat";"08217";"Sant Joan Despí";"1";"3";"A";"658";"224";"440";"552";"106";"5";"1";"546";"547"
"8";"Barcelona";"1";"Barcelona";"11";"Baix Llobregat";"08217";"Sant Joan Despí";"1";"3";"B";"798";"260";"534";"669";"129";"1";"3";"665";"668"
"8";"Barcelona";"1";"Barcelona";"11";"Baix Llobregat";"08217";"Sant Joan Despí";"1";"4";"A";"605";"213";"381";"496";"109";"1";"3";"492";"495"
"8";"Barcelona";"1";"Barcelona";"11";"Baix Llobregat";"08217";"Sant Joan Despí";"1";"4";"B";"621";"198";"397";"511";"110";"1";"4";"506";"510"
"8";"Barcelona";"1";"Barcelona";"11";"Baix Llobregat";"08217";"Sant Joan Despí";"1";"4";"C";"668";"211";"417";"562";"106";"0";"3";"559";"562"
"8";"Barcelona";"1";"Barcelona";"11";"Baix Llobregat";"08217";"Sant Joan Despí";"1";"5";"A";"434";"155";"296";"365";"69";"1";"3";"361";"364"
"8";"Barcelona";"1";"Barcelona";"11";"Baix Llobregat";"08217";"Sant Joan Despí";"1";"5";"B";"471";"155";"309";"394";"77";"0";"1";"393";"394"
"8";"Barcelona";"1";"Barcelona";"11";"Baix Llobregat";"08217";"Sant Joan Despí";"1";"5";"C";"506";"178";"332";"406";"100";"1";"3";"402";"405"
"8";"Barcelona";"1";"Barcelona";"11";"Baix Llobregat";"08217";"Sant Joan Despí";"1";"6";"A";"373";"100";"203";"264";"109";"0";"1";"263";"264"
"8";"Barcelona";"1";"Barcelona";"11";"Baix Llobregat";"08217";"Sant Joan Despí";"1";"6";"B";"427";"126";"252";"322";"105";"0";"1";"321";"322"
"8";"Barcelona";"1";"Barcelona";"11";"Baix Llobregat";"08217";"Sant Joan Despí";"1";"7";"A";"512";"186";"304";"396";"116";"0";"1";"395";"396"
"8";"Barcelona";"1";"Barcelona";"11";"Baix Llobregat";"08217";"Sant Joan Despí";"1";"7";"B";"509";"187";"328";"408";"101";"0";"1";"407";"408"
"8";"Barcelona";"1";"Barcelona";"11";"Baix Llobregat";"08217";"Sant Joan Despí";"1";"8";"A";"563";"180";"340";"445";"118";"2";"2";"441";"443"
"8";"Barcelona";"1";"Barcelona";"11";"Baix Llobregat";"08217";"Sant Joan Despí";"1";"8";"B";"618";"205";"389";"490";"128";"3";"1";"486";"487"
"8";"Barcelona";"1";"Barcelona";"11";"Baix Llobregat";"08217";"Sant Joan Despí";"1";"9";"U";"1000";"350";"643";"874";"126";"0";"8";"866";"874"
"8";"Barcelona";"1";"Barcelona";"11";"Baix Llobregat";"08217";"Sant Joan Despí";"2";"2";"A";"893";"287";"531";"696";"197";"4";"1";"691";"692"
"8";"Barcelona";"1";"Barcelona";"11";"Baix Llobregat";"08217";"Sant Joan Despí";"2";"2";"B";"891";"296";"542";"706";"185";"4";"3";"699";"702"
"8";"Barcelona";"1";"Barcelona";"11";"Baix Llobregat";"08217";"Sant Joan Despí";"2";"3";"U";"535";"161";"311";"381";"154";"1";"2";"378";"380"
"8";"Barcelona";"1";"Barcelona";"11";"Baix Llobregat";"08217";"Sant Joan Despí";"2";"4";"A";"421";"137";"245";"292";"129";"0";"3";"289";"292"
"8";"Barcelona";"1";"Barcelona";"11";"Baix Llobregat";"08217";"Sant Joan Despí";"2";"4";"B";"484";"170";"304";"361";"123";"0";"1";"360";"361"
"8";"Barcelona";"1";"Barcelona";"11";"Baix Llobregat";"08217";"Sant Joan Despí";"3";"1";"A";"303";"120";"207";"234";"69";"2";"1";"231";"232"
"8";"Barcelona";"1";"Barcelona";"11";"Baix Llobregat";"08217";"Sant Joan Despí";"3";"1";"B";"364";"116";"218";"288";"76";"2";"0";"286";"286"
"8";"Barcelona";"1";"Barcelona";"11";"Baix Llobregat";"08217";"Sant Joan Despí";"3";"1";"C";"320";"120";"202";"254";"66";"0";"2";"252";"254"
"8";"Barcelona";"1";"Barcelona";"11";"Baix Llobregat";"08217";"Sant Joan Despí";"3";"2";"A";"524";"187";"310";"413";"111";"1";"0";"412";"412"
"8";"Barcelona";"1";"Barcelona";"11";"Baix Llobregat";"08217";"Sant Joan Despí";"3";"2";"B";"522";"182";"295";"376";"146";"2";"3";"371";"374"
"8";"Barcelona";"1";"Barcelona";"11";"Baix Llobregat";"08217";"Sant Joan Despí";"3";"3";"A";"332";"107";"202";"261";"71";"0";"0";"261";"261"
"8";"Barcelona";"1";"Barcelona";"11";"Baix Llobregat";"08217";"Sant Joan Despí";"3";"3";"B";"333";"127";"220";"267";"66";"1";"1";"265";"266"
"8";"Barcelona";"1";"Barcelona";"11";"Baix Llobregat";"08217";"Sant Joan Despí";"3";"4";"A";"591";"215";"396";"480";"111";"1";"0";"479";"479"
"8";"Barcelona";"1";"Barcelona";"11";"Baix Llobregat";"08217";"Sant Joan Despí";"3";"4";"B";"696";"268";"462";"562";"134";"3";"1";"558";"559"
"8";"Barcelona";"1";"Barcelona";"11";"Baix Llobregat";"08217";"Sant Joan Despí";"3";"5";"A";"418";"140";"268";"332";"86";"0";"2";"330";"332"
"8";"Barcelona";"1";"Barcelona";"11";"Baix Llobregat";"08217";"Sant Joan Despí";"3";"5";"B";"459";"137";"279";"344";"115";"3";"2";"339";"341"
"8";"Barcelona";"1";"Barcelona";"11";"Baix Llobregat";"08217";"Sant Joan Despí";"4";"1";"A";"661";"202";"452";"565";"96";"0";"2";"563";"565"
"8";"Barcelona";"1";"Barcelona";"11";"Baix Llobregat";"08217";"Sant Joan Despí";"4";"1";"B";"645";"204";"451";"561";"84";"1";"2";"558";"560"
"8";"Barcelona";"1";"Barcelona";"11";"Baix Llobregat";"08217";"Sant Joan Despí";"4";"1";"C";"733";"228";"402";"631";"102";"0";"5";"626";"631"
"8";"Barcelona";"1";"Barcelona";"11";"Baix Llobregat";"08217";"Sant Joan Despí";"5";"1";"A";"613";"165";"387";"516";"97";"0";"0";"516";"516"
"8";"Barcelona";"1";"Barcelona";"11";"Baix Llobregat";"08217";"Sant Joan Despí";"5";"1";"B";"655";"180";"421";"544";"111";"1";"1";"542";"543"
"8";"Barcelona";"1";"Barcelona";"11";"Baix Llobregat";"08217";"Sant Joan Despí";"5";"1";"C";"687";"165";"427";"552";"135";"0";"2";"550";"552"
"8";"Barcelona";"1";"Barcelona";"11";"Baix Llobregat";"08217";"Sant Joan Despí";"5";"2";"U";"870";"238";"570";"745";"125";"1";"1";"743";"744"
"8";"Barcelona";"1";"Barcelona";"11";"Baix Llobregat";"08221";"Sant Just Desvern";"1";"1";"A";"707";"272";"512";"608";"99";"0";"2";"606";"608"
"8";"Barcelona";"1";"Barcelona";"11";"Baix Llobregat";"08221";"Sant Just Desvern";"1";"1";"B";"828";"277";"567";"693";"135";"3";"6";"684";"690"
"8";"Barcelona";"1";"Barcelona";"11";"Baix Llobregat";"08221";"Sant Just Desvern";"1";"2";"U";"631";"229";"391";"478";"153";"2";"3";"473";"476"
"8";"Barcelona";"1";"Barcelona";"11";"Baix Llobregat";"08221";"Sant Just Desvern";"1";"3";"A";"812";"250";"566";"659";"153";"1";"2";"656";"658"
"8";"Barcelona";"1";"Barcelona";"11";"Baix Llobregat";"08221";"Sant Just Desvern";"1";"3";"B";"954";"320";"641";"756";"198";"1";"7";"748";"755"
"8";"Barcelona";"1";"Barcelona";"11";"Baix Llobregat";"08221";"Sant Just Desvern";"1";"4";"A";"584";"231";"393";"478";"106";"2";"2";"474";"476"
"8";"Barcelona";"1";"Barcelona";"11";"Baix Llobregat";"08221";"Sant Just Desvern";"1";"4";"B";"746";"248";"498";"603";"143";"0";"4";"599";"603"
"8";"Barcelona";"1";"Barcelona";"11";"Baix Llobregat";"08221";"Sant Just Desvern";"1";"5";"A";"665";"243";"444";"533";"132";"1";"3";"529";"532"
"8";"Barcelona";"1";"Barcelona";"11";"Baix Llobregat";"08221";"Sant Just Desvern";"1";"5";"B";"805";"267";"666";"683";"122";"2";"2";"679";"681"
"8";"Barcelona";"1";"Barcelona";"11";"Baix Llobregat";"08221";"Sant Just Desvern";"1";"6";"A";"602";"211";"400";"505";"97";"2";"2";"501";"503"
"8";"Barcelona";"1";"Barcelona";"11";"Baix Llobregat";"08221";"Sant Just Desvern";"1";"6";"B";"702";"218";"473";"603";"99";"2";"3";"598";"601"
"8";"Barcelona";"1";"Barcelona";"11";"Baix Llobregat";"08221";"Sant Just Desvern";"1";"6";"C";"618";"206";"409";"534";"84";"4";"4";"526";"530"
"8";"Barcelona";"1";"Barcelona";"11";"Baix Llobregat";"08221";"Sant Just Desvern";"1";"7";"A";"638";"196";"406";"520";"118";"0";"0";"520";"520"
"8";"Barcelona";"1";"Barcelona";"11";"Baix Llobregat";"08221";"Sant Just Desvern";"1";"7";"B";"790";"237";"466";"615";"175";"3";"2";"610";"612"
"8";"Barcelona";"1";"Barcelona";"11";"Baix Llobregat";"08221";"Sant Just Desvern";"1";"8";"A";"432";"137";"279";"357";"75";"1";"0";"356";"356"
"8";"Barcelona";"1";"Barcelona";"11";"Baix Llobregat";"08221";"Sant Just Desvern";"1";"8";"B";"522";"175";"357";"444";"78";"2";"3";"439";"442"
"8";"Barcelona";"1";"Barcelona";"11";"Baix Llobregat";"08221";"Sant Just Desvern";"1";"9";"A";"777";"288";"551";"660";"117";"1";"2";"657";"659"
"8";"Barcelona";"1";"Barcelona";"11";"Baix Llobregat";"08221";"Sant Just Desvern";"1";"9";"B";"546";"151";"359";"488";"58";"0";"1";"487";"488"
"8";"Barcelona";"1";"Barcelona";"40";"Vallès Occidental";"08223";"Sant Llorenç Savall";"1";"1";"A";"649";"230";"423";"516";"133";"2";"3";"511";"514"
"8";"Barcelona";"1";"Barcelona";"40";"Vallès Occidental";"08223";"Sant Llorenç Savall";"1";"1";"B";"540";"193";"332";"411";"129";"1";"1";"409";"410"
"8";"Barcelona";"1";"Barcelona";"40";"Vallès Occidental";"08223";"Sant Llorenç Savall";"1";"1";"C";"670";"228";"398";"505";"165";"5";"3";"497";"500"
"8";"Barcelona";"1";"Barcelona";"3";"Alt Penedès";"08222";"Sant Llorenç d'Hortons";"1";"1";"A";"690";"257";"479";"602";"88";"0";"2";"600";"602"
"8";"Barcelona";"1";"Barcelona";"3";"Alt Penedès";"08222";"Sant Llorenç d'Hortons";"1";"1";"B";"724";"274";"511";"609";"115";"2";"6";"601";"607"
"8";"Barcelona";"1";"Barcelona";"3";"Alt Penedès";"08222";"Sant Llorenç d'Hortons";"1";"1";"C";"479";"211";"321";"379";"100";"3";"3";"373";"376"
"8";"Barcelona";"1";"Barcelona";"3";"Alt Penedès";"08227";"Sant Martí Sarroca";"1";"1";"A";"670";"234";"427";"550";"120";"4";"6";"540";"546"
"8";"Barcelona";"1";"Barcelona";"3";"Alt Penedès";"08227";"Sant Martí Sarroca";"1";"1";"B";"752";"262";"506";"616";"136";"5";"2";"609";"611"
"8";"Barcelona";"1";"Barcelona";"3";"Alt Penedès";"08227";"Sant Martí Sarroca";"1";"2";"A";"431";"150";"288";"339";"92";"4";"8";"327";"335"
"8";"Barcelona";"1";"Barcelona";"3";"Alt Penedès";"08227";"Sant Martí Sarroca";"1";"2";"B";"481";"197";"329";"398";"83";"1";"2";"395";"397"
"8";"Barcelona";"1";"Barcelona";"17";"Garraf";"08231";"Sant Pere de Ribes";"1";"1";"A";"551";"215";"372";"442";"109";"1";"0";"441";"441"
"8";"Barcelona";"1";"Barcelona";"17";"Garraf";"08231";"Sant Pere de Ribes";"1";"1";"B";"583";"201";"385";"444";"139";"1";"1";"442";"443"
"8";"Barcelona";"1";"Barcelona";"17";"Garraf";"08231";"Sant Pere de Ribes";"1";"10";"A";"522";"170";"262";"334";"188";"2";"1";"331";"332"
"8";"Barcelona";"1";"Barcelona";"17";"Garraf";"08231";"Sant Pere de Ribes";"1";"10";"B";"686";"211";"362";"461";"225";"0";"3";"458";"461"
"8";"Barcelona";"1";"Barcelona";"17";"Garraf";"08231";"Sant Pere de Ribes";"1";"11";"A";"458";"157";"250";"312";"146";"2";"0";"310";"310"
"8";"Barcelona";"1";"Barcelona";"17";"Garraf";"08231";"Sant Pere de Ribes";"1";"11";"B";"411";"148";"239";"297";"114";"1";"1";"295";"296"
"8";"Barcelona";"1";"Barcelona";"17";"Garraf";"08231";"Sant Pere de Ribes";"1";"12";"A";"446";"145";"266";"332";"114";"0";"2";"330";"332"
"8";"Barcelona";"1";"Barcelona";"17";"Garraf";"08231";"Sant Pere de Ribes";"1";"12";"B";"382";"134";"228";"277";"105";"1";"3";"273";"276"
"8";"Barcelona";"1";"Barcelona";"17";"Garraf";"08231";"Sant Pere de Ribes";"1";"13";"A";"516";"162";"292";"377";"139";"0";"3";"374";"377"
"8";"Barcelona";"1";"Barcelona";"17";"Garraf";"08231";"Sant Pere de Ribes";"1";"13";"B";"573";"184";"330";"417";"156";"0";"3";"414";"417"
"8";"Barcelona";"1";"Barcelona";"17";"Garraf";"08231";"Sant Pere de Ribes";"1";"14";"U";"717";"251";"426";"513";"204";"0";"0";"513";"513"
"8";"Barcelona";"1";"Barcelona";"17";"Garraf";"08231";"Sant Pere de Ribes";"1";"15";"A";"522";"198";"328";"408";"114";"2";"0";"406";"406"
"8";"Barcelona";"1";"Barcelona";"17";"Garraf";"08231";"Sant Pere de Ribes";"1";"15";"B";"637";"214";"400";"492";"145";"1";"5";"486";"491"
"8";"Barcelona";"1";"Barcelona";"17";"Garraf";"08231";"Sant Pere de Ribes";"1";"15";"C";"282";"97";"161";"210";"72";"0";"1";"209";"210"
"8";"Barcelona";"1";"Barcelona";"17";"Garraf";"08231";"Sant Pere de Ribes";"1";"16";"A";"543";"186";"328";"399";"144";"1";"3";"395";"398"
"8";"Barcelona";"1";"Barcelona";"17";"Garraf";"08231";"Sant Pere de Ribes";"1";"16";"B";"604";"207";"386";"457";"147";"1";"2";"454";"456"
"8";"Barcelona";"1";"Barcelona";"17";"Garraf";"08231";"Sant Pere de Ribes";"1";"17";"A";"526";"163";"336";"401";"125";"0";"2";"399";"401"
"8";"Barcelona";"1";"Barcelona";"17";"Garraf";"08231";"Sant Pere de Ribes";"1";"17";"B";"688";"240";"439";"515";"173";"2";"3";"510";"513"
"8";"Barcelona";"1";"Barcelona";"17";"Garraf";"08231";"Sant Pere de Ribes";"1";"2";"A";"533";"191";"346";"418";"115";"0";"1";"417";"418"
"8";"Barcelona";"1";"Barcelona";"17";"Garraf";"08231";"Sant Pere de Ribes";"1";"2";"B";"582";"193";"326";"400";"182";"3";"0";"397";"397"
"8";"Barcelona";"1";"Barcelona";"17";"Garraf";"08231";"Sant Pere de Ribes";"1";"3";"A";"641";"250";"442";"524";"117";"3";"5";"516";"521"
"8";"Barcelona";"1";"Barcelona";"17";"Garraf";"08231";"Sant Pere de Ribes";"1";"3";"B";"772";"256";"486";"607";"165";"2";"2";"603";"605"
"8";"Barcelona";"1";"Barcelona";"17";"Garraf";"08231";"Sant Pere de Ribes";"1";"4";"A";"627";"209";"344";"432";"195";"2";"2";"428";"430"
"8";"Barcelona";"1";"Barcelona";"17";"Garraf";"08231";"Sant Pere de Ribes";"1";"4";"B";"802";"315";"476";"591";"211";"3";"2";"586";"588"
"8";"Barcelona";"1";"Barcelona";"17";"Garraf";"08231";"Sant Pere de Ribes";"1";"5";"A";"747";"243";"433";"520";"227";"0";"1";"519";"520"
"8";"Barcelona";"1";"Barcelona";"17";"Garraf";"08231";"Sant Pere de Ribes";"1";"5";"B";"866";"301";"523";"639";"227";"1";"5";"633";"638"
"8";"Barcelona";"1";"Barcelona";"17";"Garraf";"08231";"Sant Pere de Ribes";"1";"6";"A";"564";"187";"307";"384";"180";"1";"4";"379";"383"
"8";"Barcelona";"1";"Barcelona";"17";"Garraf";"08231";"Sant Pere de Ribes";"1";"6";"B";"646";"205";"368";"441";"205";"1";"3";"437";"440"
"8";"Barcelona";"1";"Barcelona";"17";"Garraf";"08231";"Sant Pere de Ribes";"1";"7";"A";"658";"209";"425";"464";"194";"0";"5";"459";"464"
"8";"Barcelona";"1";"Barcelona";"17";"Garraf";"08231";"Sant Pere de Ribes";"1";"7";"B";"798";"267";"487";"581";"217";"3";"0";"578";"578"
"8";"Barcelona";"1";"Barcelona";"17";"Garraf";"08231";"Sant Pere de Ribes";"1";"8";"A";"425";"159";"269";"316";"109";"0";"2";"314";"316"
"8";"Barcelona";"1";"Barcelona";"17";"Garraf";"08231";"Sant Pere de Ribes";"1";"8";"B";"571";"206";"387";"459";"112";"1";"3";"455";"458"
"8";"Barcelona";"1";"Barcelona";"17";"Garraf";"08231";"Sant Pere de Ribes";"1";"9";"A";"821";"259";"495";"629";"192";"1";"4";"624";"628"
"8";"Barcelona";"1";"Barcelona";"17";"Garraf";"08231";"Sant Pere de Ribes";"1";"9";"B";"782";"268";"490";"603";"179";"0";"3";"600";"603"
"8";"Barcelona";"1";"Barcelona";"3";"Alt Penedès";"08232";"Sant Pere de Riudebitlles";"1";"1";"A";"611";"261";"435";"513";"98";"1";"2";"510";"512"
"8";"Barcelona";"1";"Barcelona";"3";"Alt Penedès";"08232";"Sant Pere de Riudebitlles";"1";"1";"B";"592";"249";"411";"489";"103";"4";"3";"482";"485"
"8";"Barcelona";"1";"Barcelona";"3";"Alt Penedès";"08232";"Sant Pere de Riudebitlles";"1";"1";"C";"590";"234";"399";"492";"98";"2";"3";"487";"490"
"8";"Barcelona";"1";"Barcelona";"41";"Vallès Oriental";"08234";"Sant Pere de Vilamajor";"1";"1";"A";"846";"354";"578";"695";"151";"4";"5";"686";"691"
"8";"Barcelona";"1";"Barcelona";"41";"Vallès Oriental";"08234";"Sant Pere de Vilamajor";"1";"1";"B";"678";"249";"462";"543";"135";"0";"1";"542";"543"
"8";"Barcelona";"1";"Barcelona";"41";"Vallès Oriental";"08234";"Sant Pere de Vilamajor";"1";"1";"C";"970";"370";"682";"788";"182";"6";"1";"781";"782"
"8";"Barcelona";"1";"Barcelona";"41";"Vallès Oriental";"08234";"Sant Pere de Vilamajor";"1";"1";"D";"695";"297";"485";"576";"119";"1";"2";"573";"575"
"8";"Barcelona";"1";"Barcelona";"21";"Maresme";"08235";"Sant Pol de Mar";"1";"1";"A";"467";"185";"304";"396";"71";"0";"1";"395";"396"
"8";"Barcelona";"1";"Barcelona";"21";"Maresme";"08235";"Sant Pol de Mar";"1";"1";"B";"603";"239";"432";"509";"94";"1";"3";"505";"508"
"8";"Barcelona";"1";"Barcelona";"21";"Maresme";"08235";"Sant Pol de Mar";"1";"2";"A";"696";"277";"477";"574";"122";"2";"0";"572";"572"
"8";"Barcelona";"1";"Barcelona";"21";"Maresme";"08235";"Sant Pol de Mar";"1";"2";"B";"921";"381";"676";"800";"121";"0";"7";"793";"800"
"8";"Barcelona";"1";"Barcelona";"21";"Maresme";"08235";"Sant Pol de Mar";"1";"3";"U";"1007";"398";"688";"837";"170";"0";"2";"835";"837"
"8";"Barcelona";"1";"Barcelona";"3";"Alt Penedès";"08236";"Sant Quintí de Mediona";"1";"1";"A";"718";"321";"487";"575";"143";"0";"4";"571";"575"
"8";"Barcelona";"1";"Barcelona";"3";"Alt Penedès";"08236";"Sant Quintí de Mediona";"1";"1";"B";"805";"336";"577";"656";"149";"4";"3";"649";"652"
"8";"Barcelona";"1";"Barcelona";"40";"Vallès Occidental";"08238";"Sant Quirze del Vallès";"1";"1";"A";"565";"216";"412";"488";"77";"2";"2";"484";"486"
"8";"Barcelona";"1";"Barcelona";"40";"Vallès Occidental";"08238";"Sant Quirze del Vallès";"1";"1";"B";"629";"270";"443";"530";"99";"0";"3";"527";"530"
"8";"Barcelona";"1";"Barcelona";"40";"Vallès Occidental";"08238";"Sant Quirze del Vallès";"1";"10";"A";"483";"203";"320";"398";"85";"2";"3";"393";"396"
"8";"Barcelona";"1";"Barcelona";"40";"Vallès Occidental";"08238";"Sant Quirze del Vallès";"1";"10";"B";"506";"186";"319";"402";"104";"2";"0";"400";"400"
"8";"Barcelona";"1";"Barcelona";"40";"Vallès Occidental";"08238";"Sant Quirze del Vallès";"1";"11";"A";"506";"213";"371";"416";"90";"3";"0";"413";"413"
"8";"Barcelona";"1";"Barcelona";"40";"Vallès Occidental";"08238";"Sant Quirze del Vallès";"1";"11";"B";"596";"242";"390";"481";"115";"1";"5";"475";"480"
"8";"Barcelona";"1";"Barcelona";"40";"Vallès Occidental";"08238";"Sant Quirze del Vallès";"1";"12";"A";"394";"153";"254";"330";"64";"3";"1";"326";"327"
"8";"Barcelona";"1";"Barcelona";"40";"Vallès Occidental";"08238";"Sant Quirze del Vallès";"1";"12";"B";"462";"168";"302";"385";"77";"0";"0";"385";"385"
"8";"Barcelona";"1";"Barcelona";"40";"Vallès Occidental";"08238";"Sant Quirze del Vallès";"1";"2";"A";"491";"222";"382";"445";"46";"1";"2";"442";"444"
"8";"Barcelona";"1";"Barcelona";"40";"Vallès Occidental";"08238";"Sant Quirze del Vallès";"1";"2";"B";"500";"213";"377";"452";"48";"0";"4";"448";"452"
"8";"Barcelona";"1";"Barcelona";"40";"Vallès Occidental";"08238";"Sant Quirze del Vallès";"1";"3";"A";"363";"120";"237";"292";"71";"0";"4";"288";"292"
"8";"Barcelona";"1";"Barcelona";"40";"Vallès Occidental";"08238";"Sant Quirze del Vallès";"1";"3";"B";"358";"140";"233";"277";"81";"0";"1";"276";"277"
"8";"Barcelona";"1";"Barcelona";"40";"Vallès Occidental";"08238";"Sant Quirze del Vallès";"1";"3";"C";"563";"201";"356";"435";"128";"2";"4";"429";"433"
"8";"Barcelona";"1";"Barcelona";"40";"Vallès Occidental";"08238";"Sant Quirze del Vallès";"1";"3";"D";"325";"117";"212";"261";"64";"0";"1";"260";"261"
"8";"Barcelona";"1";"Barcelona";"40";"Vallès Occidental";"08238";"Sant Quirze del Vallès";"1";"4";"A";"489";"197";"354";"440";"49";"3";"2";"435";"437"
"8";"Barcelona";"1";"Barcelona";"40";"Vallès Occidental";"08238";"Sant Quirze del Vallès";"1";"4";"B";"465";"186";"337";"406";"59";"0";"0";"406";"406"
"8";"Barcelona";"1";"Barcelona";"40";"Vallès Occidental";"08238";"Sant Quirze del Vallès";"1";"4";"C";"437";"198";"318";"406";"31";"1";"1";"404";"405"
"8";"Barcelona";"1";"Barcelona";"40";"Vallès Occidental";"08238";"Sant Quirze del Vallès";"1";"5";"A";"507";"195";"348";"437";"70";"1";"2";"434";"436"
"8";"Barcelona";"1";"Barcelona";"40";"Vallès Occidental";"08238";"Sant Quirze del Vallès";"1";"5";"B";"549";"201";"370";"463";"86";"0";"2";"461";"463"
"8";"Barcelona";"1";"Barcelona";"40";"Vallès Occidental";"08238";"Sant Quirze del Vallès";"1";"5";"C";"527";"211";"358";"430";"97";"2";"3";"425";"428"
"8";"Barcelona";"1";"Barcelona";"40";"Vallès Occidental";"08238";"Sant Quirze del Vallès";"1";"6";"A";"391";"154";"266";"333";"58";"0";"2";"331";"333"
"8";"Barcelona";"1";"Barcelona";"40";"Vallès Occidental";"08238";"Sant Quirze del Vallès";"1";"6";"B";"461";"187";"317";"400";"61";"0";"2";"398";"400"
"8";"Barcelona";"1";"Barcelona";"40";"Vallès Occidental";"08238";"Sant Quirze del Vallès";"1";"6";"C";"378";"143";"256";"335";"43";"2";"0";"333";"333"
"8";"Barcelona";"1";"Barcelona";"40";"Vallès Occidental";"08238";"Sant Quirze del Vallès";"1";"7";"A";"433";"171";"320";"387";"46";"0";"3";"384";"387"
"8";"Barcelona";"1";"Barcelona";"40";"Vallès Occidental";"08238";"Sant Quirze del Vallès";"1";"7";"B";"419";"177";"302";"373";"46";"3";"1";"369";"370"
"8";"Barcelona";"1";"Barcelona";"40";"Vallès Occidental";"08238";"Sant Quirze del Vallès";"1";"7";"C";"419";"167";"303";"377";"42";"0";"0";"377";"377"
"8";"Barcelona";"1";"Barcelona";"40";"Vallès Occidental";"08238";"Sant Quirze del Vallès";"1";"8";"A";"675";"270";"480";"600";"75";"1";"5";"594";"599"
"8";"Barcelona";"1";"Barcelona";"40";"Vallès Occidental";"08238";"Sant Quirze del Vallès";"1";"8";"B";"814";"314";"578";"731";"83";"2";"5";"724";"729"
"8";"Barcelona";"1";"Barcelona";"40";"Vallès Occidental";"08238";"Sant Quirze del Vallès";"1";"9";"A";"348";"146";"245";"289";"59";"0";"0";"289";"289"
"8";"Barcelona";"1";"Barcelona";"40";"Vallès Occidental";"08238";"Sant Quirze del Vallès";"1";"9";"B";"401";"149";"257";"316";"85";"2";"1";"313";"314"
"8";"Barcelona";"1";"Barcelona";"3";"Alt Penedès";"08240";"Sant Sadurní d'Anoia";"1";"1";"A";"404";"171";"289";"347";"57";"2";"1";"344";"345"
"8";"Barcelona";"1";"Barcelona";"3";"Alt Penedès";"08240";"Sant Sadurní d'Anoia";"1";"1";"B";"503";"184";"351";"419";"84";"1";"0";"418";"418"
"8";"Barcelona";"1";"Barcelona";"3";"Alt Penedès";"08240";"Sant Sadurní d'Anoia";"1";"2";"A";"545";"212";"352";"442";"103";"1";"1";"440";"441"
"8";"Barcelona";"1";"Barcelona";"3";"Alt Penedès";"08240";"Sant Sadurní d'Anoia";"1";"2";"B";"504";"173";"324";"399";"105";"0";"2";"397";"399"
"8";"Barcelona";"1";"Barcelona";"3";"Alt Penedès";"08240";"Sant Sadurní d'Anoia";"1";"2";"C";"489";"181";"327";"394";"95";"3";"3";"388";"391"
"8";"Barcelona";"1";"Barcelona";"3";"Alt Penedès";"08240";"Sant Sadurní d'Anoia";"1";"3";"A";"446";"174";"298";"357";"89";"4";"1";"352";"353"
"8";"Barcelona";"1";"Barcelona";"3";"Alt Penedès";"08240";"Sant Sadurní d'Anoia";"1";"3";"B";"413";"144";"263";"329";"84";"2";"8";"319";"327"
"8";"Barcelona";"1";"Barcelona";"3";"Alt Penedès";"08240";"Sant Sadurní d'Anoia";"1";"4";"A";"363";"124";"228";"302";"61";"0";"1";"301";"302"
"8";"Barcelona";"1";"Barcelona";"3";"Alt Penedès";"08240";"Sant Sadurní d'Anoia";"1";"4";"B";"420";"154";"277";"361";"59";"1";"1";"359";"360"
"8";"Barcelona";"1";"Barcelona";"3";"Alt Penedès";"08240";"Sant Sadurní d'Anoia";"2";"1";"A";"411";"144";"261";"316";"95";"0";"0";"316";"316"
"8";"Barcelona";"1";"Barcelona";"3";"Alt Penedès";"08240";"Sant Sadurní d'Anoia";"2";"1";"B";"464";"171";"312";"386";"78";"0";"0";"386";"386"
"8";"Barcelona";"1";"Barcelona";"3";"Alt Penedès";"08240";"Sant Sadurní d'Anoia";"2";"2";"A";"503";"212";"339";"418";"85";"1";"0";"417";"417"
"8";"Barcelona";"1";"Barcelona";"3";"Alt Penedès";"08240";"Sant Sadurní d'Anoia";"2";"2";"B";"495";"183";"300";"387";"108";"3";"2";"382";"384"
"8";"Barcelona";"1";"Barcelona";"3";"Alt Penedès";"08240";"Sant Sadurní d'Anoia";"2";"2";"C";"572";"240";"375";"445";"127";"0";"2";"443";"445"
"8";"Barcelona";"1";"Barcelona";"3";"Alt Penedès";"08240";"Sant Sadurní d'Anoia";"2";"3";"A";"465";"175";"312";"384";"81";"3";"0";"381";"381"
"8";"Barcelona";"1";"Barcelona";"3";"Alt Penedès";"08240";"Sant Sadurní d'Anoia";"2";"3";"B";"615";"238";"420";"523";"92";"2";"2";"519";"521"
"8";"Barcelona";"1";"Barcelona";"3";"Alt Penedès";"08240";"Sant Sadurní d'Anoia";"2";"4";"A";"578";"215";"373";"475";"103";"1";"3";"471";"474"
"8";"Barcelona";"1";"Barcelona";"3";"Alt Penedès";"08240";"Sant Sadurní d'Anoia";"2";"4";"B";"599";"232";"396";"499";"100";"0";"3";"496";"499"
"8";"Barcelona";"1";"Barcelona";"3";"Alt Penedès";"08240";"Sant Sadurní d'Anoia";"2";"4";"C";"576";"208";"375";"483";"93";"1";"0";"482";"482"
"8";"Barcelona";"1";"Barcelona";"21";"Maresme";"08264";"Sant Vicenç de Montalt";"1";"1";"A";"775";"259";"555";"663";"112";"0";"2";"661";"663"
"8";"Barcelona";"1";"Barcelona";"21";"Maresme";"08264";"Sant Vicenç de Montalt";"1";"1";"B";"833";"284";"566";"696";"137";"2";"2";"692";"694"
"8";"Barcelona";"1";"Barcelona";"21";"Maresme";"08264";"Sant Vicenç de Montalt";"1";"2";"A";"432";"145";"260";"329";"103";"1";"0";"328";"328"
"8";"Barcelona";"1";"Barcelona";"21";"Maresme";"08264";"Sant Vicenç de Montalt";"1";"2";"B";"559";"209";"350";"431";"128";"0";"0";"431";"431"
"8";"Barcelona";"1";"Barcelona";"21";"Maresme";"08264";"Sant Vicenç de Montalt";"1";"3";"U";"697";"261";"489";"602";"95";"2";"6";"594";"600"
"8";"Barcelona";"1";"Barcelona";"21";"Maresme";"08264";"Sant Vicenç de Montalt";"1";"4";"A";"436";"170";"278";"336";"100";"0";"1";"335";"336"
"8";"Barcelona";"1";"Barcelona";"21";"Maresme";"08264";"Sant Vicenç de Montalt";"1";"4";"B";"522";"170";"326";"418";"104";"1";"4";"413";"417"
"8";"Barcelona";"1";"Barcelona";"11";"Baix Llobregat";"08263";"Sant Vicenç dels Horts";"1";"1";"U";"666";"264";"477";"572";"94";"0";"0";"572";"572"
"8";"Barcelona";"1";"Barcelona";"11";"Baix Llobregat";"08263";"Sant Vicenç dels Horts";"1";"10";"A";"439";"148";"264";"333";"106";"2";"3";"328";"331"
"8";"Barcelona";"1";"Barcelona";"11";"Baix Llobregat";"08263";"Sant Vicenç dels Horts";"1";"10";"B";"524";"144";"323";"396";"128";"1";"3";"392";"395"
"8";"Barcelona";"1";"Barcelona";"11";"Baix Llobregat";"08263";"Sant Vicenç dels Horts";"1";"11";"A";"473";"184";"302";"376";"97";"2";"5";"369";"374"
"8";"Barcelona";"1";"Barcelona";"11";"Baix Llobregat";"08263";"Sant Vicenç dels Horts";"1";"11";"B";"565";"228";"399";"468";"97";"1";"1";"466";"467"
"8";"Barcelona";"1";"Barcelona";"11";"Baix Llobregat";"08263";"Sant Vicenç dels Horts";"1";"12";"U";"620";"250";"374";"456";"164";"9";"4";"443";"447"
"8";"Barcelona";"1";"Barcelona";"11";"Baix Llobregat";"08263";"Sant Vicenç dels Horts";"1";"2";"A";"683";"250";"449";"559";"124";"3";"5";"551";"556"
"8";"Barcelona";"1";"Barcelona";"11";"Baix Llobregat";"08263";"Sant Vicenç dels Horts";"1";"2";"B";"748";"288";"496";"600";"148";"1";"2";"597";"599"
"8";"Barcelona";"1";"Barcelona";"11";"Baix Llobregat";"08263";"Sant Vicenç dels Horts";"1";"3";"A";"444";"189";"313";"367";"77";"0";"1";"366";"367"
"8";"Barcelona";"1";"Barcelona";"11";"Baix Llobregat";"08263";"Sant Vicenç dels Horts";"1";"3";"B";"537";"195";"351";"434";"103";"5";"6";"423";"429"
"8";"Barcelona";"1";"Barcelona";"11";"Baix Llobregat";"08263";"Sant Vicenç dels Horts";"1";"4";"A";"663";"190";"439";"526";"137";"6";"7";"513";"520"
"8";"Barcelona";"1";"Barcelona";"11";"Baix Llobregat";"08263";"Sant Vicenç dels Horts";"1";"4";"B";"724";"229";"482";"566";"158";"3";"2";"561";"563"
"8";"Barcelona";"1";"Barcelona";"11";"Baix Llobregat";"08263";"Sant Vicenç dels Horts";"1";"5";"A";"563";"228";"385";"456";"107";"0";"2";"454";"456"
"8";"Barcelona";"1";"Barcelona";"11";"Baix Llobregat";"08263";"Sant Vicenç dels Horts";"1";"5";"B";"592";"228";"396";"472";"120";"3";"4";"465";"469"
"8";"Barcelona";"1";"Barcelona";"11";"Baix Llobregat";"08263";"Sant Vicenç dels Horts";"1";"6";"A";"294";"113";"195";"237";"57";"0";"0";"237";"237"
"8";"Barcelona";"1";"Barcelona";"11";"Baix Llobregat";"08263";"Sant Vicenç dels Horts";"1";"6";"B";"370";"136";"243";"296";"74";"1";"0";"295";"295"
"8";"Barcelona";"1";"Barcelona";"11";"Baix Llobregat";"08263";"Sant Vicenç dels Horts";"1";"7";"A";"638";"240";"404";"488";"150";"2";"8";"478";"486"
"8";"Barcelona";"1";"Barcelona";"11";"Baix Llobregat";"08263";"Sant Vicenç dels Horts";"1";"7";"B";"669";"246";"421";"515";"154";"2";"6";"507";"513"
"8";"Barcelona";"1";"Barcelona";"11";"Baix Llobregat";"08263";"Sant Vicenç dels Horts";"1";"8";"U";"825";"372";"610";"661";"164";"7";"4";"650";"654"
"8";"Barcelona";"1";"Barcelona";"11";"Baix Llobregat";"08263";"Sant Vicenç dels Horts";"1";"9";"U";"574";"222";"386";"453";"121";"0";"3";"450";"453"
"8";"Barcelona";"1";"Barcelona";"11";"Baix Llobregat";"08263";"Sant Vicenç dels Horts";"2";"1";"A";"264";"72";"137";"172";"92";"0";"0";"172";"172"
"8";"Barcelona";"1";"Barcelona";"11";"Baix Llobregat";"08263";"Sant Vicenç dels Horts";"2";"1";"B";"254";"63";"112";"149";"105";"0";"0";"149";"149"
"8";"Barcelona";"1";"Barcelona";"11";"Baix Llobregat";"08263";"Sant Vicenç dels Horts";"2";"2";"A";"687";"230";"434";"501";"186";"4";"3";"494";"497"
"8";"Barcelona";"1";"Barcelona";"11";"Baix Llobregat";"08263";"Sant Vicenç dels Horts";"2";"2";"B";"836";"301";"478";"591";"245";"0";"6";"585";"591"
"8";"Barcelona";"1";"Barcelona";"11";"Baix Llobregat";"08263";"Sant Vicenç dels Horts";"2";"3";"A";"484";"160";"274";"341";"143";"1";"1";"339";"340"
"8";"Barcelona";"1";"Barcelona";"11";"Baix Llobregat";"08263";"Sant Vicenç dels Horts";"2";"3";"B";"526";"145";"266";"340";"186";"0";"6";"334";"340"
"8";"Barcelona";"1";"Barcelona";"11";"Baix Llobregat";"08263";"Sant Vicenç dels Horts";"3";"1";"A";"683";"255";"406";"483";"200";"3";"1";"479";"480"
"8";"Barcelona";"1";"Barcelona";"11";"Baix Llobregat";"08263";"Sant Vicenç dels Horts";"3";"1";"B";"758";"244";"443";"534";"224";"5";"3";"526";"529"
"8";"Barcelona";"1";"Barcelona";"11";"Baix Llobregat";"08263";"Sant Vicenç dels Horts";"3";"2";"A";"631";"223";"381";"457";"174";"0";"2";"455";"457"
"8";"Barcelona";"1";"Barcelona";"11";"Baix Llobregat";"08263";"Sant Vicenç dels Horts";"3";"2";"B";"705";"260";"449";"545";"160";"1";"1";"543";"544"
"8";"Barcelona";"1";"Barcelona";"11";"Baix Llobregat";"08263";"Sant Vicenç dels Horts";"4";"1";"A";"633";"218";"378";"496";"137";"3";"6";"487";"493"
"8";"Barcelona";"1";"Barcelona";"11";"Baix Llobregat";"08263";"Sant Vicenç dels Horts";"4";"1";"B";"713";"250";"462";"547";"166";"3";"9";"535";"544"
"8";"Barcelona";"1";"Barcelona";"11";"Baix Llobregat";"08263";"Sant Vicenç dels Horts";"4";"2";"A";"457";"165";"278";"331";"126";"0";"3";"328";"331"
"8";"Barcelona";"1";"Barcelona";"11";"Baix Llobregat";"08263";"Sant Vicenç dels Horts";"4";"2";"B";"861";"292";"527";"661";"200";"4";"2";"655";"657"
"8";"Barcelona";"1";"Barcelona";"11";"Baix Llobregat";"08263";"Sant Vicenç dels Horts";"4";"3";"U";"856";"328";"581";"688";"168";"1";"5";"682";"687"
"8";"Barcelona";"1";"Barcelona";"11";"Baix Llobregat";"08244";"Santa Coloma de Cervelló";"1";"1";"A";"486";"187";"319";"387";"99";"0";"3";"384";"387"
"8";"Barcelona";"1";"Barcelona";"11";"Baix Llobregat";"08244";"Santa Coloma de Cervelló";"1";"1";"B";"568";"210";"367";"463";"105";"2";"2";"459";"461"
"8";"Barcelona";"1";"Barcelona";"11";"Baix Llobregat";"08244";"Santa Coloma de Cervelló";"1";"1";"C";"605";"241";"432";"508";"97";"1";"3";"504";"507"
"8";"Barcelona";"1";"Barcelona";"11";"Baix Llobregat";"08244";"Santa Coloma de Cervelló";"1";"2";"U";"580";"246";"398";"484";"96";"3";"3";"478";"481"
"8";"Barcelona";"1";"Barcelona";"11";"Baix Llobregat";"08244";"Santa Coloma de Cervelló";"1";"3";"A";"514";"218";"355";"447";"67";"0";"2";"445";"447"
"8";"Barcelona";"1";"Barcelona";"11";"Baix Llobregat";"08244";"Santa Coloma de Cervelló";"1";"3";"B";"686";"270";"473";"594";"92";"3";"3";"588";"591"
"8";"Barcelona";"1";"Barcelona";"11";"Baix Llobregat";"08244";"Santa Coloma de Cervelló";"1";"3";"C";"552";"226";"400";"473";"79";"3";"3";"467";"470"
"8";"Barcelona";"1";"Barcelona";"11";"Baix Llobregat";"08244";"Santa Coloma de Cervelló";"1";"4";"A";"632";"226";"396";"478";"154";"1";"6";"471";"477"
"8";"Barcelona";"1";"Barcelona";"11";"Baix Llobregat";"08244";"Santa Coloma de Cervelló";"1";"4";"B";"671";"245";"436";"532";"139";"4";"2";"526";"528"
"8";"Barcelona";"1";"Barcelona";"11";"Baix Llobregat";"08244";"Santa Coloma de Cervelló";"1";"5";"U";"541";"202";"349";"428";"113";"2";"0";"426";"426"
"8";"Barcelona";"1";"Barcelona";"13";"Barcelonès";"08245";"Santa Coloma de Gramenet";"1";"1";"U";"813";"323";"578";"692";"121";"2";"8";"682";"690"
"8";"Barcelona";"1";"Barcelona";"13";"Barcelonès";"08245";"Santa Coloma de Gramenet";"1";"10";"A";"471";"162";"271";"334";"137";"2";"0";"332";"332"
"8";"Barcelona";"1";"Barcelona";"13";"Barcelonès";"08245";"Santa Coloma de Gramenet";"1";"10";"B";"519";"196";"295";"367";"152";"1";"0";"366";"366"
"8";"Barcelona";"1";"Barcelona";"13";"Barcelonès";"08245";"Santa Coloma de Gramenet";"1";"11";"A";"399";"162";"253";"309";"90";"0";"0";"309";"309"
"8";"Barcelona";"1";"Barcelona";"13";"Barcelonès";"08245";"Santa Coloma de Gramenet";"1";"11";"B";"410";"150";"256";"306";"104";"0";"1";"305";"306"
"8";"Barcelona";"1";"Barcelona";"13";"Barcelonès";"08245";"Santa Coloma de Gramenet";"1";"12";"U";"623";"215";"389";"485";"138";"1";"6";"478";"484"
"8";"Barcelona";"1";"Barcelona";"13";"Barcelonès";"08245";"Santa Coloma de Gramenet";"1";"13";"A";"434";"148";"277";"349";"85";"0";"6";"343";"349"
"8";"Barcelona";"1";"Barcelona";"13";"Barcelonès";"08245";"Santa Coloma de Gramenet";"1";"13";"B";"529";"202";"339";"425";"104";"3";"2";"420";"422"
"8";"Barcelona";"1";"Barcelona";"13";"Barcelonès";"08245";"Santa Coloma de Gramenet";"1";"13";"C";"495";"191";"312";"391";"104";"5";"2";"384";"386"
"8";"Barcelona";"1";"Barcelona";"13";"Barcelonès";"08245";"Santa Coloma de Gramenet";"1";"14";"U";"864";"298";"581";"720";"144";"3";"2";"715";"717"
"8";"Barcelona";"1";"Barcelona";"13";"Barcelonès";"08245";"Santa Coloma de Gramenet";"1";"15";"U";"629";"189";"366";"470";"159";"7";"4";"459";"463"
"8";"Barcelona";"1";"Barcelona";"13";"Barcelonès";"08245";"Santa Coloma de Gramenet";"1";"16";"U";"675";"260";"430";"528";"147";"0";"2";"526";"528"
"8";"Barcelona";"1";"Barcelona";"13";"Barcelonès";"08245";"Santa Coloma de Gramenet";"1";"17";"A";"582";"192";"350";"456";"126";"5";"7";"444";"451"
"8";"Barcelona";"1";"Barcelona";"13";"Barcelonès";"08245";"Santa Coloma de Gramenet";"1";"17";"B";"644";"230";"381";"480";"164";"0";"4";"476";"480"
"8";"Barcelona";"1";"Barcelona";"13";"Barcelonès";"08245";"Santa Coloma de Gramenet";"1";"18";"A";"502";"179";"330";"396";"106";"0";"2";"394";"396"
"8";"Barcelona";"1";"Barcelona";"13";"Barcelonès";"08245";"Santa Coloma de Gramenet";"1";"18";"B";"522";"170";"309";"400";"122";"1";"2";"397";"399"
"8";"Barcelona";"1";"Barcelona";"13";"Barcelonès";"08245";"Santa Coloma de Gramenet";"1";"19";"A";"504";"163";"277";"366";"138";"1";"0";"365";"365"
"8";"Barcelona";"1";"Barcelona";"13";"Barcelonès";"08245";"Santa Coloma de Gramenet";"1";"19";"B";"598";"214";"358";"448";"150";"1";"1";"446";"447"
"8";"Barcelona";"1";"Barcelona";"13";"Barcelonès";"08245";"Santa Coloma de Gramenet";"1";"2";"U";"699";"279";"443";"555";"144";"5";"1";"549";"550"
"8";"Barcelona";"1";"Barcelona";"13";"Barcelonès";"08245";"Santa Coloma de Gramenet";"1";"3";"A";"432";"160";"253";"311";"121";"1";"4";"306";"310"
"8";"Barcelona";"1";"Barcelona";"13";"Barcelonès";"08245";"Santa Coloma de Gramenet";"1";"3";"B";"476";"186";"281";"346";"130";"0";"6";"340";"346"
"8";"Barcelona";"1";"Barcelona";"13";"Barcelonès";"08245";"Santa Coloma de Gramenet";"1";"4";"U";"584";"204";"337";"416";"168";"4";"5";"407";"412"
"8";"Barcelona";"1";"Barcelona";"13";"Barcelonès";"08245";"Santa Coloma de Gramenet";"1";"5";"U";"639";"229";"375";"452";"187";"5";"2";"445";"447"
"8";"Barcelona";"1";"Barcelona";"13";"Barcelonès";"08245";"Santa Coloma de Gramenet";"1";"6";"U";"594";"216";"365";"430";"164";"0";"1";"429";"430"
"8";"Barcelona";"1";"Barcelona";"13";"Barcelonès";"08245";"Santa Coloma de Gramenet";"1";"7";"U";"460";"159";"246";"296";"164";"2";"0";"294";"294"
"8";"Barcelona";"1";"Barcelona";"13";"Barcelonès";"08245";"Santa Coloma de Gramenet";"1";"8";"U";"445";"159";"255";"308";"137";"4";"3";"301";"304"
"8";"Barcelona";"1";"Barcelona";"13";"Barcelonès";"08245";"Santa Coloma de Gramenet";"1";"9";"A";"405";"155";"250";"312";"93";"1";"1";"310";"311"
"8";"Barcelona";"1";"Barcelona";"13";"Barcelonès";"08245";"Santa Coloma de Gramenet";"1";"9";"B";"480";"172";"276";"350";"130";"3";"1";"346";"347"
"8";"Barcelona";"1";"Barcelona";"13";"Barcelonès";"08245";"Santa Coloma de Gramenet";"2";"1";"U";"728";"269";"480";"557";"171";"0";"2";"555";"557"
"8";"Barcelona";"1";"Barcelona";"13";"Barcelonès";"08245";"Santa Coloma de Gramenet";"2";"10";"U";"558";"191";"297";"378";"180";"0";"2";"376";"378"
"8";"Barcelona";"1";"Barcelona";"13";"Barcelonès";"08245";"Santa Coloma de Gramenet";"2";"11";"A";"449";"169";"263";"315";"134";"1";"1";"313";"314"
"8";"Barcelona";"1";"Barcelona";"13";"Barcelonès";"08245";"Santa Coloma de Gramenet";"2";"11";"B";"475";"186";"279";"353";"122";"0";"2";"351";"353"
"8";"Barcelona";"1";"Barcelona";"13";"Barcelonès";"08245";"Santa Coloma de Gramenet";"2";"2";"A";"528";"191";"317";"397";"131";"3";"2";"392";"394"
"8";"Barcelona";"1";"Barcelona";"13";"Barcelonès";"08245";"Santa Coloma de Gramenet";"2";"2";"B";"619";"197";"367";"471";"148";"2";"4";"465";"469"
"8";"Barcelona";"1";"Barcelona";"13";"Barcelonès";"08245";"Santa Coloma de Gramenet";"2";"3";"A";"555";"160";"348";"418";"137";"0";"5";"413";"418"
"8";"Barcelona";"1";"Barcelona";"13";"Barcelonès";"08245";"Santa Coloma de Gramenet";"2";"3";"B";"677";"209";"407";"504";"173";"0";"2";"502";"504"
"8";"Barcelona";"1";"Barcelona";"13";"Barcelonès";"08245";"Santa Coloma de Gramenet";"2";"4";"A";"349";"126";"202";"247";"102";"0";"0";"247";"247"
"8";"Barcelona";"1";"Barcelona";"13";"Barcelonès";"08245";"Santa Coloma de Gramenet";"2";"4";"B";"449";"151";"258";"311";"138";"0";"2";"309";"311"
"8";"Barcelona";"1";"Barcelona";"13";"Barcelonès";"08245";"Santa Coloma de Gramenet";"2";"5";"A";"432";"148";"247";"314";"118";"2";"0";"312";"312"
"8";"Barcelona";"1";"Barcelona";"13";"Barcelonès";"08245";"Santa Coloma de Gramenet";"2";"5";"B";"435";"176";"268";"317";"118";"2";"0";"315";"315"
"8";"Barcelona";"1";"Barcelona";"13";"Barcelonès";"08245";"Santa Coloma de Gramenet";"2";"6";"A";"419";"155";"257";"312";"107";"2";"3";"307";"310"
"8";"Barcelona";"1";"Barcelona";"13";"Barcelonès";"08245";"Santa Coloma de Gramenet";"2";"6";"B";"453";"175";"286";"335";"118";"0";"3";"332";"335"
"8";"Barcelona";"1";"Barcelona";"13";"Barcelonès";"08245";"Santa Coloma de Gramenet";"2";"7";"A";"465";"144";"245";"326";"139";"0";"2";"324";"326"
"8";"Barcelona";"1";"Barcelona";"13";"Barcelonès";"08245";"Santa Coloma de Gramenet";"2";"7";"B";"545";"167";"288";"415";"130";"1";"1";"413";"414"
"8";"Barcelona";"1";"Barcelona";"13";"Barcelonès";"08245";"Santa Coloma de Gramenet";"2";"7";"C";"512";"140";"271";"381";"131";"0";"4";"377";"381"
"8";"Barcelona";"1";"Barcelona";"13";"Barcelonès";"08245";"Santa Coloma de Gramenet";"2";"8";"A";"456";"181";"290";"354";"102";"1";"1";"352";"353"
"8";"Barcelona";"1";"Barcelona";"13";"Barcelonès";"08245";"Santa Coloma de Gramenet";"2";"8";"B";"568";"210";"332";"416";"152";"0";"1";"415";"416"
"8";"Barcelona";"1";"Barcelona";"13";"Barcelonès";"08245";"Santa Coloma de Gramenet";"2";"9";"A";"413";"142";"237";"303";"110";"0";"1";"302";"303"
"8";"Barcelona";"1";"Barcelona";"13";"Barcelonès";"08245";"Santa Coloma de Gramenet";"2";"9";"B";"442";"140";"267";"331";"111";"0";"0";"331";"331"
"8";"Barcelona";"1";"Barcelona";"13";"Barcelonès";"08245";"Santa Coloma de Gramenet";"3";"1";"U";"584";"201";"336";"431";"153";"2";"2";"427";"429"
"8";"Barcelona";"1";"Barcelona";"13";"Barcelonès";"08245";"Santa Coloma de Gramenet";"3";"10";"U";"535";"201";"318";"429";"106";"0";"0";"429";"429"
"8";"Barcelona";"1";"Barcelona";"13";"Barcelonès";"08245";"Santa Coloma de Gramenet";"3";"11";"U";"851";"284";"530";"680";"171";"3";"6";"671";"677"
"8";"Barcelona";"1";"Barcelona";"13";"Barcelonès";"08245";"Santa Coloma de Gramenet";"3";"12";"A";"529";"180";"313";"400";"129";"0";"6";"394";"400"
"8";"Barcelona";"1";"Barcelona";"13";"Barcelonès";"08245";"Santa Coloma de Gramenet";"3";"12";"B";"654";"237";"397";"501";"153";"5";"4";"492";"496"
"8";"Barcelona";"1";"Barcelona";"13";"Barcelonès";"08245";"Santa Coloma de Gramenet";"3";"13";"A";"370";"122";"224";"285";"85";"0";"0";"285";"285"
"8";"Barcelona";"1";"Barcelona";"13";"Barcelonès";"08245";"Santa Coloma de Gramenet";"3";"13";"B";"450";"161";"284";"345";"105";"0";"1";"344";"345"
"8";"Barcelona";"1";"Barcelona";"13";"Barcelonès";"08245";"Santa Coloma de Gramenet";"3";"13";"C";"472";"170";"302";"369";"103";"2";"0";"367";"367"
"8";"Barcelona";"1";"Barcelona";"13";"Barcelonès";"08245";"Santa Coloma de Gramenet";"3";"14";"A";"458";"159";"267";"328";"130";"4";"1";"323";"324"
"8";"Barcelona";"1";"Barcelona";"13";"Barcelonès";"08245";"Santa Coloma de Gramenet";"3";"14";"B";"490";"162";"280";"349";"141";"3";"0";"346";"346"
"8";"Barcelona";"1";"Barcelona";"13";"Barcelonès";"08245";"Santa Coloma de Gramenet";"3";"15";"A";"480";"143";"268";"369";"111";"0";"0";"369";"369"
"8";"Barcelona";"1";"Barcelona";"13";"Barcelonès";"08245";"Santa Coloma de Gramenet";"3";"15";"B";"561";"181";"315";"422";"139";"1";"1";"420";"421"
"8";"Barcelona";"1";"Barcelona";"13";"Barcelonès";"08245";"Santa Coloma de Gramenet";"3";"16";"U";"716";"214";"435";"548";"168";"1";"5";"542";"547"
"8";"Barcelona";"1";"Barcelona";"13";"Barcelonès";"08245";"Santa Coloma de Gramenet";"3";"17";"U";"551";"195";"303";"384";"167";"3";"3";"378";"381"
"8";"Barcelona";"1";"Barcelona";"13";"Barcelonès";"08245";"Santa Coloma de Gramenet";"3";"2";"U";"552";"205";"323";"411";"141";"2";"2";"407";"409"
"8";"Barcelona";"1";"Barcelona";"13";"Barcelonès";"08245";"Santa Coloma de Gramenet";"3";"3";"U";"644";"218";"422";"515";"129";"1";"2";"512";"514"
"8";"Barcelona";"1";"Barcelona";"13";"Barcelonès";"08245";"Santa Coloma de Gramenet";"3";"4";"A";"370";"138";"237";"266";"104";"0";"0";"266";"266"
"8";"Barcelona";"1";"Barcelona";"13";"Barcelonès";"08245";"Santa Coloma de Gramenet";"3";"4";"B";"422";"142";"236";"294";"128";"0";"0";"294";"294"
"8";"Barcelona";"1";"Barcelona";"13";"Barcelonès";"08245";"Santa Coloma de Gramenet";"3";"5";"A";"370";"125";"192";"242";"128";"0";"0";"242";"242"
"8";"Barcelona";"1";"Barcelona";"13";"Barcelonès";"08245";"Santa Coloma de Gramenet";"3";"5";"B";"484";"164";"250";"311";"173";"4";"2";"305";"307"
"8";"Barcelona";"1";"Barcelona";"13";"Barcelonès";"08245";"Santa Coloma de Gramenet";"3";"6";"A";"369";"129";"216";"272";"97";"0";"0";"272";"272"
"8";"Barcelona";"1";"Barcelona";"13";"Barcelonès";"08245";"Santa Coloma de Gramenet";"3";"6";"B";"497";"178";"293";"367";"130";"0";"1";"366";"367"
"8";"Barcelona";"1";"Barcelona";"13";"Barcelonès";"08245";"Santa Coloma de Gramenet";"3";"7";"A";"402";"169";"259";"312";"90";"2";"0";"310";"310"
"8";"Barcelona";"1";"Barcelona";"13";"Barcelonès";"08245";"Santa Coloma de Gramenet";"3";"7";"B";"519";"174";"313";"404";"115";"0";"1";"403";"404"
"8";"Barcelona";"1";"Barcelona";"13";"Barcelonès";"08245";"Santa Coloma de Gramenet";"3";"7";"C";"449";"173";"274";"348";"101";"2";"1";"345";"346"
"8";"Barcelona";"1";"Barcelona";"13";"Barcelonès";"08245";"Santa Coloma de Gramenet";"3";"8";"U";"631";"237";"371";"474";"157";"2";"5";"467";"472"
"8";"Barcelona";"1";"Barcelona";"13";"Barcelonès";"08245";"Santa Coloma de Gramenet";"3";"9";"U";"1181";"358";"673";"861";"320";"3";"2";"856";"858"
"8";"Barcelona";"1";"Barcelona";"13";"Barcelonès";"08245";"Santa Coloma de Gramenet";"4";"1";"U";"843";"278";"533";"662";"181";"2";"7";"653";"660"
"8";"Barcelona";"1";"Barcelona";"13";"Barcelonès";"08245";"Santa Coloma de Gramenet";"4";"10";"A";"415";"160";"261";"313";"102";"2";"0";"311";"311"
"8";"Barcelona";"1";"Barcelona";"13";"Barcelonès";"08245";"Santa Coloma de Gramenet";"4";"10";"B";"502";"188";"308";"364";"138";"2";"3";"359";"362"
"8";"Barcelona";"1";"Barcelona";"13";"Barcelonès";"08245";"Santa Coloma de Gramenet";"4";"11";"A";"368";"131";"230";"279";"89";"0";"0";"279";"279"
"8";"Barcelona";"1";"Barcelona";"13";"Barcelonès";"08245";"Santa Coloma de Gramenet";"4";"11";"B";"426";"173";"286";"333";"93";"1";"1";"331";"332"
"8";"Barcelona";"1";"Barcelona";"13";"Barcelonès";"08245";"Santa Coloma de Gramenet";"4";"12";"A";"326";"142";"208";"251";"75";"0";"0";"251";"251"
"8";"Barcelona";"1";"Barcelona";"13";"Barcelonès";"08245";"Santa Coloma de Gramenet";"4";"12";"B";"409";"161";"247";"310";"99";"0";"0";"310";"310"
"8";"Barcelona";"1";"Barcelona";"13";"Barcelonès";"08245";"Santa Coloma de Gramenet";"4";"13";"A";"347";"152";"232";"284";"63";"1";"1";"282";"283"
"8";"Barcelona";"1";"Barcelona";"13";"Barcelonès";"08245";"Santa Coloma de Gramenet";"4";"13";"B";"444";"191";"284";"352";"92";"0";"0";"352";"352"
"8";"Barcelona";"1";"Barcelona";"13";"Barcelonès";"08245";"Santa Coloma de Gramenet";"4";"14";"A";"385";"163";"236";"291";"94";"0";"4";"287";"291"
"8";"Barcelona";"1";"Barcelona";"13";"Barcelonès";"08245";"Santa Coloma de Gramenet";"4";"14";"B";"443";"165";"283";"344";"99";"0";"1";"343";"344"
"8";"Barcelona";"1";"Barcelona";"13";"Barcelonès";"08245";"Santa Coloma de Gramenet";"4";"14";"C";"488";"199";"312";"375";"113";"2";"2";"371";"373"
"8";"Barcelona";"1";"Barcelona";"13";"Barcelonès";"08245";"Santa Coloma de Gramenet";"4";"15";"A";"415";"169";"239";"289";"126";"1";"1";"287";"288"
"8";"Barcelona";"1";"Barcelona";"13";"Barcelonès";"08245";"Santa Coloma de Gramenet";"4";"15";"B";"536";"205";"305";"370";"166";"0";"1";"369";"370"
"8";"Barcelona";"1";"Barcelona";"13";"Barcelonès";"08245";"Santa Coloma de Gramenet";"4";"16";"A";"475";"171";"283";"358";"117";"0";"0";"358";"358"
"8";"Barcelona";"1";"Barcelona";"13";"Barcelonès";"08245";"Santa Coloma de Gramenet";"4";"16";"B";"638";"231";"398";"499";"139";"0";"0";"499";"499"
"8";"Barcelona";"1";"Barcelona";"13";"Barcelonès";"08245";"Santa Coloma de Gramenet";"4";"2";"A";"449";"175";"291";"351";"98";"1";"2";"348";"350"
"8";"Barcelona";"1";"Barcelona";"13";"Barcelonès";"08245";"Santa Coloma de Gramenet";"4";"2";"B";"454";"182";"294";"359";"95";"1";"4";"354";"358"
"8";"Barcelona";"1";"Barcelona";"13";"Barcelonès";"08245";"Santa Coloma de Gramenet";"4";"3";"A";"588";"183";"350";"446";"142";"3";"1";"442";"443"
"8";"Barcelona";"1";"Barcelona";"13";"Barcelonès";"08245";"Santa Coloma de Gramenet";"4";"3";"B";"670";"225";"400";"502";"168";"2";"5";"495";"500"
"8";"Barcelona";"1";"Barcelona";"13";"Barcelonès";"08245";"Santa Coloma de Gramenet";"4";"4";"A";"545";"170";"333";"419";"126";"2";"3";"414";"417"
"8";"Barcelona";"1";"Barcelona";"13";"Barcelonès";"08245";"Santa Coloma de Gramenet";"4";"4";"B";"666";"229";"435";"544";"122";"2";"3";"539";"542"
"8";"Barcelona";"1";"Barcelona";"13";"Barcelonès";"08245";"Santa Coloma de Gramenet";"4";"5";"U";"785";"239";"487";"610";"175";"2";"3";"605";"608"
"8";"Barcelona";"1";"Barcelona";"13";"Barcelonès";"08245";"Santa Coloma de Gramenet";"4";"6";"A";"461";"140";"269";"338";"123";"3";"1";"334";"335"
"8";"Barcelona";"1";"Barcelona";"13";"Barcelonès";"08245";"Santa Coloma de Gramenet";"4";"6";"B";"555";"175";"333";"417";"138";"1";"2";"414";"416"
"8";"Barcelona";"1";"Barcelona";"13";"Barcelonès";"08245";"Santa Coloma de Gramenet";"4";"7";"A";"529";"185";"332";"403";"126";"2";"1";"400";"401"
"8";"Barcelona";"1";"Barcelona";"13";"Barcelonès";"08245";"Santa Coloma de Gramenet";"4";"7";"B";"635";"239";"389";"488";"147";"5";"2";"481";"483"
"8";"Barcelona";"1";"Barcelona";"13";"Barcelonès";"08245";"Santa Coloma de Gramenet";"4";"8";"A";"343";"118";"200";"254";"89";"0";"0";"254";"254"
"8";"Barcelona";"1";"Barcelona";"13";"Barcelonès";"08245";"Santa Coloma de Gramenet";"4";"8";"B";"409";"157";"252";"323";"86";"0";"1";"322";"323"
"8";"Barcelona";"1";"Barcelona";"13";"Barcelonès";"08245";"Santa Coloma de Gramenet";"4";"8";"C";"517";"173";"301";"382";"135";"1";"2";"379";"381"
"8";"Barcelona";"1";"Barcelona";"13";"Barcelonès";"08245";"Santa Coloma de Gramenet";"4";"9";"A";"547";"230";"363";"431";"116";"5";"4";"422";"426"
"8";"Barcelona";"1";"Barcelona";"13";"Barcelonès";"08245";"Santa Coloma de Gramenet";"4";"9";"B";"599";"242";"359";"452";"147";"1";"2";"449";"451"
"8";"Barcelona";"1";"Barcelona";"13";"Barcelonès";"08245";"Santa Coloma de Gramenet";"5";"1";"U";"584";"225";"340";"404";"180";"7";"1";"396";"397"
"8";"Barcelona";"1";"Barcelona";"13";"Barcelonès";"08245";"Santa Coloma de Gramenet";"5";"10";"U";"498";"178";"234";"285";"213";"0";"0";"285";"285"
"8";"Barcelona";"1";"Barcelona";"13";"Barcelonès";"08245";"Santa Coloma de Gramenet";"5";"11";"A";"417";"119";"216";"273";"144";"3";"0";"270";"270"
"8";"Barcelona";"1";"Barcelona";"13";"Barcelonès";"08245";"Santa Coloma de Gramenet";"5";"11";"B";"457";"149";"252";"303";"154";"1";"1";"301";"302"
"8";"Barcelona";"1";"Barcelona";"13";"Barcelonès";"08245";"Santa Coloma de Gramenet";"5";"12";"U";"777";"232";"381";"492";"285";"0";"2";"490";"492"
"8";"Barcelona";"1";"Barcelona";"13";"Barcelonès";"08245";"Santa Coloma de Gramenet";"5";"13";"A";"399";"130";"196";"250";"149";"0";"2";"248";"250"
"8";"Barcelona";"1";"Barcelona";"13";"Barcelonès";"08245";"Santa Coloma de Gramenet";"5";"13";"B";"424";"138";"231";"294";"130";"6";"4";"284";"288"
"8";"Barcelona";"1";"Barcelona";"13";"Barcelonès";"08245";"Santa Coloma de Gramenet";"5";"14";"A";"452";"150";"260";"322";"130";"0";"2";"320";"322"
"8";"Barcelona";"1";"Barcelona";"13";"Barcelonès";"08245";"Santa Coloma de Gramenet";"5";"14";"B";"524";"181";"310";"394";"130";"4";"3";"387";"390"
"8";"Barcelona";"1";"Barcelona";"13";"Barcelonès";"08245";"Santa Coloma de Gramenet";"5";"15";"A";"435";"112";"206";"278";"157";"0";"0";"278";"278"
"8";"Barcelona";"1";"Barcelona";"13";"Barcelonès";"08245";"Santa Coloma de Gramenet";"5";"15";"B";"517";"131";"266";"336";"181";"1";"1";"334";"335"
"8";"Barcelona";"1";"Barcelona";"13";"Barcelonès";"08245";"Santa Coloma de Gramenet";"5";"16";"U";"811";"228";"447";"595";"216";"1";"3";"591";"594"
"8";"Barcelona";"1";"Barcelona";"13";"Barcelonès";"08245";"Santa Coloma de Gramenet";"5";"17";"U";"492";"168";"252";"303";"189";"1";"3";"299";"302"
"8";"Barcelona";"1";"Barcelona";"13";"Barcelonès";"08245";"Santa Coloma de Gramenet";"5";"18";"A";"355";"78";"145";"191";"164";"0";"3";"188";"191"
"8";"Barcelona";"1";"Barcelona";"13";"Barcelonès";"08245";"Santa Coloma de Gramenet";"5";"18";"B";"284";"77";"125";"158";"126";"0";"0";"158";"158"
"8";"Barcelona";"1";"Barcelona";"13";"Barcelonès";"08245";"Santa Coloma de Gramenet";"5";"19";"U";"818";"273";"494";"595";"223";"1";"7";"587";"594"
"8";"Barcelona";"1";"Barcelona";"13";"Barcelonès";"08245";"Santa Coloma de Gramenet";"5";"2";"A";"432";"162";"262";"317";"115";"1";"0";"316";"316"
"8";"Barcelona";"1";"Barcelona";"13";"Barcelonès";"08245";"Santa Coloma de Gramenet";"5";"2";"B";"513";"197";"311";"364";"149";"0";"0";"364";"364"
"8";"Barcelona";"1";"Barcelona";"13";"Barcelonès";"08245";"Santa Coloma de Gramenet";"5";"3";"U";"696";"257";"421";"497";"199";"1";"4";"492";"496"
"8";"Barcelona";"1";"Barcelona";"13";"Barcelonès";"08245";"Santa Coloma de Gramenet";"5";"4";"U";"564";"188";"334";"406";"158";"1";"1";"404";"405"
"8";"Barcelona";"1";"Barcelona";"13";"Barcelonès";"08245";"Santa Coloma de Gramenet";"5";"5";"A";"380";"124";"197";"240";"140";"2";"4";"234";"238"
"8";"Barcelona";"1";"Barcelona";"13";"Barcelonès";"08245";"Santa Coloma de Gramenet";"5";"5";"B";"400";"134";"219";"260";"140";"0";"0";"260";"260"
"8";"Barcelona";"1";"Barcelona";"13";"Barcelonès";"08245";"Santa Coloma de Gramenet";"5";"6";"U";"630";"213";"348";"450";"180";"1";"0";"449";"449"
"8";"Barcelona";"1";"Barcelona";"13";"Barcelonès";"08245";"Santa Coloma de Gramenet";"5";"7";"A";"346";"120";"202";"246";"100";"2";"0";"244";"244"
"8";"Barcelona";"1";"Barcelona";"13";"Barcelonès";"08245";"Santa Coloma de Gramenet";"5";"7";"B";"353";"129";"207";"258";"95";"2";"0";"256";"256"
"8";"Barcelona";"1";"Barcelona";"13";"Barcelonès";"08245";"Santa Coloma de Gramenet";"5";"8";"U";"577";"142";"267";"347";"230";"0";"1";"346";"347"
"8";"Barcelona";"1";"Barcelona";"13";"Barcelonès";"08245";"Santa Coloma de Gramenet";"5";"9";"U";"763";"238";"403";"477";"286";"1";"0";"476";"476"
"8";"Barcelona";"1";"Barcelona";"13";"Barcelonès";"08245";"Santa Coloma de Gramenet";"6";"1";"U";"481";"178";"302";"363";"118";"1";"0";"362";"362"
"8";"Barcelona";"1";"Barcelona";"13";"Barcelonès";"08245";"Santa Coloma de Gramenet";"6";"10";"U";"463";"140";"209";"265";"198";"0";"4";"261";"265"
"8";"Barcelona";"1";"Barcelona";"13";"Barcelonès";"08245";"Santa Coloma de Gramenet";"6";"11";"U";"472";"165";"259";"309";"163";"0";"0";"309";"309"
"8";"Barcelona";"1";"Barcelona";"13";"Barcelonès";"08245";"Santa Coloma de Gramenet";"6";"12";"U";"473";"159";"266";"318";"155";"0";"3";"315";"318"
"8";"Barcelona";"1";"Barcelona";"13";"Barcelonès";"08245";"Santa Coloma de Gramenet";"6";"13";"U";"245";"106";"157";"186";"59";"2";"2";"182";"184"
"8";"Barcelona";"1";"Barcelona";"13";"Barcelonès";"08245";"Santa Coloma de Gramenet";"6";"14";"A";"314";"111";"160";"198";"116";"1";"1";"196";"197"
"8";"Barcelona";"1";"Barcelona";"13";"Barcelonès";"08245";"Santa Coloma de Gramenet";"6";"14";"B";"393";"144";"222";"261";"132";"1";"2";"258";"260"
"8";"Barcelona";"1";"Barcelona";"13";"Barcelonès";"08245";"Santa Coloma de Gramenet";"6";"15";"U";"302";"112";"168";"195";"107";"0";"0";"195";"195"
"8";"Barcelona";"1";"Barcelona";"13";"Barcelonès";"08245";"Santa Coloma de Gramenet";"6";"16";"U";"283";"85";"117";"145";"138";"0";"0";"145";"145"
"8";"Barcelona";"1";"Barcelona";"13";"Barcelonès";"08245";"Santa Coloma de Gramenet";"6";"17";"U";"425";"134";"195";"252";"173";"3";"2";"247";"249"
"8";"Barcelona";"1";"Barcelona";"13";"Barcelonès";"08245";"Santa Coloma de Gramenet";"6";"2";"U";"620";"224";"346";"439";"181";"0";"3";"436";"439"
"8";"Barcelona";"1";"Barcelona";"13";"Barcelonès";"08245";"Santa Coloma de Gramenet";"6";"3";"A";"294";"111";"162";"199";"95";"0";"0";"199";"199"
"8";"Barcelona";"1";"Barcelona";"13";"Barcelonès";"08245";"Santa Coloma de Gramenet";"6";"3";"B";"314";"110";"157";"198";"116";"1";"3";"194";"197"
"8";"Barcelona";"1";"Barcelona";"13";"Barcelonès";"08245";"Santa Coloma de Gramenet";"6";"4";"A";"259";"95";"153";"188";"71";"0";"1";"187";"188"
"8";"Barcelona";"1";"Barcelona";"13";"Barcelonès";"08245";"Santa Coloma de Gramenet";"6";"4";"B";"357";"139";"218";"262";"95";"1";"0";"261";"261"
"8";"Barcelona";"1";"Barcelona";"13";"Barcelonès";"08245";"Santa Coloma de Gramenet";"6";"5";"U";"641";"219";"343";"439";"202";"2";"2";"435";"437"
"8";"Barcelona";"1";"Barcelona";"13";"Barcelonès";"08245";"Santa Coloma de Gramenet";"6";"6";"U";"421";"166";"269";"310";"111";"0";"2";"308";"310"
"8";"Barcelona";"1";"Barcelona";"13";"Barcelonès";"08245";"Santa Coloma de Gramenet";"6";"7";"U";"288";"93";"143";"199";"89";"1";"1";"197";"198"
"8";"Barcelona";"1";"Barcelona";"13";"Barcelonès";"08245";"Santa Coloma de Gramenet";"6";"8";"A";"330";"128";"203";"238";"92";"0";"0";"238";"238"
"8";"Barcelona";"1";"Barcelona";"13";"Barcelonès";"08245";"Santa Coloma de Gramenet";"6";"8";"B";"348";"115";"204";"242";"106";"1";"1";"240";"241"
"8";"Barcelona";"1";"Barcelona";"13";"Barcelonès";"08245";"Santa Coloma de Gramenet";"6";"9";"U";"377";"149";"212";"245";"132";"0";"1";"244";"245"
"8";"Barcelona";"1";"Barcelona";"41";"Vallès Oriental";"08248";"Santa Eulàlia de Ronçana";"1";"1";"A";"879";"277";"597";"714";"165";"2";"4";"708";"712"
"8";"Barcelona";"1";"Barcelona";"41";"Vallès Oriental";"08248";"Santa Eulàlia de Ronçana";"1";"1";"B";"981";"331";"727";"768";"213";"5";"2";"761";"763"
"8";"Barcelona";"1";"Barcelona";"41";"Vallès Oriental";"08248";"Santa Eulàlia de Ronçana";"1";"1";"C";"865";"308";"546";"678";"187";"3";"3";"672";"675"
"8";"Barcelona";"1";"Barcelona";"41";"Vallès Oriental";"08248";"Santa Eulàlia de Ronçana";"1";"2";"A";"877";"323";"582";"707";"170";"7";"5";"695";"700"
"8";"Barcelona";"1";"Barcelona";"41";"Vallès Oriental";"08248";"Santa Eulàlia de Ronçana";"1";"2";"B";"946";"340";"609";"743";"203";"4";"5";"734";"739"
"8";"Barcelona";"1";"Barcelona";"41";"Vallès Oriental";"08248";"Santa Eulàlia de Ronçana";"1";"2";"C";"837";"285";"533";"653";"184";"2";"0";"651";"651"
"8";"Barcelona";"1";"Barcelona";"3";"Alt Penedès";"08249";"Santa Fe del Penedès";"1";"1";"U";"270";"120";"213";"257";"13";"1";"1";"255";"256"
"8";"Barcelona";"1";"Barcelona";"3";"Alt Penedès";"08251";"Santa Margarida i els Monjos";"1";"1";"U";"885";"336";"601";"730";"155";"1";"0";"729";"729"
"8";"Barcelona";"1";"Barcelona";"3";"Alt Penedès";"08251";"Santa Margarida i els Monjos";"1";"2";"A";"518";"204";"332";"406";"112";"2";"3";"401";"404"
"8";"Barcelona";"1";"Barcelona";"3";"Alt Penedès";"08251";"Santa Margarida i els Monjos";"1";"2";"B";"612";"250";"407";"496";"116";"3";"1";"492";"493"
"8";"Barcelona";"1";"Barcelona";"3";"Alt Penedès";"08251";"Santa Margarida i els Monjos";"1";"3";"A";"770";"304";"479";"577";"193";"0";"4";"573";"577"
"8";"Barcelona";"1";"Barcelona";"3";"Alt Penedès";"08251";"Santa Margarida i els Monjos";"1";"3";"B";"983";"399";"620";"760";"223";"2";"4";"754";"758"
"8";"Barcelona";"1";"Barcelona";"3";"Alt Penedès";"08251";"Santa Margarida i els Monjos";"1";"4";"A";"541";"210";"349";"429";"112";"1";"2";"426";"428"
"8";"Barcelona";"1";"Barcelona";"3";"Alt Penedès";"08251";"Santa Margarida i els Monjos";"1";"4";"B";"661";"153";"422";"511";"150";"4";"0";"507";"507"
"8";"Barcelona";"1";"Barcelona";"41";"Vallès Oriental";"08256";"Santa Maria de Martorelles";"1";"1";"U";"650";"253";"447";"548";"102";"1";"1";"546";"547"
"8";"Barcelona";"1";"Barcelona";"41";"Vallès Oriental";"08259";"Santa Maria de Palautordera";"1";"1";"A";"657";"286";"449";"536";"121";"0";"6";"530";"536"
"8";"Barcelona";"1";"Barcelona";"41";"Vallès Oriental";"08259";"Santa Maria de Palautordera";"1";"1";"B";"700";"300";"475";"570";"130";"1";"2";"567";"569"
"8";"Barcelona";"1";"Barcelona";"41";"Vallès Oriental";"08259";"Santa Maria de Palautordera";"1";"1";"C";"700";"273";"452";"561";"139";"2";"3";"556";"559"
"8";"Barcelona";"1";"Barcelona";"41";"Vallès Oriental";"08259";"Santa Maria de Palautordera";"1";"2";"A";"526";"216";"373";"432";"94";"2";"4";"426";"430"
"8";"Barcelona";"1";"Barcelona";"41";"Vallès Oriental";"08259";"Santa Maria de Palautordera";"1";"2";"B";"653";"258";"478";"558";"95";"1";"3";"554";"557"
"8";"Barcelona";"1";"Barcelona";"41";"Vallès Oriental";"08259";"Santa Maria de Palautordera";"1";"2";"C";"465";"187";"300";"357";"108";"3";"3";"351";"354"
"8";"Barcelona";"1";"Barcelona";"41";"Vallès Oriental";"08259";"Santa Maria de Palautordera";"1";"3";"A";"336";"123";"217";"260";"76";"0";"0";"260";"260"
"8";"Barcelona";"1";"Barcelona";"41";"Vallès Oriental";"08259";"Santa Maria de Palautordera";"1";"3";"B";"838";"338";"641";"708";"130";"3";"2";"703";"705"
"8";"Barcelona";"1";"Barcelona";"41";"Vallès Oriental";"08259";"Santa Maria de Palautordera";"1";"3";"C";"529";"221";"374";"454";"75";"1";"1";"452";"453"
"8";"Barcelona";"1";"Barcelona";"41";"Vallès Oriental";"08259";"Santa Maria de Palautordera";"1";"4";"A";"603";"245";"439";"528";"75";"1";"2";"525";"527"
"8";"Barcelona";"1";"Barcelona";"41";"Vallès Oriental";"08259";"Santa Maria de Palautordera";"1";"4";"B";"620";"255";"457";"529";"91";"2";"2";"525";"527"
"8";"Barcelona";"1";"Barcelona";"40";"Vallès Occidental";"08260";"Santa Perpètua de Mogoda";"1";"1";"A";"574";"215";"388";"459";"115";"6";"1";"452";"453"
"8";"Barcelona";"1";"Barcelona";"40";"Vallès Occidental";"08260";"Santa Perpètua de Mogoda";"1";"1";"B";"617";"236";"410";"480";"137";"4";"4";"472";"476"
"8";"Barcelona";"1";"Barcelona";"40";"Vallès Occidental";"08260";"Santa Perpètua de Mogoda";"1";"10";"U";"746";"264";"480";"601";"145";"1";"3";"597";"600"
"8";"Barcelona";"1";"Barcelona";"40";"Vallès Occidental";"08260";"Santa Perpètua de Mogoda";"1";"11";"U";"961";"347";"573";"702";"259";"3";"3";"696";"699"
"8";"Barcelona";"1";"Barcelona";"40";"Vallès Occidental";"08260";"Santa Perpètua de Mogoda";"1";"12";"A";"472";"202";"302";"372";"100";"2";"1";"369";"370"
"8";"Barcelona";"1";"Barcelona";"40";"Vallès Occidental";"08260";"Santa Perpètua de Mogoda";"1";"12";"B";"645";"265";"405";"514";"131";"0";"3";"511";"514"
"8";"Barcelona";"1";"Barcelona";"40";"Vallès Occidental";"08260";"Santa Perpètua de Mogoda";"1";"12";"C";"430";"184";"275";"347";"83";"2";"4";"341";"345"
"8";"Barcelona";"1";"Barcelona";"40";"Vallès Occidental";"08260";"Santa Perpètua de Mogoda";"1";"13";"A";"639";"206";"406";"544";"95";"1";"2";"541";"543"
"8";"Barcelona";"1";"Barcelona";"40";"Vallès Occidental";"08260";"Santa Perpètua de Mogoda";"1";"13";"B";"807";"260";"499";"679";"128";"4";"0";"675";"675"
"8";"Barcelona";"1";"Barcelona";"40";"Vallès Occidental";"08260";"Santa Perpètua de Mogoda";"1";"13";"C";"648";"220";"386";"548";"100";"2";"7";"539";"546"
"8";"Barcelona";"1";"Barcelona";"40";"Vallès Occidental";"08260";"Santa Perpètua de Mogoda";"1";"14";"U";"717";"262";"460";"604";"113";"3";"6";"595";"601"
"8";"Barcelona";"1";"Barcelona";"40";"Vallès Occidental";"08260";"Santa Perpètua de Mogoda";"1";"2";"A";"661";"250";"438";"516";"145";"4";"2";"510";"512"
"8";"Barcelona";"1";"Barcelona";"40";"Vallès Occidental";"08260";"Santa Perpètua de Mogoda";"1";"2";"B";"761";"231";"436";"564";"197";"6";"3";"555";"558"
"8";"Barcelona";"1";"Barcelona";"40";"Vallès Occidental";"08260";"Santa Perpètua de Mogoda";"1";"2";"C";"644";"202";"377";"483";"161";"0";"4";"479";"483"
"8";"Barcelona";"1";"Barcelona";"40";"Vallès Occidental";"08260";"Santa Perpètua de Mogoda";"1";"3";"A";"785";"297";"525";"630";"155";"2";"5";"623";"628"
"8";"Barcelona";"1";"Barcelona";"40";"Vallès Occidental";"08260";"Santa Perpètua de Mogoda";"1";"3";"B";"863";"337";"646";"694";"169";"2";"4";"688";"692"
"8";"Barcelona";"1";"Barcelona";"40";"Vallès Occidental";"08260";"Santa Perpètua de Mogoda";"1";"4";"A";"634";"179";"310";"394";"240";"0";"0";"394";"394"
"8";"Barcelona";"1";"Barcelona";"40";"Vallès Occidental";"08260";"Santa Perpètua de Mogoda";"1";"4";"B";"577";"198";"297";"363";"214";"0";"1";"362";"363"
"8";"Barcelona";"1";"Barcelona";"40";"Vallès Occidental";"08260";"Santa Perpètua de Mogoda";"1";"5";"A";"480";"173";"293";"362";"118";"2";"4";"356";"360"
"8";"Barcelona";"1";"Barcelona";"40";"Vallès Occidental";"08260";"Santa Perpètua de Mogoda";"1";"5";"B";"518";"182";"313";"377";"141";"0";"5";"372";"377"
"8";"Barcelona";"1";"Barcelona";"40";"Vallès Occidental";"08260";"Santa Perpètua de Mogoda";"1";"6";"U";"759";"295";"461";"573";"186";"2";"3";"568";"571"
"8";"Barcelona";"1";"Barcelona";"40";"Vallès Occidental";"08260";"Santa Perpètua de Mogoda";"1";"7";"A";"455";"175";"276";"345";"110";"6";"0";"339";"339"
"8";"Barcelona";"1";"Barcelona";"40";"Vallès Occidental";"08260";"Santa Perpètua de Mogoda";"1";"7";"B";"570";"237";"369";"460";"110";"1";"0";"459";"459"
"8";"Barcelona";"1";"Barcelona";"40";"Vallès Occidental";"08260";"Santa Perpètua de Mogoda";"1";"8";"A";"403";"162";"253";"323";"80";"0";"1";"322";"323"
"8";"Barcelona";"1";"Barcelona";"40";"Vallès Occidental";"08260";"Santa Perpètua de Mogoda";"1";"8";"B";"961";"311";"578";"726";"235";"0";"0";"726";"726"
"8";"Barcelona";"1";"Barcelona";"40";"Vallès Occidental";"08260";"Santa Perpètua de Mogoda";"1";"9";"A";"595";"235";"409";"493";"102";"1";"1";"491";"492"
"8";"Barcelona";"1";"Barcelona";"40";"Vallès Occidental";"08260";"Santa Perpètua de Mogoda";"1";"9";"B";"763";"305";"509";"620";"143";"0";"5";"615";"620"
"8";"Barcelona";"1";"Barcelona";"40";"Vallès Occidental";"08260";"Santa Perpètua de Mogoda";"1";"9";"C";"619";"226";"399";"506";"113";"3";"1";"502";"503"
"8";"Barcelona";"1";"Barcelona";"21";"Maresme";"08261";"Santa Susanna";"1";"1";"A";"595";"242";"416";"488";"107";"2";"2";"484";"486"
"8";"Barcelona";"1";"Barcelona";"21";"Maresme";"08261";"Santa Susanna";"1";"1";"B";"743";"283";"489";"609";"134";"2";"2";"605";"607"
"8";"Barcelona";"1";"Barcelona";"21";"Maresme";"08261";"Santa Susanna";"1";"2";"A";"453";"173";"267";"334";"119";"4";"0";"330";"330"
"8";"Barcelona";"1";"Barcelona";"21";"Maresme";"08261";"Santa Susanna";"1";"2";"B";"530";"194";"322";"397";"133";"2";"1";"394";"395"
"8";"Barcelona";"1";"Barcelona";"40";"Vallès Occidental";"08267";"Sentmenat";"1";"1";"A";"555";"209";"360";"456";"99";"1";"4";"451";"455"
"8";"Barcelona";"1";"Barcelona";"40";"Vallès Occidental";"08267";"Sentmenat";"1";"1";"B";"623";"204";"365";"484";"139";"3";"4";"477";"481"
"8";"Barcelona";"1";"Barcelona";"40";"Vallès Occidental";"08267";"Sentmenat";"1";"2";"A";"688";"199";"400";"504";"184";"2";"3";"499";"502"
"8";"Barcelona";"1";"Barcelona";"40";"Vallès Occidental";"08267";"Sentmenat";"1";"2";"B";"782";"232";"457";"584";"198";"1";"4";"579";"583"
"8";"Barcelona";"1";"Barcelona";"40";"Vallès Occidental";"08267";"Sentmenat";"1";"3";"A";"517";"190";"335";"410";"107";"3";"0";"407";"407"
"8";"Barcelona";"1";"Barcelona";"40";"Vallès Occidental";"08267";"Sentmenat";"1";"3";"B";"660";"255";"432";"515";"145";"0";"2";"513";"515"
"8";"Barcelona";"1";"Barcelona";"40";"Vallès Occidental";"08267";"Sentmenat";"1";"4";"A";"699";"230";"458";"569";"130";"1";"2";"566";"568"
"8";"Barcelona";"1";"Barcelona";"40";"Vallès Occidental";"08267";"Sentmenat";"1";"4";"B";"862";"268";"539";"675";"187";"1";"8";"666";"674"
"8";"Barcelona";"1";"Barcelona";"40";"Vallès Occidental";"08267";"Sentmenat";"1";"5";"A";"425";"136";"283";"364";"61";"0";"3";"361";"364"
"8";"Barcelona";"1";"Barcelona";"40";"Vallès Occidental";"08267";"Sentmenat";"1";"5";"B";"600";"176";"362";"488";"112";"3";"0";"485";"485"
"8";"Barcelona";"1";"Barcelona";"17";"Garraf";"08270";"Sitges";"1";"1";"A";"452";"130";"258";"334";"118";"3";"1";"330";"331"
"8";"Barcelona";"1";"Barcelona";"17";"Garraf";"08270";"Sitges";"1";"1";"B";"523";"165";"319";"386";"137";"1";"0";"385";"385"
"8";"Barcelona";"1";"Barcelona";"17";"Garraf";"08270";"Sitges";"1";"2";"A";"513";"168";"324";"382";"131";"0";"2";"380";"382"
"8";"Barcelona";"1";"Barcelona";"17";"Garraf";"08270";"Sitges";"1";"2";"B";"697";"202";"426";"521";"176";"2";"1";"518";"519"
"8";"Barcelona";"1";"Barcelona";"17";"Garraf";"08270";"Sitges";"1";"3";"A";"658";"251";"416";"513";"145";"2";"1";"510";"511"
"8";"Barcelona";"1";"Barcelona";"17";"Garraf";"08270";"Sitges";"1";"3";"B";"654";"252";"430";"517";"137";"2";"4";"511";"515"
"8";"Barcelona";"1";"Barcelona";"17";"Garraf";"08270";"Sitges";"1";"3";"C";"740";"251";"464";"561";"179";"1";"5";"555";"560"
"8";"Barcelona";"1";"Barcelona";"17";"Garraf";"08270";"Sitges";"1";"4";"A";"815";"261";"505";"607";"208";"2";"4";"601";"605"
"8";"Barcelona";"1";"Barcelona";"17";"Garraf";"08270";"Sitges";"1";"4";"B";"895";"267";"547";"672";"223";"2";"1";"669";"670"
"8";"Barcelona";"1";"Barcelona";"17";"Garraf";"08270";"Sitges";"1";"5";"U";"590";"206";"394";"454";"136";"2";"3";"449";"452"
"8";"Barcelona";"1";"Barcelona";"17";"Garraf";"08270";"Sitges";"2";"1";"A";"673";"203";"428";"515";"158";"1";"3";"511";"514"
"8";"Barcelona";"1";"Barcelona";"17";"Garraf";"08270";"Sitges";"2";"1";"B";"829";"242";"524";"630";"199";"1";"5";"624";"629"
"8";"Barcelona";"1";"Barcelona";"17";"Garraf";"08270";"Sitges";"2";"10";"A";"565";"190";"349";"439";"126";"0";"2";"437";"439"
"8";"Barcelona";"1";"Barcelona";"17";"Garraf";"08270";"Sitges";"2";"10";"B";"644";"235";"425";"500";"144";"1";"2";"497";"499"
"8";"Barcelona";"1";"Barcelona";"17";"Garraf";"08270";"Sitges";"2";"11";"A";"622";"168";"414";"510";"112";"3";"3";"504";"507"
"8";"Barcelona";"1";"Barcelona";"17";"Garraf";"08270";"Sitges";"2";"11";"B";"652";"174";"418";"515";"137";"1";"5";"509";"514"
"8";"Barcelona";"1";"Barcelona";"17";"Garraf";"08270";"Sitges";"2";"2";"U";"931";"283";"588";"737";"194";"0";"0";"737";"737"
"8";"Barcelona";"1";"Barcelona";"17";"Garraf";"08270";"Sitges";"2";"3";"A";"587";"161";"370";"452";"135";"4";"4";"444";"448"
"8";"Barcelona";"1";"Barcelona";"17";"Garraf";"08270";"Sitges";"2";"3";"B";"736";"214";"491";"583";"153";"3";"0";"580";"580"
"8";"Barcelona";"1";"Barcelona";"17";"Garraf";"08270";"Sitges";"2";"4";"A";"551";"151";"298";"364";"187";"1";"1";"362";"363"
"8";"Barcelona";"1";"Barcelona";"17";"Garraf";"08270";"Sitges";"2";"4";"B";"699";"211";"403";"478";"221";"1";"1";"476";"477"
"8";"Barcelona";"1";"Barcelona";"17";"Garraf";"08270";"Sitges";"2";"5";"A";"396";"161";"241";"299";"97";"0";"1";"298";"299"
"8";"Barcelona";"1";"Barcelona";"17";"Garraf";"08270";"Sitges";"2";"5";"B";"535";"127";"331";"394";"141";"0";"1";"393";"394"
"8";"Barcelona";"1";"Barcelona";"17";"Garraf";"08270";"Sitges";"2";"6";"A";"557";"200";"368";"453";"104";"1";"4";"448";"452"
"8";"Barcelona";"1";"Barcelona";"17";"Garraf";"08270";"Sitges";"2";"6";"B";"666";"232";"427";"518";"148";"3";"3";"512";"515"
"8";"Barcelona";"1";"Barcelona";"17";"Garraf";"08270";"Sitges";"2";"7";"U";"690";"237";"434";"528";"162";"0";"2";"526";"528"
"8";"Barcelona";"1";"Barcelona";"17";"Garraf";"08270";"Sitges";"2";"9";"A";"242";"85";"151";"188";"54";"0";"1";"187";"188"
"8";"Barcelona";"1";"Barcelona";"17";"Garraf";"08270";"Sitges";"2";"9";"B";"628";"197";"386";"490";"138";"0";"3";"487";"490"
"8";"Barcelona";"1";"Barcelona";"17";"Garraf";"08270";"Sitges";"2";"9";"C";"642";"200";"404";"490";"152";"0";"5";"485";"490"
"8";"Barcelona";"1";"Barcelona";"3";"Alt Penedès";"08273";"Subirats";"1";"1";"U";"626";"242";"439";"542";"84";"2";"3";"537";"540"
"8";"Barcelona";"1";"Barcelona";"3";"Alt Penedès";"08273";"Subirats";"1";"2";"A";"493";"224";"376";"427";"66";"0";"1";"426";"427"
"8";"Barcelona";"1";"Barcelona";"3";"Alt Penedès";"08273";"Subirats";"1";"2";"B";"204";"65";"122";"158";"46";"1";"0";"157";"157"
"8";"Barcelona";"1";"Barcelona";"3";"Alt Penedès";"08273";"Subirats";"1";"2";"C";"357";"127";"234";"284";"73";"1";"1";"282";"283"
"8";"Barcelona";"1";"Barcelona";"3";"Alt Penedès";"08273";"Subirats";"1";"3";"U";"622";"235";"420";"529";"93";"3";"1";"525";"526"
"8";"Barcelona";"1";"Barcelona";"41";"Vallès Oriental";"08276";"Tagamanent";"1";"1";"U";"237";"104";"163";"194";"43";"0";"1";"193";"194"
"8";"Barcelona";"1";"Barcelona";"21";"Maresme";"08281";"Teià";"1";"1";"A";"580";"244";"402";"487";"93";"1";"4";"482";"486"
"8";"Barcelona";"1";"Barcelona";"21";"Maresme";"08281";"Teià";"1";"1";"B";"516";"210";"363";"425";"91";"0";"1";"424";"425"
"8";"Barcelona";"1";"Barcelona";"21";"Maresme";"08281";"Teià";"1";"1";"C";"557";"244";"411";"478";"79";"0";"1";"477";"478"
"8";"Barcelona";"1";"Barcelona";"21";"Maresme";"08281";"Teià";"1";"2";"A";"572";"233";"413";"480";"92";"1";"3";"476";"479"
"8";"Barcelona";"1";"Barcelona";"21";"Maresme";"08281";"Teià";"1";"2";"B";"612";"233";"401";"475";"137";"1";"3";"471";"474"
"8";"Barcelona";"1";"Barcelona";"21";"Maresme";"08281";"Teià";"1";"2";"C";"593";"212";"385";"471";"122";"0";"0";"471";"471"
"8";"Barcelona";"1";"Barcelona";"21";"Maresme";"08281";"Teià";"1";"3";"A";"674";"270";"502";"589";"85";"0";"3";"586";"589"
"8";"Barcelona";"1";"Barcelona";"21";"Maresme";"08281";"Teià";"1";"3";"B";"750";"271";"520";"651";"99";"2";"2";"647";"649"
"8";"Barcelona";"1";"Barcelona";"40";"Vallès Occidental";"08279";"Terrassa";"1";"1";"A";"467";"225";"351";"408";"59";"0";"0";"408";"408"
"8";"Barcelona";"1";"Barcelona";"40";"Vallès Occidental";"08279";"Terrassa";"1";"1";"B";"575";"267";"412";"494";"81";"1";"3";"490";"493"
"8";"Barcelona";"1";"Barcelona";"40";"Vallès Occidental";"08279";"Terrassa";"1";"10";"U";"951";"357";"651";"820";"131";"0";"6";"814";"820"
"8";"Barcelona";"1";"Barcelona";"40";"Vallès Occidental";"08279";"Terrassa";"1";"11";"U";"916";"298";"592";"739";"177";"2";"8";"729";"737"
"8";"Barcelona";"1";"Barcelona";"40";"Vallès Occidental";"08279";"Terrassa";"1";"12";"A";"490";"171";"314";"401";"89";"0";"2";"399";"401"
"8";"Barcelona";"1";"Barcelona";"40";"Vallès Occidental";"08279";"Terrassa";"1";"12";"B";"622";"196";"382";"486";"136";"0";"4";"482";"486"
"8";"Barcelona";"1";"Barcelona";"40";"Vallès Occidental";"08279";"Terrassa";"1";"13";"U";"625";"222";"385";"491";"134";"1";"7";"483";"490"
"8";"Barcelona";"1";"Barcelona";"40";"Vallès Occidental";"08279";"Terrassa";"1";"14";"A";"428";"177";"262";"322";"106";"0";"2";"320";"322"
"8";"Barcelona";"1";"Barcelona";"40";"Vallès Occidental";"08279";"Terrassa";"1";"14";"B";"667";"235";"398";"503";"164";"6";"1";"496";"497"
"8";"Barcelona";"1";"Barcelona";"40";"Vallès Occidental";"08279";"Terrassa";"1";"14";"C";"486";"172";"287";"363";"123";"0";"0";"363";"363"
"8";"Barcelona";"1";"Barcelona";"40";"Vallès Occidental";"08279";"Terrassa";"1";"15";"U";"888";"292";"576";"706";"182";"2";"2";"702";"704"
"8";"Barcelona";"1";"Barcelona";"40";"Vallès Occidental";"08279";"Terrassa";"1";"16";"A";"579";"211";"300";"481";"98";"3";"7";"471";"478"
"8";"Barcelona";"1";"Barcelona";"40";"Vallès Occidental";"08279";"Terrassa";"1";"16";"B";"661";"227";"476";"525";"136";"1";"0";"524";"524"
"8";"Barcelona";"1";"Barcelona";"40";"Vallès Occidental";"08279";"Terrassa";"1";"16";"C";"612";"225";"436";"523";"89";"0";"4";"519";"523"
"8";"Barcelona";"1";"Barcelona";"40";"Vallès Occidental";"08279";"Terrassa";"1";"17";"A";"760";"301";"530";"628";"132";"0";"3";"625";"628"
"8";"Barcelona";"1";"Barcelona";"40";"Vallès Occidental";"08279";"Terrassa";"1";"17";"B";"902";"302";"635";"762";"140";"1";"3";"758";"761"
"8";"Barcelona";"1";"Barcelona";"40";"Vallès Occidental";"08279";"Terrassa";"1";"18";"U";"430";"215";"314";"375";"55";"1";"4";"370";"374"
"8";"Barcelona";"1";"Barcelona";"40";"Vallès Occidental";"08279";"Terrassa";"1";"19";"A";"517";"183";"326";"419";"98";"3";"1";"415";"416"
"8";"Barcelona";"1";"Barcelona";"40";"Vallès Occidental";"08279";"Terrassa";"1";"19";"B";"600";"206";"387";"487";"113";"1";"0";"486";"486"
"8";"Barcelona";"1";"Barcelona";"40";"Vallès Occidental";"08279";"Terrassa";"1";"2";"A";"495";"226";"339";"404";"91";"0";"2";"402";"404"
"8";"Barcelona";"1";"Barcelona";"40";"Vallès Occidental";"08279";"Terrassa";"1";"2";"B";"600";"228";"434";"486";"114";"1";"2";"483";"485"
"8";"Barcelona";"1";"Barcelona";"40";"Vallès Occidental";"08279";"Terrassa";"1";"20";"A";"491";"192";"339";"419";"72";"1";"0";"418";"418"
"8";"Barcelona";"1";"Barcelona";"40";"Vallès Occidental";"08279";"Terrassa";"1";"20";"B";"523";"179";"364";"454";"69";"1";"4";"449";"453"
"8";"Barcelona";"1";"Barcelona";"40";"Vallès Occidental";"08279";"Terrassa";"1";"21";"A";"471";"185";"309";"373";"98";"1";"8";"364";"372"
"8";"Barcelona";"1";"Barcelona";"40";"Vallès Occidental";"08279";"Terrassa";"1";"21";"B";"609";"272";"415";"496";"113";"1";"1";"494";"495"
"8";"Barcelona";"1";"Barcelona";"40";"Vallès Occidental";"08279";"Terrassa";"1";"22";"A";"690";"230";"463";"575";"115";"6";"2";"567";"569"
"8";"Barcelona";"1";"Barcelona";"40";"Vallès Occidental";"08279";"Terrassa";"1";"22";"B";"708";"260";"493";"612";"96";"2";"3";"607";"610"
"8";"Barcelona";"1";"Barcelona";"40";"Vallès Occidental";"08279";"Terrassa";"1";"23";"A";"437";"169";"308";"386";"51";"2";"1";"383";"384"
"8";"Barcelona";"1";"Barcelona";"40";"Vallès Occidental";"08279";"Terrassa";"1";"23";"B";"516";"189";"400";"466";"50";"3";"1";"462";"463"
"8";"Barcelona";"1";"Barcelona";"40";"Vallès Occidental";"08279";"Terrassa";"1";"24";"U";"634";"250";"469";"564";"70";"0";"1";"563";"564"
"8";"Barcelona";"1";"Barcelona";"40";"Vallès Occidental";"08279";"Terrassa";"1";"4";"A";"728";"254";"491";"613";"115";"0";"0";"613";"613"
"8";"Barcelona";"1";"Barcelona";"40";"Vallès Occidental";"08279";"Terrassa";"1";"4";"B";"802";"269";"549";"686";"116";"1";"3";"682";"685"
"8";"Barcelona";"1";"Barcelona";"40";"Vallès Occidental";"08279";"Terrassa";"1";"5";"U";"995";"388";"702";"848";"147";"2";"2";"844";"846"
"8";"Barcelona";"1";"Barcelona";"40";"Vallès Occidental";"08279";"Terrassa";"1";"6";"A";"574";"211";"400";"492";"82";"4";"4";"484";"488"
"8";"Barcelona";"1";"Barcelona";"40";"Vallès Occidental";"08279";"Terrassa";"1";"6";"B";"606";"247";"434";"522";"84";"0";"0";"522";"522"
"8";"Barcelona";"1";"Barcelona";"40";"Vallès Occidental";"08279";"Terrassa";"1";"7";"A";"614";"215";"419";"507";"107";"2";"2";"503";"505"
"8";"Barcelona";"1";"Barcelona";"40";"Vallès Occidental";"08279";"Terrassa";"1";"7";"B";"723";"263";"474";"604";"119";"1";"2";"601";"603"
"8";"Barcelona";"1";"Barcelona";"40";"Vallès Occidental";"08279";"Terrassa";"1";"8";"A";"623";"262";"441";"535";"88";"3";"0";"532";"532"
"8";"Barcelona";"1";"Barcelona";"40";"Vallès Occidental";"08279";"Terrassa";"1";"8";"B";"575";"224";"389";"472";"103";"1";"3";"468";"471"
"8";"Barcelona";"1";"Barcelona";"40";"Vallès Occidental";"08279";"Terrassa";"1";"8";"C";"638";"262";"446";"548";"90";"1";"2";"545";"547"
"8";"Barcelona";"1";"Barcelona";"40";"Vallès Occidental";"08279";"Terrassa";"1";"9";"A";"471";"173";"325";"392";"79";"2";"3";"387";"390"
"8";"Barcelona";"1";"Barcelona";"40";"Vallès Occidental";"08279";"Terrassa";"1";"9";"B";"560";"187";"361";"456";"104";"0";"0";"456";"456"
"8";"Barcelona";"1";"Barcelona";"40";"Vallès Occidental";"08279";"Terrassa";"2";"1";"A";"498";"163";"267";"339";"159";"1";"3";"335";"338"
"8";"Barcelona";"1";"Barcelona";"40";"Vallès Occidental";"08279";"Terrassa";"2";"1";"B";"569";"212";"370";"429";"140";"2";"2";"425";"427"
"8";"Barcelona";"1";"Barcelona";"40";"Vallès Occidental";"08279";"Terrassa";"2";"11";"U";"802";"257";"452";"565";"237";"2";"2";"561";"563"
"8";"Barcelona";"1";"Barcelona";"40";"Vallès Occidental";"08279";"Terrassa";"2";"12";"U";"678";"172";"338";"428";"250";"3";"1";"424";"425"
"8";"Barcelona";"1";"Barcelona";"40";"Vallès Occidental";"08279";"Terrassa";"2";"14";"A";"601";"179";"354";"469";"132";"2";"2";"465";"467"
"8";"Barcelona";"1";"Barcelona";"40";"Vallès Occidental";"08279";"Terrassa";"2";"14";"B";"805";"216";"440";"602";"203";"4";"3";"595";"598"
"8";"Barcelona";"1";"Barcelona";"40";"Vallès Occidental";"08279";"Terrassa";"2";"15";"U";"588";"120";"253";"348";"240";"0";"1";"347";"348"
"8";"Barcelona";"1";"Barcelona";"40";"Vallès Occidental";"08279";"Terrassa";"2";"16";"A";"549";"171";"328";"432";"117";"0";"2";"430";"432"
"8";"Barcelona";"1";"Barcelona";"40";"Vallès Occidental";"08279";"Terrassa";"2";"16";"B";"743";"234";"441";"574";"169";"1";"7";"566";"573"
"8";"Barcelona";"1";"Barcelona";"40";"Vallès Occidental";"08279";"Terrassa";"2";"17";"U";"1254";"295";"663";"889";"365";"3";"7";"879";"886"
"8";"Barcelona";"1";"Barcelona";"40";"Vallès Occidental";"08279";"Terrassa";"2";"2";"U";"498";"132";"239";"287";"211";"4";"1";"282";"283"
"8";"Barcelona";"1";"Barcelona";"40";"Vallès Occidental";"08279";"Terrassa";"2";"3";"U";"808";"265";"459";"553";"255";"1";"3";"549";"552"
"8";"Barcelona";"1";"Barcelona";"40";"Vallès Occidental";"08279";"Terrassa";"2";"4";"U";"695";"236";"372";"461";"234";"0";"1";"460";"461"
"8";"Barcelona";"1";"Barcelona";"40";"Vallès Occidental";"08279";"Terrassa";"2";"5";"U";"824";"216";"466";"572";"252";"7";"3";"562";"565"
"8";"Barcelona";"1";"Barcelona";"40";"Vallès Occidental";"08279";"Terrassa";"2";"6";"U";"728";"237";"423";"526";"202";"3";"4";"519";"523"
"8";"Barcelona";"1";"Barcelona";"40";"Vallès Occidental";"08279";"Terrassa";"2";"8";"U";"697";"243";"392";"491";"206";"11";"2";"478";"480"
"8";"Barcelona";"1";"Barcelona";"40";"Vallès Occidental";"08279";"Terrassa";"2";"9";"U";"1073";"288";"619";"764";"309";"3";"6";"755";"761"
"8";"Barcelona";"1";"Barcelona";"40";"Vallès Occidental";"08279";"Terrassa";"3";"1";"A";"602";"209";"372";"476";"126";"0";"2";"474";"476"
"8";"Barcelona";"1";"Barcelona";"40";"Vallès Occidental";"08279";"Terrassa";"3";"1";"B";"712";"252";"427";"550";"162";"3";"1";"546";"547"
"8";"Barcelona";"1";"Barcelona";"40";"Vallès Occidental";"08279";"Terrassa";"3";"10";"A";"688";"228";"423";"534";"154";"0";"1";"533";"534"
"8";"Barcelona";"1";"Barcelona";"40";"Vallès Occidental";"08279";"Terrassa";"3";"10";"B";"839";"220";"510";"608";"231";"11";"4";"593";"597"
"8";"Barcelona";"1";"Barcelona";"40";"Vallès Occidental";"08279";"Terrassa";"3";"11";"A";"498";"112";"238";"313";"185";"0";"3";"310";"313"
"8";"Barcelona";"1";"Barcelona";"40";"Vallès Occidental";"08279";"Terrassa";"3";"11";"B";"654";"145";"312";"390";"264";"4";"3";"383";"386"
"8";"Barcelona";"1";"Barcelona";"40";"Vallès Occidental";"08279";"Terrassa";"3";"12";"A";"486";"183";"290";"359";"127";"1";"1";"357";"358"
"8";"Barcelona";"1";"Barcelona";"40";"Vallès Occidental";"08279";"Terrassa";"3";"12";"B";"725";"277";"477";"562";"163";"2";"2";"558";"560"
"8";"Barcelona";"1";"Barcelona";"40";"Vallès Occidental";"08279";"Terrassa";"3";"12";"C";"538";"175";"312";"410";"128";"5";"6";"399";"405"
"8";"Barcelona";"1";"Barcelona";"40";"Vallès Occidental";"08279";"Terrassa";"3";"14";"A";"524";"149";"274";"348";"176";"1";"0";"347";"347"
"8";"Barcelona";"1";"Barcelona";"40";"Vallès Occidental";"08279";"Terrassa";"3";"14";"B";"586";"180";"295";"388";"198";"4";"0";"384";"384"
"8";"Barcelona";"1";"Barcelona";"40";"Vallès Occidental";"08279";"Terrassa";"3";"15";"U";"948";"305";"594";"738";"210";"8";"0";"730";"730"
"8";"Barcelona";"1";"Barcelona";"40";"Vallès Occidental";"08279";"Terrassa";"3";"16";"U";"646";"224";"375";"448";"198";"1";"4";"443";"447"
"8";"Barcelona";"1";"Barcelona";"40";"Vallès Occidental";"08279";"Terrassa";"3";"17";"A";"385";"138";"207";"271";"114";"2";"0";"269";"269"
"8";"Barcelona";"1";"Barcelona";"40";"Vallès Occidental";"08279";"Terrassa";"3";"17";"B";"498";"133";"259";"328";"170";"0";"3";"325";"328"
"8";"Barcelona";"1";"Barcelona";"40";"Vallès Occidental";"08279";"Terrassa";"3";"18";"A";"363";"128";"228";"277";"86";"1";"3";"273";"276"
"8";"Barcelona";"1";"Barcelona";"40";"Vallès Occidental";"08279";"Terrassa";"3";"18";"B";"385";"140";"241";"319";"66";"2";"4";"313";"317"
"8";"Barcelona";"1";"Barcelona";"40";"Vallès Occidental";"08279";"Terrassa";"3";"19";"A";"411";"124";"217";"277";"134";"3";"0";"274";"274"
"8";"Barcelona";"1";"Barcelona";"40";"Vallès Occidental";"08279";"Terrassa";"3";"19";"B";"498";"176";"280";"347";"151";"2";"4";"341";"345"
"8";"Barcelona";"1";"Barcelona";"40";"Vallès Occidental";"08279";"Terrassa";"3";"2";"A";"483";"158";"309";"379";"104";"1";"3";"375";"378"
"8";"Barcelona";"1";"Barcelona";"40";"Vallès Occidental";"08279";"Terrassa";"3";"2";"B";"590";"200";"377";"476";"114";"0";"2";"474";"476"
"8";"Barcelona";"1";"Barcelona";"40";"Vallès Occidental";"08279";"Terrassa";"3";"20";"A";"519";"168";"284";"380";"139";"1";"2";"377";"379"
"8";"Barcelona";"1";"Barcelona";"40";"Vallès Occidental";"08279";"Terrassa";"3";"20";"B";"664";"229";"394";"500";"164";"3";"5";"492";"497"
"8";"Barcelona";"1";"Barcelona";"40";"Vallès Occidental";"08279";"Terrassa";"3";"3";"A";"581";"184";"327";"415";"166";"1";"1";"413";"414"
"8";"Barcelona";"1";"Barcelona";"40";"Vallès Occidental";"08279";"Terrassa";"3";"3";"B";"595";"203";"373";"458";"137";"2";"1";"455";"456"
"8";"Barcelona";"1";"Barcelona";"40";"Vallès Occidental";"08279";"Terrassa";"3";"4";"U";"931";"234";"505";"661";"270";"0";"3";"658";"661"
"8";"Barcelona";"1";"Barcelona";"40";"Vallès Occidental";"08279";"Terrassa";"3";"5";"A";"693";"237";"415";"535";"158";"1";"3";"531";"534"
"8";"Barcelona";"1";"Barcelona";"40";"Vallès Occidental";"08279";"Terrassa";"3";"5";"B";"838";"273";"521";"667";"171";"1";"4";"662";"666"
"8";"Barcelona";"1";"Barcelona";"40";"Vallès Occidental";"08279";"Terrassa";"3";"6";"A";"655";"202";"423";"538";"117";"0";"5";"533";"538"
"8";"Barcelona";"1";"Barcelona";"40";"Vallès Occidental";"08279";"Terrassa";"3";"6";"B";"789";"264";"523";"647";"142";"0";"0";"647";"647"
"8";"Barcelona";"1";"Barcelona";"40";"Vallès Occidental";"08279";"Terrassa";"3";"7";"A";"767";"242";"493";"628";"139";"0";"5";"623";"628"
"8";"Barcelona";"1";"Barcelona";"40";"Vallès Occidental";"08279";"Terrassa";"3";"7";"B";"873";"284";"561";"702";"171";"0";"11";"691";"702"
"8";"Barcelona";"1";"Barcelona";"40";"Vallès Occidental";"08279";"Terrassa";"3";"8";"A";"674";"238";"394";"484";"190";"1";"2";"481";"483"
"8";"Barcelona";"1";"Barcelona";"40";"Vallès Occidental";"08279";"Terrassa";"3";"8";"B";"891";"322";"526";"636";"255";"6";"3";"627";"630"
"8";"Barcelona";"1";"Barcelona";"40";"Vallès Occidental";"08279";"Terrassa";"3";"9";"A";"575";"182";"348";"460";"115";"1";"3";"456";"459"
"8";"Barcelona";"1";"Barcelona";"40";"Vallès Occidental";"08279";"Terrassa";"3";"9";"B";"725";"225";"436";"569";"156";"3";"6";"560";"566"
"8";"Barcelona";"1";"Barcelona";"40";"Vallès Occidental";"08279";"Terrassa";"3";"9";"C";"639";"188";"395";"510";"129";"1";"1";"508";"509"
"8";"Barcelona";"1";"Barcelona";"40";"Vallès Occidental";"08279";"Terrassa";"4";"1";"A";"523";"198";"350";"445";"78";"2";"1";"442";"443"
"8";"Barcelona";"1";"Barcelona";"40";"Vallès Occidental";"08279";"Terrassa";"4";"1";"B";"600";"256";"402";"496";"104";"1";"4";"491";"495"
"8";"Barcelona";"1";"Barcelona";"40";"Vallès Occidental";"08279";"Terrassa";"4";"10";"U";"734";"241";"409";"483";"251";"1";"2";"480";"482"
"8";"Barcelona";"1";"Barcelona";"40";"Vallès Occidental";"08279";"Terrassa";"4";"12";"A";"473";"211";"304";"368";"105";"0";"2";"366";"368"
"8";"Barcelona";"1";"Barcelona";"40";"Vallès Occidental";"08279";"Terrassa";"4";"12";"B";"517";"190";"334";"414";"103";"2";"0";"412";"412"
"8";"Barcelona";"1";"Barcelona";"40";"Vallès Occidental";"08279";"Terrassa";"4";"13";"A";"584";"174";"405";"491";"93";"1";"1";"489";"490"
"8";"Barcelona";"1";"Barcelona";"40";"Vallès Occidental";"08279";"Terrassa";"4";"13";"B";"601";"222";"397";"479";"122";"2";"0";"477";"477"
"8";"Barcelona";"1";"Barcelona";"40";"Vallès Occidental";"08279";"Terrassa";"4";"14";"A";"461";"194";"348";"409";"52";"1";"3";"405";"408"
"8";"Barcelona";"1";"Barcelona";"40";"Vallès Occidental";"08279";"Terrassa";"4";"14";"B";"498";"188";"365";"430";"68";"0";"1";"429";"430"
"8";"Barcelona";"1";"Barcelona";"40";"Vallès Occidental";"08279";"Terrassa";"4";"15";"U";"846";"253";"591";"703";"143";"1";"4";"698";"702"
"8";"Barcelona";"1";"Barcelona";"40";"Vallès Occidental";"08279";"Terrassa";"4";"16";"A";"432";"158";"297";"362";"70";"1";"1";"360";"361"
"8";"Barcelona";"1";"Barcelona";"40";"Vallès Occidental";"08279";"Terrassa";"4";"16";"B";"514";"206";"370";"429";"85";"1";"3";"425";"428"
"8";"Barcelona";"1";"Barcelona";"40";"Vallès Occidental";"08279";"Terrassa";"4";"17";"A";"532";"193";"378";"407";"125";"0";"2";"405";"407"
"8";"Barcelona";"1";"Barcelona";"40";"Vallès Occidental";"08279";"Terrassa";"4";"17";"B";"588";"249";"428";"503";"85";"0";"1";"502";"503"
"8";"Barcelona";"1";"Barcelona";"40";"Vallès Occidental";"08279";"Terrassa";"4";"18";"A";"854";"274";"561";"684";"170";"1";"2";"681";"683"
"8";"Barcelona";"1";"Barcelona";"40";"Vallès Occidental";"08279";"Terrassa";"4";"18";"B";"999";"325";"658";"814";"185";"4";"3";"807";"810"
"8";"Barcelona";"1";"Barcelona";"40";"Vallès Occidental";"08279";"Terrassa";"4";"19";"A";"426";"145";"262";"319";"107";"1";"1";"317";"318"
"8";"Barcelona";"1";"Barcelona";"40";"Vallès Occidental";"08279";"Terrassa";"4";"19";"B";"465";"152";"269";"345";"120";"1";"2";"342";"344"
"8";"Barcelona";"1";"Barcelona";"40";"Vallès Occidental";"08279";"Terrassa";"4";"2";"A";"524";"229";"359";"425";"99";"3";"1";"421";"422"
"8";"Barcelona";"1";"Barcelona";"40";"Vallès Occidental";"08279";"Terrassa";"4";"2";"B";"582";"265";"419";"487";"95";"1";"2";"484";"486"
"8";"Barcelona";"1";"Barcelona";"40";"Vallès Occidental";"08279";"Terrassa";"4";"20";"U";"548";"178";"291";"342";"206";"1";"4";"337";"341"
"8";"Barcelona";"1";"Barcelona";"40";"Vallès Occidental";"08279";"Terrassa";"4";"21";"U";"768";"260";"445";"546";"222";"0";"3";"543";"546"
"8";"Barcelona";"1";"Barcelona";"40";"Vallès Occidental";"08279";"Terrassa";"4";"22";"A";"724";"202";"421";"563";"161";"3";"1";"559";"560"
"8";"Barcelona";"1";"Barcelona";"40";"Vallès Occidental";"08279";"Terrassa";"4";"22";"B";"847";"202";"518";"670";"177";"1";"5";"664";"669"
"8";"Barcelona";"1";"Barcelona";"40";"Vallès Occidental";"08279";"Terrassa";"4";"23";"A";"666";"244";"424";"545";"121";"4";"4";"537";"541"
"8";"Barcelona";"1";"Barcelona";"40";"Vallès Occidental";"08279";"Terrassa";"4";"23";"B";"852";"265";"518";"666";"186";"3";"9";"654";"663"
"8";"Barcelona";"1";"Barcelona";"40";"Vallès Occidental";"08279";"Terrassa";"4";"24";"A";"693";"191";"418";"518";"175";"2";"0";"516";"516"
"8";"Barcelona";"1";"Barcelona";"40";"Vallès Occidental";"08279";"Terrassa";"4";"24";"B";"822";"277";"510";"624";"198";"1";"6";"617";"623"
"8";"Barcelona";"1";"Barcelona";"40";"Vallès Occidental";"08279";"Terrassa";"4";"25";"A";"404";"153";"252";"306";"98";"0";"0";"306";"306"
"8";"Barcelona";"1";"Barcelona";"40";"Vallès Occidental";"08279";"Terrassa";"4";"25";"B";"484";"175";"295";"356";"128";"0";"2";"354";"356"
"8";"Barcelona";"1";"Barcelona";"40";"Vallès Occidental";"08279";"Terrassa";"4";"26";"A";"515";"200";"344";"403";"112";"2";"3";"398";"401"
"8";"Barcelona";"1";"Barcelona";"40";"Vallès Occidental";"08279";"Terrassa";"4";"26";"B";"528";"190";"369";"440";"88";"0";"2";"438";"440"
"8";"Barcelona";"1";"Barcelona";"40";"Vallès Occidental";"08279";"Terrassa";"4";"3";"A";"544";"208";"360";"431";"113";"2";"3";"426";"429"
"8";"Barcelona";"1";"Barcelona";"40";"Vallès Occidental";"08279";"Terrassa";"4";"3";"B";"691";"255";"457";"546";"145";"2";"4";"540";"544"
"8";"Barcelona";"1";"Barcelona";"40";"Vallès Occidental";"08279";"Terrassa";"4";"4";"A";"549";"223";"369";"447";"102";"2";"2";"443";"445"
"8";"Barcelona";"1";"Barcelona";"40";"Vallès Occidental";"08279";"Terrassa";"4";"4";"B";"567";"221";"367";"460";"107";"1";"1";"458";"459"
"8";"Barcelona";"1";"Barcelona";"40";"Vallès Occidental";"08279";"Terrassa";"4";"5";"A";"589";"225";"419";"453";"136";"0";"4";"449";"453"
"8";"Barcelona";"1";"Barcelona";"40";"Vallès Occidental";"08279";"Terrassa";"4";"5";"B";"678";"252";"414";"496";"182";"1";"5";"490";"495"
"8";"Barcelona";"1";"Barcelona";"40";"Vallès Occidental";"08279";"Terrassa";"4";"6";"A";"580";"222";"371";"448";"132";"3";"3";"442";"445"
"8";"Barcelona";"1";"Barcelona";"40";"Vallès Occidental";"08279";"Terrassa";"4";"6";"B";"824";"329";"540";"639";"185";"1";"3";"635";"638"
"8";"Barcelona";"1";"Barcelona";"40";"Vallès Occidental";"08279";"Terrassa";"4";"7";"A";"862";"298";"515";"632";"230";"3";"2";"627";"629"
"8";"Barcelona";"1";"Barcelona";"40";"Vallès Occidental";"08279";"Terrassa";"4";"7";"B";"1020";"348";"600";"727";"293";"1";"2";"724";"726"
"8";"Barcelona";"1";"Barcelona";"40";"Vallès Occidental";"08279";"Terrassa";"4";"8";"U";"947";"297";"564";"718";"229";"3";"6";"709";"715"
"8";"Barcelona";"1";"Barcelona";"40";"Vallès Occidental";"08279";"Terrassa";"4";"9";"U";"744";"268";"438";"545";"199";"3";"3";"539";"542"
"8";"Barcelona";"1";"Barcelona";"40";"Vallès Occidental";"08279";"Terrassa";"5";"1";"A";"677";"238";"455";"553";"124";"1";"1";"551";"552"
"8";"Barcelona";"1";"Barcelona";"40";"Vallès Occidental";"08279";"Terrassa";"5";"1";"B";"845";"257";"560";"681";"164";"0";"2";"679";"681"
"8";"Barcelona";"1";"Barcelona";"40";"Vallès Occidental";"08279";"Terrassa";"5";"10";"A";"640";"258";"396";"481";"159";"0";"0";"481";"481"
"8";"Barcelona";"1";"Barcelona";"40";"Vallès Occidental";"08279";"Terrassa";"5";"10";"B";"798";"253";"486";"585";"213";"2";"3";"580";"583"
"8";"Barcelona";"1";"Barcelona";"40";"Vallès Occidental";"08279";"Terrassa";"5";"11";"A";"658";"220";"431";"525";"133";"1";"2";"522";"524"
"8";"Barcelona";"1";"Barcelona";"40";"Vallès Occidental";"08279";"Terrassa";"5";"11";"B";"808";"282";"538";"662";"146";"4";"1";"657";"658"
"8";"Barcelona";"1";"Barcelona";"40";"Vallès Occidental";"08279";"Terrassa";"5";"12";"U";"585";"236";"379";"454";"131";"2";"2";"450";"452"
"8";"Barcelona";"1";"Barcelona";"40";"Vallès Occidental";"08279";"Terrassa";"5";"13";"A";"531";"160";"290";"370";"161";"0";"0";"370";"370"
"8";"Barcelona";"1";"Barcelona";"40";"Vallès Occidental";"08279";"Terrassa";"5";"13";"B";"636";"217";"370";"469";"167";"1";"2";"466";"468"
"8";"Barcelona";"1";"Barcelona";"40";"Vallès Occidental";"08279";"Terrassa";"5";"14";"A";"477";"144";"270";"348";"129";"1";"1";"346";"347"
"8";"Barcelona";"1";"Barcelona";"40";"Vallès Occidental";"08279";"Terrassa";"5";"14";"B";"625";"216";"392";"494";"131";"2";"1";"491";"492"
"8";"Barcelona";"1";"Barcelona";"40";"Vallès Occidental";"08279";"Terrassa";"5";"14";"C";"478";"161";"309";"379";"99";"1";"1";"377";"378"
"8";"Barcelona";"1";"Barcelona";"40";"Vallès Occidental";"08279";"Terrassa";"5";"15";"A";"685";"200";"372";"481";"204";"5";"1";"475";"476"
"8";"Barcelona";"1";"Barcelona";"40";"Vallès Occidental";"08279";"Terrassa";"5";"15";"B";"790";"271";"470";"563";"227";"3";"4";"556";"560"
"8";"Barcelona";"1";"Barcelona";"40";"Vallès Occidental";"08279";"Terrassa";"5";"16";"A";"578";"210";"357";"448";"130";"2";"4";"442";"446"
"8";"Barcelona";"1";"Barcelona";"40";"Vallès Occidental";"08279";"Terrassa";"5";"16";"B";"731";"259";"431";"548";"183";"2";"2";"544";"546"
"8";"Barcelona";"1";"Barcelona";"40";"Vallès Occidental";"08279";"Terrassa";"5";"16";"C";"601";"192";"329";"433";"168";"3";"0";"430";"430"
"8";"Barcelona";"1";"Barcelona";"40";"Vallès Occidental";"08279";"Terrassa";"5";"17";"A";"548";"173";"343";"445";"103";"0";"1";"444";"445"
"8";"Barcelona";"1";"Barcelona";"40";"Vallès Occidental";"08279";"Terrassa";"5";"17";"B";"725";"249";"476";"599";"126";"1";"7";"591";"598"
"8";"Barcelona";"1";"Barcelona";"40";"Vallès Occidental";"08279";"Terrassa";"5";"18";"A";"436";"154";"271";"338";"98";"1";"0";"337";"337"
"8";"Barcelona";"1";"Barcelona";"40";"Vallès Occidental";"08279";"Terrassa";"5";"18";"B";"543";"188";"333";"422";"121";"2";"7";"413";"420"
"8";"Barcelona";"1";"Barcelona";"40";"Vallès Occidental";"08279";"Terrassa";"5";"19";"U";"837";"203";"501";"672";"165";"1";"4";"667";"671"
"8";"Barcelona";"1";"Barcelona";"40";"Vallès Occidental";"08279";"Terrassa";"5";"2";"A";"474";"180";"298";"363";"111";"2";"0";"361";"361"
"8";"Barcelona";"1";"Barcelona";"40";"Vallès Occidental";"08279";"Terrassa";"5";"2";"B";"644";"197";"355";"468";"176";"6";"0";"462";"462"
"8";"Barcelona";"1";"Barcelona";"40";"Vallès Occidental";"08279";"Terrassa";"5";"20";"A";"529";"208";"354";"434";"95";"0";"2";"432";"434"
"8";"Barcelona";"1";"Barcelona";"40";"Vallès Occidental";"08279";"Terrassa";"5";"20";"B";"657";"212";"411";"532";"125";"3";"4";"525";"529"
"8";"Barcelona";"1";"Barcelona";"40";"Vallès Occidental";"08279";"Terrassa";"5";"21";"A";"637";"235";"421";"520";"117";"0";"2";"518";"520"
"8";"Barcelona";"1";"Barcelona";"40";"Vallès Occidental";"08279";"Terrassa";"5";"21";"B";"774";"259";"501";"617";"157";"1";"7";"609";"616"
"8";"Barcelona";"1";"Barcelona";"40";"Vallès Occidental";"08279";"Terrassa";"5";"22";"U";"549";"177";"344";"388";"161";"0";"0";"388";"388"
"8";"Barcelona";"1";"Barcelona";"40";"Vallès Occidental";"08279";"Terrassa";"5";"23";"A";"623";"206";"419";"520";"103";"0";"5";"515";"520"
"8";"Barcelona";"1";"Barcelona";"40";"Vallès Occidental";"08279";"Terrassa";"5";"23";"B";"656";"212";"411";"528";"128";"3";"6";"519";"525"
"8";"Barcelona";"1";"Barcelona";"40";"Vallès Occidental";"08279";"Terrassa";"5";"24";"A";"540";"181";"351";"421";"119";"1";"1";"419";"420"
"8";"Barcelona";"1";"Barcelona";"40";"Vallès Occidental";"08279";"Terrassa";"5";"24";"B";"617";"196";"415";"482";"135";"2";"1";"479";"480"
"8";"Barcelona";"1";"Barcelona";"40";"Vallès Occidental";"08279";"Terrassa";"5";"25";"U";"867";"273";"547";"703";"164";"3";"6";"694";"700"
"8";"Barcelona";"1";"Barcelona";"40";"Vallès Occidental";"08279";"Terrassa";"5";"26";"A";"475";"176";"334";"395";"80";"3";"1";"391";"392"
"8";"Barcelona";"1";"Barcelona";"40";"Vallès Occidental";"08279";"Terrassa";"5";"26";"B";"523";"202";"376";"452";"71";"1";"0";"451";"451"
"8";"Barcelona";"1";"Barcelona";"40";"Vallès Occidental";"08279";"Terrassa";"5";"27";"U";"953";"330";"616";"782";"171";"1";"8";"773";"781"
"8";"Barcelona";"1";"Barcelona";"40";"Vallès Occidental";"08279";"Terrassa";"5";"28";"U";"883";"261";"561";"711";"172";"1";"7";"703";"710"
"8";"Barcelona";"1";"Barcelona";"40";"Vallès Occidental";"08279";"Terrassa";"5";"29";"U";"858";"264";"534";"698";"160";"1";"3";"694";"697"
"8";"Barcelona";"1";"Barcelona";"40";"Vallès Occidental";"08279";"Terrassa";"5";"3";"A";"652";"250";"421";"504";"148";"0";"0";"504";"504"
"8";"Barcelona";"1";"Barcelona";"40";"Vallès Occidental";"08279";"Terrassa";"5";"3";"B";"833";"291";"531";"656";"177";"4";"4";"648";"652"
"8";"Barcelona";"1";"Barcelona";"40";"Vallès Occidental";"08279";"Terrassa";"5";"4";"A";"526";"176";"332";"414";"112";"2";"0";"412";"412"
"8";"Barcelona";"1";"Barcelona";"40";"Vallès Occidental";"08279";"Terrassa";"5";"4";"B";"648";"257";"435";"540";"108";"3";"3";"534";"537"
"8";"Barcelona";"1";"Barcelona";"40";"Vallès Occidental";"08279";"Terrassa";"5";"5";"U";"777";"279";"490";"604";"173";"0";"2";"602";"604"
"8";"Barcelona";"1";"Barcelona";"40";"Vallès Occidental";"08279";"Terrassa";"5";"6";"A";"749";"268";"496";"604";"145";"1";"2";"601";"603"
"8";"Barcelona";"1";"Barcelona";"40";"Vallès Occidental";"08279";"Terrassa";"5";"6";"B";"804";"271";"538";"664";"140";"2";"3";"659";"662"
"8";"Barcelona";"1";"Barcelona";"40";"Vallès Occidental";"08279";"Terrassa";"5";"7";"U";"883";"256";"685";"744";"139";"2";"4";"738";"742"
"8";"Barcelona";"1";"Barcelona";"40";"Vallès Occidental";"08279";"Terrassa";"5";"8";"A";"674";"230";"438";"549";"125";"1";"5";"543";"548"
"8";"Barcelona";"1";"Barcelona";"40";"Vallès Occidental";"08279";"Terrassa";"5";"8";"B";"756";"250";"479";"595";"161";"3";"3";"589";"592"
"8";"Barcelona";"1";"Barcelona";"40";"Vallès Occidental";"08279";"Terrassa";"5";"9";"A";"649";"249";"440";"544";"105";"1";"1";"542";"543"
"8";"Barcelona";"1";"Barcelona";"40";"Vallès Occidental";"08279";"Terrassa";"5";"9";"B";"705";"292";"484";"587";"118";"1";"3";"583";"586"
"8";"Barcelona";"1";"Barcelona";"40";"Vallès Occidental";"08279";"Terrassa";"6";"1";"U";"876";"270";"549";"680";"196";"5";"3";"672";"675"
"8";"Barcelona";"1";"Barcelona";"40";"Vallès Occidental";"08279";"Terrassa";"6";"10";"A";"669";"200";"399";"500";"169";"2";"1";"497";"498"
"8";"Barcelona";"1";"Barcelona";"40";"Vallès Occidental";"08279";"Terrassa";"6";"10";"B";"901";"370";"608";"736";"165";"8";"0";"728";"728"
"8";"Barcelona";"1";"Barcelona";"40";"Vallès Occidental";"08279";"Terrassa";"6";"11";"A";"550";"176";"292";"368";"182";"2";"1";"365";"366"
"8";"Barcelona";"1";"Barcelona";"40";"Vallès Occidental";"08279";"Terrassa";"6";"11";"B";"723";"236";"377";"477";"246";"3";"5";"469";"474"
"8";"Barcelona";"1";"Barcelona";"40";"Vallès Occidental";"08279";"Terrassa";"6";"12";"A";"389";"130";"227";"284";"105";"5";"1";"278";"279"
"8";"Barcelona";"1";"Barcelona";"40";"Vallès Occidental";"08279";"Terrassa";"6";"12";"B";"534";"173";"318";"387";"147";"1";"5";"381";"386"
"8";"Barcelona";"1";"Barcelona";"40";"Vallès Occidental";"08279";"Terrassa";"6";"13";"U";"712";"239";"445";"529";"183";"1";"1";"527";"528"
"8";"Barcelona";"1";"Barcelona";"40";"Vallès Occidental";"08279";"Terrassa";"6";"14";"U";"717";"200";"361";"478";"239";"0";"5";"473";"478"
"8";"Barcelona";"1";"Barcelona";"40";"Vallès Occidental";"08279";"Terrassa";"6";"16";"A";"517";"167";"279";"351";"166";"2";"1";"348";"349"
"8";"Barcelona";"1";"Barcelona";"40";"Vallès Occidental";"08279";"Terrassa";"6";"16";"B";"619";"196";"327";"405";"214";"1";"3";"401";"404"
"8";"Barcelona";"1";"Barcelona";"40";"Vallès Occidental";"08279";"Terrassa";"6";"18";"U";"923";"344";"516";"627";"296";"3";"3";"621";"624"
"8";"Barcelona";"1";"Barcelona";"40";"Vallès Occidental";"08279";"Terrassa";"6";"2";"A";"499";"155";"274";"366";"133";"2";"2";"362";"364"
"8";"Barcelona";"1";"Barcelona";"40";"Vallès Occidental";"08279";"Terrassa";"6";"2";"B";"670";"198";"367";"472";"198";"1";"1";"470";"471"
"8";"Barcelona";"1";"Barcelona";"40";"Vallès Occidental";"08279";"Terrassa";"6";"20";"U";"1165";"287";"588";"752";"413";"1";"10";"741";"751"
"8";"Barcelona";"1";"Barcelona";"40";"Vallès Occidental";"08279";"Terrassa";"6";"23";"A";"427";"130";"237";"316";"111";"1";"2";"313";"315"
"8";"Barcelona";"1";"Barcelona";"40";"Vallès Occidental";"08279";"Terrassa";"6";"23";"B";"578";"178";"329";"404";"174";"1";"2";"401";"403"
"8";"Barcelona";"1";"Barcelona";"40";"Vallès Occidental";"08279";"Terrassa";"6";"24";"A";"521";"160";"325";"397";"124";"2";"5";"390";"395"
"8";"Barcelona";"1";"Barcelona";"40";"Vallès Occidental";"08279";"Terrassa";"6";"24";"B";"748";"238";"466";"573";"175";"0";"7";"566";"573"
"8";"Barcelona";"1";"Barcelona";"40";"Vallès Occidental";"08279";"Terrassa";"6";"24";"C";"535";"181";"323";"401";"134";"2";"4";"395";"399"
"8";"Barcelona";"1";"Barcelona";"40";"Vallès Occidental";"08279";"Terrassa";"6";"25";"A";"593";"194";"349";"429";"164";"1";"5";"423";"428"
"8";"Barcelona";"1";"Barcelona";"40";"Vallès Occidental";"08279";"Terrassa";"6";"25";"B";"790";"234";"474";"596";"194";"1";"4";"591";"595"
"8";"Barcelona";"1";"Barcelona";"40";"Vallès Occidental";"08279";"Terrassa";"6";"26";"A";"524";"147";"304";"382";"142";"1";"2";"379";"381"
"8";"Barcelona";"1";"Barcelona";"40";"Vallès Occidental";"08279";"Terrassa";"6";"26";"B";"681";"188";"419";"526";"155";"2";"0";"524";"524"
"8";"Barcelona";"1";"Barcelona";"40";"Vallès Occidental";"08279";"Terrassa";"6";"27";"A";"413";"136";"241";"309";"104";"1";"2";"306";"308"
"8";"Barcelona";"1";"Barcelona";"40";"Vallès Occidental";"08279";"Terrassa";"6";"27";"B";"553";"169";"310";"386";"167";"2";"4";"380";"384"
"8";"Barcelona";"1";"Barcelona";"40";"Vallès Occidental";"08279";"Terrassa";"6";"28";"A";"524";"167";"332";"418";"106";"2";"0";"416";"416"
"8";"Barcelona";"1";"Barcelona";"40";"Vallès Occidental";"08279";"Terrassa";"6";"28";"B";"666";"213";"422";"532";"134";"0";"4";"528";"532"
"8";"Barcelona";"1";"Barcelona";"40";"Vallès Occidental";"08279";"Terrassa";"6";"29";"U";"774";"233";"486";"597";"177";"0";"1";"596";"597"
"8";"Barcelona";"1";"Barcelona";"40";"Vallès Occidental";"08279";"Terrassa";"6";"3";"A";"623";"206";"375";"467";"156";"0";"2";"465";"467"
"8";"Barcelona";"1";"Barcelona";"40";"Vallès Occidental";"08279";"Terrassa";"6";"3";"B";"841";"267";"478";"606";"235";"3";"4";"599";"603"
"8";"Barcelona";"1";"Barcelona";"40";"Vallès Occidental";"08279";"Terrassa";"6";"30";"U";"545";"134";"321";"418";"127";"1";"3";"414";"417"
"8";"Barcelona";"1";"Barcelona";"40";"Vallès Occidental";"08279";"Terrassa";"6";"31";"U";"742";"221";"400";"522";"220";"3";"1";"518";"519"
"8";"Barcelona";"1";"Barcelona";"40";"Vallès Occidental";"08279";"Terrassa";"6";"32";"U";"541";"159";"344";"426";"115";"1";"6";"419";"425"
"8";"Barcelona";"1";"Barcelona";"40";"Vallès Occidental";"08279";"Terrassa";"6";"33";"A";"434";"143";"273";"343";"91";"0";"4";"339";"343"
"8";"Barcelona";"1";"Barcelona";"40";"Vallès Occidental";"08279";"Terrassa";"6";"33";"B";"576";"174";"357";"470";"106";"2";"2";"466";"468"
"8";"Barcelona";"1";"Barcelona";"40";"Vallès Occidental";"08279";"Terrassa";"6";"4";"A";"403";"131";"223";"277";"126";"1";"2";"274";"276"
"8";"Barcelona";"1";"Barcelona";"40";"Vallès Occidental";"08279";"Terrassa";"6";"4";"B";"457";"141";"252";"314";"143";"2";"1";"311";"312"
"8";"Barcelona";"1";"Barcelona";"40";"Vallès Occidental";"08279";"Terrassa";"6";"5";"A";"467";"131";"251";"328";"139";"1";"1";"326";"327"
"8";"Barcelona";"1";"Barcelona";"40";"Vallès Occidental";"08279";"Terrassa";"6";"5";"B";"627";"184";"355";"456";"171";"1";"1";"454";"455"
"8";"Barcelona";"1";"Barcelona";"40";"Vallès Occidental";"08279";"Terrassa";"6";"6";"A";"453";"156";"272";"338";"115";"1";"2";"335";"337"
"8";"Barcelona";"1";"Barcelona";"40";"Vallès Occidental";"08279";"Terrassa";"6";"6";"B";"654";"165";"415";"491";"163";"1";"3";"487";"490"
"8";"Barcelona";"1";"Barcelona";"40";"Vallès Occidental";"08279";"Terrassa";"6";"8";"A";"450";"155";"263";"354";"96";"3";"3";"348";"351"
"8";"Barcelona";"1";"Barcelona";"40";"Vallès Occidental";"08279";"Terrassa";"6";"8";"B";"627";"236";"387";"490";"137";"0";"6";"484";"490"
"8";"Barcelona";"1";"Barcelona";"40";"Vallès Occidental";"08279";"Terrassa";"6";"8";"C";"550";"225";"383";"436";"114";"0";"3";"433";"436"
"8";"Barcelona";"1";"Barcelona";"40";"Vallès Occidental";"08279";"Terrassa";"6";"9";"A";"384";"107";"230";"292";"92";"0";"3";"289";"292"
"8";"Barcelona";"1";"Barcelona";"40";"Vallès Occidental";"08279";"Terrassa";"6";"9";"B";"478";"150";"295";"373";"105";"0";"3";"370";"373"
"8";"Barcelona";"1";"Barcelona";"21";"Maresme";"08282";"Tiana";"1";"1";"A";"575";"199";"395";"496";"79";"0";"1";"495";"496"
"8";"Barcelona";"1";"Barcelona";"21";"Maresme";"08282";"Tiana";"1";"1";"B";"606";"232";"430";"513";"93";"2";"1";"510";"511"
"8";"Barcelona";"1";"Barcelona";"21";"Maresme";"08282";"Tiana";"1";"1";"C";"587";"200";"392";"488";"99";"1";"1";"486";"487"
"8";"Barcelona";"1";"Barcelona";"21";"Maresme";"08282";"Tiana";"1";"2";"A";"405";"145";"270";"335";"70";"0";"1";"334";"335"
"8";"Barcelona";"1";"Barcelona";"21";"Maresme";"08282";"Tiana";"1";"2";"B";"313";"120";"213";"256";"57";"0";"1";"255";"256"
"8";"Barcelona";"1";"Barcelona";"21";"Maresme";"08282";"Tiana";"1";"2";"C";"498";"169";"327";"399";"99";"0";"0";"399";"399"
"8";"Barcelona";"1";"Barcelona";"21";"Maresme";"08282";"Tiana";"1";"2";"D";"418";"167";"293";"366";"52";"1";"5";"360";"365"
"8";"Barcelona";"1";"Barcelona";"21";"Maresme";"08282";"Tiana";"1";"3";"A";"436";"168";"300";"367";"69";"2";"3";"362";"365"
"8";"Barcelona";"1";"Barcelona";"21";"Maresme";"08282";"Tiana";"1";"3";"B";"512";"212";"379";"450";"62";"1";"3";"446";"449"
"8";"Barcelona";"1";"Barcelona";"21";"Maresme";"08282";"Tiana";"1";"4";"A";"645";"260";"449";"563";"82";"0";"2";"561";"563"
"8";"Barcelona";"1";"Barcelona";"21";"Maresme";"08282";"Tiana";"1";"4";"B";"675";"294";"500";"617";"58";"0";"4";"613";"617"
"8";"Barcelona";"1";"Barcelona";"21";"Maresme";"08282";"Tiana";"1";"5";"U";"817";"310";"570";"703";"114";"0";"5";"698";"703"
"8";"Barcelona";"1";"Barcelona";"21";"Maresme";"08284";"Tordera";"1";"1";"A";"458";"156";"255";"337";"121";"2";"2";"333";"335"
"8";"Barcelona";"1";"Barcelona";"21";"Maresme";"08284";"Tordera";"1";"1";"B";"536";"177";"299";"391";"145";"2";"3";"386";"389"
"8";"Barcelona";"1";"Barcelona";"21";"Maresme";"08284";"Tordera";"1";"1";"C";"566";"189";"334";"435";"131";"2";"4";"429";"433"
"8";"Barcelona";"1";"Barcelona";"21";"Maresme";"08284";"Tordera";"1";"2";"A";"574";"174";"300";"387";"187";"2";"3";"382";"385"
"8";"Barcelona";"1";"Barcelona";"21";"Maresme";"08284";"Tordera";"1";"2";"B";"677";"190";"351";"458";"219";"1";"3";"454";"457"
"8";"Barcelona";"1";"Barcelona";"21";"Maresme";"08284";"Tordera";"1";"3";"A";"686";"189";"352";"508";"178";"2";"5";"501";"506"
"8";"Barcelona";"1";"Barcelona";"21";"Maresme";"08284";"Tordera";"1";"3";"B";"839";"246";"455";"626";"213";"3";"1";"622";"623"
"8";"Barcelona";"1";"Barcelona";"21";"Maresme";"08284";"Tordera";"1";"4";"A";"510";"173";"319";"372";"138";"2";"0";"370";"370"
"8";"Barcelona";"1";"Barcelona";"21";"Maresme";"08284";"Tordera";"1";"4";"B";"621";"204";"358";"435";"186";"4";"2";"429";"431"
"8";"Barcelona";"1";"Barcelona";"21";"Maresme";"08284";"Tordera";"1";"4";"C";"605";"215";"383";"460";"145";"1";"1";"458";"459"
"8";"Barcelona";"1";"Barcelona";"21";"Maresme";"08284";"Tordera";"2";"1";"A";"611";"208";"370";"446";"165";"2";"1";"443";"444"
"8";"Barcelona";"1";"Barcelona";"21";"Maresme";"08284";"Tordera";"2";"1";"B";"727";"321";"424";"518";"209";"4";"4";"510";"514"
"8";"Barcelona";"1";"Barcelona";"21";"Maresme";"08284";"Tordera";"2";"1";"C";"600";"236";"378";"452";"148";"6";"0";"446";"446"
"8";"Barcelona";"1";"Barcelona";"21";"Maresme";"08284";"Tordera";"2";"2";"A";"517";"175";"300";"368";"149";"0";"2";"366";"368"
"8";"Barcelona";"1";"Barcelona";"21";"Maresme";"08284";"Tordera";"2";"2";"B";"456";"158";"259";"320";"136";"5";"3";"312";"315"
"8";"Barcelona";"1";"Barcelona";"21";"Maresme";"08284";"Tordera";"2";"2";"C";"624";"208";"331";"421";"203";"3";"1";"417";"418"
"8";"Barcelona";"1";"Barcelona";"21";"Maresme";"08284";"Tordera";"2";"2";"D";"568";"203";"323";"407";"161";"3";"3";"401";"404"
"8";"Barcelona";"1";"Barcelona";"21";"Maresme";"08284";"Tordera";"2";"3";"A";"589";"216";"368";"417";"172";"1";"5";"411";"416"
"8";"Barcelona";"1";"Barcelona";"21";"Maresme";"08284";"Tordera";"2";"3";"B";"684";"268";"417";"505";"179";"1";"5";"499";"504"
"8";"Barcelona";"1";"Barcelona";"21";"Maresme";"08284";"Tordera";"2";"3";"C";"638";"245";"349";"456";"182";"6";"3";"447";"450"
"8";"Barcelona";"1";"Barcelona";"3";"Alt Penedès";"08287";"Torrelavit";"1";"1";"A";"515";"299";"398";"436";"79";"1";"3";"432";"435"
"8";"Barcelona";"1";"Barcelona";"3";"Alt Penedès";"08287";"Torrelavit";"1";"1";"B";"534";"226";"382";"468";"66";"1";"5";"462";"467"
"8";"Barcelona";"1";"Barcelona";"3";"Alt Penedès";"08288";"Torrelles de Foix";"1";"1";"A";"738";"289";"453";"535";"203";"1";"2";"532";"534"
"8";"Barcelona";"1";"Barcelona";"3";"Alt Penedès";"08288";"Torrelles de Foix";"1";"1";"B";"888";"348";"520";"626";"262";"4";"3";"619";"622"
"8";"Barcelona";"1";"Barcelona";"11";"Baix Llobregat";"08289";"Torrelles de Llobregat";"1";"1";"A";"419";"144";"268";"342";"77";"0";"2";"340";"342"
"8";"Barcelona";"1";"Barcelona";"11";"Baix Llobregat";"08289";"Torrelles de Llobregat";"1";"1";"B";"557";"197";"387";"470";"87";"0";"0";"470";"470"
"8";"Barcelona";"1";"Barcelona";"11";"Baix Llobregat";"08289";"Torrelles de Llobregat";"1";"2";"A";"527";"189";"318";"405";"122";"0";"1";"404";"405"
"8";"Barcelona";"1";"Barcelona";"11";"Baix Llobregat";"08289";"Torrelles de Llobregat";"1";"2";"B";"588";"206";"355";"452";"136";"1";"1";"450";"451"
"8";"Barcelona";"1";"Barcelona";"11";"Baix Llobregat";"08289";"Torrelles de Llobregat";"1";"3";"A";"667";"240";"438";"541";"126";"1";"2";"538";"540"
"8";"Barcelona";"1";"Barcelona";"11";"Baix Llobregat";"08289";"Torrelles de Llobregat";"1";"3";"B";"682";"244";"429";"556";"126";"0";"3";"553";"556"
"8";"Barcelona";"1";"Barcelona";"11";"Baix Llobregat";"08289";"Torrelles de Llobregat";"1";"4";"A";"363";"134";"245";"312";"51";"0";"0";"312";"312"
"8";"Barcelona";"1";"Barcelona";"11";"Baix Llobregat";"08289";"Torrelles de Llobregat";"1";"4";"B";"474";"176";"305";"398";"76";"0";"2";"396";"398"
"8";"Barcelona";"1";"Barcelona";"40";"Vallès Occidental";"08290";"Ullastrell";"1";"1";"A";"696";"279";"461";"592";"104";"2";"2";"588";"590"
"8";"Barcelona";"1";"Barcelona";"40";"Vallès Occidental";"08290";"Ullastrell";"1";"1";"B";"803";"301";"673";"709";"94";"3";"1";"705";"706"
"8";"Barcelona";"1";"Barcelona";"40";"Vallès Occidental";"08291";"Vacarisses";"1";"1";"A";"503";"209";"343";"410";"93";"1";"5";"404";"409"
"8";"Barcelona";"1";"Barcelona";"40";"Vallès Occidental";"08291";"Vacarisses";"1";"1";"B";"564";"231";"377";"454";"110";"3";"3";"448";"451"
"8";"Barcelona";"1";"Barcelona";"40";"Vallès Occidental";"08291";"Vacarisses";"1";"2";"A";"653";"285";"460";"559";"94";"0";"2";"557";"559"
"8";"Barcelona";"1";"Barcelona";"40";"Vallès Occidental";"08291";"Vacarisses";"1";"2";"B";"790";"343";"537";"630";"160";"0";"4";"626";"630"
"8";"Barcelona";"1";"Barcelona";"40";"Vallès Occidental";"08291";"Vacarisses";"1";"3";"A";"567";"229";"357";"451";"116";"1";"4";"446";"450"
"8";"Barcelona";"1";"Barcelona";"40";"Vallès Occidental";"08291";"Vacarisses";"1";"3";"B";"675";"232";"406";"501";"174";"0";"7";"494";"501"
"8";"Barcelona";"1";"Barcelona";"40";"Vallès Occidental";"08291";"Vacarisses";"1";"4";"U";"777";"224";"415";"529";"248";"3";"4";"522";"526"
"8";"Barcelona";"1";"Barcelona";"41";"Vallès Oriental";"08294";"Vallgorguina";"1";"1";"A";"614";"218";"441";"520";"94";"1";"1";"518";"519"
"8";"Barcelona";"1";"Barcelona";"41";"Vallès Oriental";"08294";"Vallgorguina";"1";"1";"B";"548";"219";"376";"454";"94";"1";"8";"445";"453"
"8";"Barcelona";"1";"Barcelona";"41";"Vallès Oriental";"08294";"Vallgorguina";"1";"1";"C";"802";"274";"517";"626";"176";"1";"4";"621";"625"
"8";"Barcelona";"1";"Barcelona";"11";"Baix Llobregat";"08295";"Vallirana";"1";"1";"A";"622";"197";"373";"460";"162";"1";"4";"455";"459"
"8";"Barcelona";"1";"Barcelona";"11";"Baix Llobregat";"08295";"Vallirana";"1";"1";"B";"606";"214";"336";"449";"157";"2";"1";"446";"447"
"8";"Barcelona";"1";"Barcelona";"11";"Baix Llobregat";"08295";"Vallirana";"1";"1";"C";"655";"220";"374";"462";"193";"4";"2";"456";"458"
"8";"Barcelona";"1";"Barcelona";"11";"Baix Llobregat";"08295";"Vallirana";"1";"2";"A";"801";"283";"492";"625";"176";"4";"7";"614";"621"
"8";"Barcelona";"1";"Barcelona";"11";"Baix Llobregat";"08295";"Vallirana";"1";"2";"B";"948";"311";"543";"694";"254";"2";"3";"689";"692"
"8";"Barcelona";"1";"Barcelona";"11";"Baix Llobregat";"08295";"Vallirana";"1";"3";"A";"659";"208";"436";"520";"139";"1";"0";"519";"519"
"8";"Barcelona";"1";"Barcelona";"11";"Baix Llobregat";"08295";"Vallirana";"1";"3";"B";"665";"250";"415";"519";"146";"3";"2";"514";"516"
"8";"Barcelona";"1";"Barcelona";"11";"Baix Llobregat";"08295";"Vallirana";"1";"4";"U";"833";"280";"509";"631";"202";"1";"6";"624";"630"
"8";"Barcelona";"1";"Barcelona";"11";"Baix Llobregat";"08295";"Vallirana";"1";"5";"U";"843";"313";"543";"636";"207";"1";"3";"632";"635"
"8";"Barcelona";"1";"Barcelona";"11";"Baix Llobregat";"08295";"Vallirana";"1";"6";"A";"653";"220";"385";"479";"174";"1";"6";"472";"478"
"8";"Barcelona";"1";"Barcelona";"11";"Baix Llobregat";"08295";"Vallirana";"1";"6";"B";"731";"296";"470";"568";"163";"2";"2";"564";"566"
"8";"Barcelona";"1";"Barcelona";"11";"Baix Llobregat";"08295";"Vallirana";"1";"7";"A";"593";"193";"359";"439";"154";"0";"7";"432";"439"
"8";"Barcelona";"1";"Barcelona";"11";"Baix Llobregat";"08295";"Vallirana";"1";"7";"B";"715";"231";"409";"531";"184";"0";"4";"527";"531"
"8";"Barcelona";"1";"Barcelona";"11";"Baix Llobregat";"08295";"Vallirana";"1";"7";"C";"612";"232";"393";"473";"139";"2";"3";"468";"471"
"8";"Barcelona";"1";"Barcelona";"11";"Baix Llobregat";"08295";"Vallirana";"1";"8";"U";"921";"407";"633";"735";"186";"3";"5";"727";"732"
"8";"Barcelona";"1";"Barcelona";"41";"Vallès Oriental";"08296";"Vallromanes";"1";"1";"A";"602";"215";"405";"517";"85";"1";"3";"513";"516"
"8";"Barcelona";"1";"Barcelona";"41";"Vallès Oriental";"08296";"Vallromanes";"1";"1";"B";"588";"224";"409";"506";"82";"0";"7";"499";"506"
"8";"Barcelona";"1";"Barcelona";"41";"Vallès Oriental";"08296";"Vallromanes";"1";"1";"C";"596";"226";"381";"508";"88";"1";"1";"506";"507"
"8";"Barcelona";"1";"Barcelona";"11";"Baix Llobregat";"08301";"Viladecans";"1";"1";"U";"971";"312";"593";"717";"254";"4";"3";"710";"713"
"8";"Barcelona";"1";"Barcelona";"11";"Baix Llobregat";"08301";"Viladecans";"1";"10";"A";"455";"141";"260";"325";"130";"2";"2";"321";"323"
"8";"Barcelona";"1";"Barcelona";"11";"Baix Llobregat";"08301";"Viladecans";"1";"10";"B";"503";"180";"309";"378";"125";"2";"0";"376";"376"
"8";"Barcelona";"1";"Barcelona";"11";"Baix Llobregat";"08301";"Viladecans";"1";"11";"A";"583";"222";"368";"442";"141";"2";"3";"437";"440"
"8";"Barcelona";"1";"Barcelona";"11";"Baix Llobregat";"08301";"Viladecans";"1";"11";"B";"622";"230";"410";"502";"120";"1";"4";"497";"501"
"8";"Barcelona";"1";"Barcelona";"11";"Baix Llobregat";"08301";"Viladecans";"1";"12";"U";"805";"265";"499";"642";"163";"4";"3";"635";"638"
"8";"Barcelona";"1";"Barcelona";"11";"Baix Llobregat";"08301";"Viladecans";"1";"13";"U";"964";"360";"687";"813";"151";"1";"7";"805";"812"
"8";"Barcelona";"1";"Barcelona";"11";"Baix Llobregat";"08301";"Viladecans";"1";"14";"A";"727";"242";"425";"546";"181";"1";"7";"538";"545"
"8";"Barcelona";"1";"Barcelona";"11";"Baix Llobregat";"08301";"Viladecans";"1";"14";"B";"815";"268";"482";"633";"182";"1";"2";"630";"632"
"8";"Barcelona";"1";"Barcelona";"11";"Baix Llobregat";"08301";"Viladecans";"1";"15";"U";"562";"191";"323";"393";"169";"0";"2";"391";"393"
"8";"Barcelona";"1";"Barcelona";"11";"Baix Llobregat";"08301";"Viladecans";"1";"16";"A";"562";"195";"378";"482";"80";"1";"2";"479";"481"
"8";"Barcelona";"1";"Barcelona";"11";"Baix Llobregat";"08301";"Viladecans";"1";"16";"B";"564";"190";"363";"481";"83";"2";"5";"474";"479"
"8";"Barcelona";"1";"Barcelona";"11";"Baix Llobregat";"08301";"Viladecans";"1";"2";"A";"848";"281";"490";"627";"221";"0";"2";"625";"627"
"8";"Barcelona";"1";"Barcelona";"11";"Baix Llobregat";"08301";"Viladecans";"1";"2";"B";"926";"278";"505";"653";"273";"0";"3";"650";"653"
"8";"Barcelona";"1";"Barcelona";"11";"Baix Llobregat";"08301";"Viladecans";"1";"3";"A";"902";"301";"586";"726";"176";"3";"3";"720";"723"
"8";"Barcelona";"1";"Barcelona";"11";"Baix Llobregat";"08301";"Viladecans";"1";"3";"B";"1027";"335";"637";"813";"214";"0";"3";"810";"813"
"8";"Barcelona";"1";"Barcelona";"11";"Baix Llobregat";"08301";"Viladecans";"1";"4";"A";"630";"210";"406";"502";"128";"7";"0";"495";"495"
"8";"Barcelona";"1";"Barcelona";"11";"Baix Llobregat";"08301";"Viladecans";"1";"4";"B";"679";"244";"453";"552";"127";"0";"0";"552";"552"
"8";"Barcelona";"1";"Barcelona";"11";"Baix Llobregat";"08301";"Viladecans";"1";"5";"U";"630";"282";"346";"489";"141";"1";"5";"483";"488"
"8";"Barcelona";"1";"Barcelona";"11";"Baix Llobregat";"08301";"Viladecans";"1";"6";"A";"583";"222";"335";"422";"161";"1";"2";"419";"421"
"8";"Barcelona";"1";"Barcelona";"11";"Baix Llobregat";"08301";"Viladecans";"1";"6";"B";"705";"275";"451";"536";"169";"2";"1";"533";"534"
"8";"Barcelona";"1";"Barcelona";"11";"Baix Llobregat";"08301";"Viladecans";"1";"7";"A";"468";"157";"272";"341";"127";"2";"2";"337";"339"
"8";"Barcelona";"1";"Barcelona";"11";"Baix Llobregat";"08301";"Viladecans";"1";"7";"B";"458";"183";"291";"355";"103";"0";"0";"355";"355"
"8";"Barcelona";"1";"Barcelona";"11";"Baix Llobregat";"08301";"Viladecans";"1";"8";"U";"957";"339";"590";"718";"239";"4";"5";"709";"714"
"8";"Barcelona";"1";"Barcelona";"11";"Baix Llobregat";"08301";"Viladecans";"1";"9";"U";"913";"226";"548";"711";"202";"2";"6";"703";"709"
"8";"Barcelona";"1";"Barcelona";"11";"Baix Llobregat";"08301";"Viladecans";"2";"1";"A";"430";"159";"240";"293";"137";"1";"1";"291";"292"
"8";"Barcelona";"1";"Barcelona";"11";"Baix Llobregat";"08301";"Viladecans";"2";"1";"B";"573";"200";"319";"381";"192";"0";"1";"380";"381"
"8";"Barcelona";"1";"Barcelona";"11";"Baix Llobregat";"08301";"Viladecans";"2";"10";"A";"505";"160";"281";"361";"144";"2";"1";"358";"359"
"8";"Barcelona";"1";"Barcelona";"11";"Baix Llobregat";"08301";"Viladecans";"2";"10";"B";"650";"215";"361";"437";"213";"4";"5";"428";"433"
"8";"Barcelona";"1";"Barcelona";"11";"Baix Llobregat";"08301";"Viladecans";"2";"11";"U";"828";"271";"504";"662";"166";"3";"3";"656";"659"
"8";"Barcelona";"1";"Barcelona";"11";"Baix Llobregat";"08301";"Viladecans";"2";"12";"A";"502";"175";"287";"355";"147";"1";"0";"354";"354"
"8";"Barcelona";"1";"Barcelona";"11";"Baix Llobregat";"08301";"Viladecans";"2";"12";"B";"566";"213";"336";"428";"138";"2";"2";"424";"426"
"8";"Barcelona";"1";"Barcelona";"11";"Baix Llobregat";"08301";"Viladecans";"2";"13";"A";"484";"165";"307";"367";"117";"2";"2";"363";"365"
"8";"Barcelona";"1";"Barcelona";"11";"Baix Llobregat";"08301";"Viladecans";"2";"13";"B";"622";"217";"397";"477";"145";"2";"2";"473";"475"
"8";"Barcelona";"1";"Barcelona";"11";"Baix Llobregat";"08301";"Viladecans";"2";"14";"U";"805";"258";"468";"601";"204";"2";"5";"594";"599"
"8";"Barcelona";"1";"Barcelona";"11";"Baix Llobregat";"08301";"Viladecans";"2";"15";"A";"709";"244";"452";"559";"150";"2";"3";"554";"557"
"8";"Barcelona";"1";"Barcelona";"11";"Baix Llobregat";"08301";"Viladecans";"2";"15";"B";"772";"216";"445";"588";"184";"3";"4";"581";"585"
"8";"Barcelona";"1";"Barcelona";"11";"Baix Llobregat";"08301";"Viladecans";"2";"16";"A";"601";"212";"411";"507";"94";"3";"1";"503";"504"
"8";"Barcelona";"1";"Barcelona";"11";"Baix Llobregat";"08301";"Viladecans";"2";"16";"B";"748";"253";"492";"618";"130";"5";"4";"609";"613"
"8";"Barcelona";"1";"Barcelona";"11";"Baix Llobregat";"08301";"Viladecans";"2";"17";"A";"622";"222";"359";"460";"162";"1";"8";"451";"459"
"8";"Barcelona";"1";"Barcelona";"11";"Baix Llobregat";"08301";"Viladecans";"2";"17";"B";"694";"231";"413";"534";"160";"2";"2";"530";"532"
"8";"Barcelona";"1";"Barcelona";"11";"Baix Llobregat";"08301";"Viladecans";"2";"18";"U";"691";"239";"379";"455";"236";"2";"1";"452";"453"
"8";"Barcelona";"1";"Barcelona";"11";"Baix Llobregat";"08301";"Viladecans";"2";"19";"U";"539";"221";"343";"407";"132";"1";"6";"400";"406"
"8";"Barcelona";"1";"Barcelona";"11";"Baix Llobregat";"08301";"Viladecans";"2";"2";"A";"509";"166";"271";"349";"160";"3";"3";"343";"346"
"8";"Barcelona";"1";"Barcelona";"11";"Baix Llobregat";"08301";"Viladecans";"2";"2";"B";"577";"213";"346";"417";"160";"2";"4";"411";"415"
"8";"Barcelona";"1";"Barcelona";"11";"Baix Llobregat";"08301";"Viladecans";"2";"20";"A";"524";"210";"332";"416";"108";"2";"2";"412";"414"
"8";"Barcelona";"1";"Barcelona";"11";"Baix Llobregat";"08301";"Viladecans";"2";"20";"B";"680";"230";"410";"536";"144";"1";"1";"534";"535"
"8";"Barcelona";"1";"Barcelona";"11";"Baix Llobregat";"08301";"Viladecans";"2";"21";"U";"897";"268";"568";"695";"202";"1";"8";"686";"694"
"8";"Barcelona";"1";"Barcelona";"11";"Baix Llobregat";"08301";"Viladecans";"2";"22";"A";"602";"208";"382";"482";"120";"5";"4";"473";"477"
"8";"Barcelona";"1";"Barcelona";"11";"Baix Llobregat";"08301";"Viladecans";"2";"22";"B";"688";"191";"440";"572";"116";"2";"0";"570";"570"
"8";"Barcelona";"1";"Barcelona";"11";"Baix Llobregat";"08301";"Viladecans";"2";"23";"A";"453";"144";"298";"375";"78";"3";"1";"371";"372"
"8";"Barcelona";"1";"Barcelona";"11";"Baix Llobregat";"08301";"Viladecans";"2";"23";"B";"452";"176";"323";"373";"79";"1";"1";"371";"372"
"8";"Barcelona";"1";"Barcelona";"11";"Baix Llobregat";"08301";"Viladecans";"2";"24";"U";"757";"253";"475";"576";"181";"1";"3";"572";"575"
"8";"Barcelona";"1";"Barcelona";"11";"Baix Llobregat";"08301";"Viladecans";"2";"25";"A";"636";"223";"474";"489";"147";"3";"5";"481";"486"
"8";"Barcelona";"1";"Barcelona";"11";"Baix Llobregat";"08301";"Viladecans";"2";"25";"B";"771";"265";"487";"602";"169";"3";"2";"597";"599"
"8";"Barcelona";"1";"Barcelona";"11";"Baix Llobregat";"08301";"Viladecans";"2";"26";"A";"534";"218";"363";"451";"83";"3";"1";"447";"448"
"8";"Barcelona";"1";"Barcelona";"11";"Baix Llobregat";"08301";"Viladecans";"2";"26";"B";"607";"241";"420";"524";"83";"4";"0";"520";"520"
"8";"Barcelona";"1";"Barcelona";"11";"Baix Llobregat";"08301";"Viladecans";"2";"27";"U";"783";"290";"490";"605";"178";"2";"0";"603";"603"
"8";"Barcelona";"1";"Barcelona";"11";"Baix Llobregat";"08301";"Viladecans";"2";"28";"U";"859";"288";"577";"737";"122";"2";"3";"732";"735"
"8";"Barcelona";"1";"Barcelona";"11";"Baix Llobregat";"08301";"Viladecans";"2";"29";"A";"716";"239";"476";"623";"93";"0";"2";"621";"623"
"8";"Barcelona";"1";"Barcelona";"11";"Baix Llobregat";"08301";"Viladecans";"2";"29";"B";"830";"272";"562";"730";"100";"1";"3";"726";"729"
"8";"Barcelona";"1";"Barcelona";"11";"Baix Llobregat";"08301";"Viladecans";"2";"3";"A";"742";"243";"476";"600";"142";"1";"1";"598";"599"
"8";"Barcelona";"1";"Barcelona";"11";"Baix Llobregat";"08301";"Viladecans";"2";"3";"B";"816";"249";"523";"670";"146";"4";"0";"666";"666"
"8";"Barcelona";"1";"Barcelona";"11";"Baix Llobregat";"08301";"Viladecans";"2";"4";"U";"817";"273";"503";"608";"209";"3";"1";"604";"605"
"8";"Barcelona";"1";"Barcelona";"11";"Baix Llobregat";"08301";"Viladecans";"2";"5";"U";"839";"250";"509";"634";"205";"1";"1";"632";"633"
"8";"Barcelona";"1";"Barcelona";"11";"Baix Llobregat";"08301";"Viladecans";"2";"6";"A";"457";"177";"283";"350";"107";"0";"1";"349";"350"
"8";"Barcelona";"1";"Barcelona";"11";"Baix Llobregat";"08301";"Viladecans";"2";"6";"B";"564";"195";"307";"397";"167";"4";"2";"391";"393"
"8";"Barcelona";"1";"Barcelona";"11";"Baix Llobregat";"08301";"Viladecans";"2";"7";"A";"474";"174";"272";"342";"132";"2";"3";"337";"340"
"8";"Barcelona";"1";"Barcelona";"11";"Baix Llobregat";"08301";"Viladecans";"2";"7";"B";"563";"199";"327";"402";"161";"1";"0";"401";"401"
"8";"Barcelona";"1";"Barcelona";"11";"Baix Llobregat";"08301";"Viladecans";"2";"8";"A";"466";"143";"281";"376";"90";"3";"1";"372";"373"
"8";"Barcelona";"1";"Barcelona";"11";"Baix Llobregat";"08301";"Viladecans";"2";"8";"B";"616";"225";"410";"492";"124";"0";"3";"489";"492"
"8";"Barcelona";"1";"Barcelona";"11";"Baix Llobregat";"08301";"Viladecans";"2";"9";"A";"521";"175";"289";"350";"171";"0";"2";"348";"350"
"8";"Barcelona";"1";"Barcelona";"11";"Baix Llobregat";"08301";"Viladecans";"2";"9";"B";"573";"223";"353";"426";"147";"0";"1";"425";"426"
"8";"Barcelona";"1";"Barcelona";"40";"Vallès Occidental";"08300";"Viladecavalls";"1";"1";"A";"511";"194";"350";"442";"69";"1";"1";"440";"441"
"8";"Barcelona";"1";"Barcelona";"40";"Vallès Occidental";"08300";"Viladecavalls";"1";"1";"B";"478";"181";"347";"416";"62";"1";"1";"414";"415"
"8";"Barcelona";"1";"Barcelona";"40";"Vallès Occidental";"08300";"Viladecavalls";"1";"1";"C";"478";"198";"337";"424";"54";"2";"3";"419";"422"
"8";"Barcelona";"1";"Barcelona";"40";"Vallès Occidental";"08300";"Viladecavalls";"1";"2";"A";"457";"195";"290";"353";"104";"0";"1";"352";"353"
"8";"Barcelona";"1";"Barcelona";"40";"Vallès Occidental";"08300";"Viladecavalls";"1";"2";"B";"656";"247";"434";"522";"134";"4";"1";"517";"518"
"8";"Barcelona";"1";"Barcelona";"40";"Vallès Occidental";"08300";"Viladecavalls";"1";"3";"A";"433";"162";"210";"345";"88";"0";"2";"343";"345"
"8";"Barcelona";"1";"Barcelona";"40";"Vallès Occidental";"08300";"Viladecavalls";"1";"3";"B";"542";"226";"350";"439";"103";"0";"3";"436";"439"
"8";"Barcelona";"1";"Barcelona";"40";"Vallès Occidental";"08300";"Viladecavalls";"1";"4";"U";"756";"317";"540";"649";"107";"2";"4";"643";"647"
"8";"Barcelona";"1";"Barcelona";"40";"Vallès Occidental";"08300";"Viladecavalls";"1";"5";"U";"813";"282";"518";"651";"162";"2";"5";"644";"649"
"8";"Barcelona";"1";"Barcelona";"40";"Vallès Occidental";"08300";"Viladecavalls";"1";"6";"U";"557";"207";"404";"463";"94";"3";"4";"456";"460"
"8";"Barcelona";"1";"Barcelona";"3";"Alt Penedès";"08305";"Vilafranca del Penedès";"1";"1";"A";"542";"206";"346";"416";"126";"1";"3";"412";"415"
"8";"Barcelona";"1";"Barcelona";"3";"Alt Penedès";"08305";"Vilafranca del Penedès";"1";"1";"B";"601";"270";"406";"480";"121";"3";"3";"474";"477"
"8";"Barcelona";"1";"Barcelona";"3";"Alt Penedès";"08305";"Vilafranca del Penedès";"1";"2";"A";"796";"314";"520";"615";"181";"4";"1";"610";"611"
"8";"Barcelona";"1";"Barcelona";"3";"Alt Penedès";"08305";"Vilafranca del Penedès";"1";"2";"B";"914";"395";"589";"712";"202";"7";"3";"702";"705"
"8";"Barcelona";"1";"Barcelona";"3";"Alt Penedès";"08305";"Vilafranca del Penedès";"1";"3";"U";"685";"253";"428";"506";"179";"4";"1";"501";"502"
"8";"Barcelona";"1";"Barcelona";"3";"Alt Penedès";"08305";"Vilafranca del Penedès";"2";"1";"A";"649";"225";"398";"479";"170";"2";"2";"475";"477"
"8";"Barcelona";"1";"Barcelona";"3";"Alt Penedès";"08305";"Vilafranca del Penedès";"2";"1";"B";"778";"268";"478";"571";"207";"5";"1";"565";"566"
"8";"Barcelona";"1";"Barcelona";"3";"Alt Penedès";"08305";"Vilafranca del Penedès";"2";"2";"A";"579";"206";"362";"441";"138";"3";"3";"435";"438"
"8";"Barcelona";"1";"Barcelona";"3";"Alt Penedès";"08305";"Vilafranca del Penedès";"2";"2";"B";"709";"266";"452";"558";"151";"2";"3";"553";"556"
"8";"Barcelona";"1";"Barcelona";"3";"Alt Penedès";"08305";"Vilafranca del Penedès";"2";"3";"U";"1008";"373";"613";"732";"276";"8";"3";"721";"724"
"8";"Barcelona";"1";"Barcelona";"3";"Alt Penedès";"08305";"Vilafranca del Penedès";"2";"4";"A";"526";"197";"297";"370";"156";"2";"0";"368";"368"
"8";"Barcelona";"1";"Barcelona";"3";"Alt Penedès";"08305";"Vilafranca del Penedès";"2";"4";"B";"604";"222";"380";"451";"153";"2";"2";"447";"449"
"8";"Barcelona";"1";"Barcelona";"3";"Alt Penedès";"08305";"Vilafranca del Penedès";"2";"5";"A";"650";"252";"442";"514";"136";"2";"3";"509";"512"
"8";"Barcelona";"1";"Barcelona";"3";"Alt Penedès";"08305";"Vilafranca del Penedès";"2";"5";"B";"813";"246";"518";"659";"154";"2";"4";"653";"657"
"8";"Barcelona";"1";"Barcelona";"3";"Alt Penedès";"08305";"Vilafranca del Penedès";"2";"6";"A";"754";"259";"434";"524";"230";"3";"2";"519";"521"
"8";"Barcelona";"1";"Barcelona";"3";"Alt Penedès";"08305";"Vilafranca del Penedès";"2";"6";"B";"864";"231";"423";"638";"226";"5";"2";"631";"633"
"8";"Barcelona";"1";"Barcelona";"3";"Alt Penedès";"08305";"Vilafranca del Penedès";"3";"1";"A";"510";"182";"337";"407";"103";"0";"1";"406";"407"
"8";"Barcelona";"1";"Barcelona";"3";"Alt Penedès";"08305";"Vilafranca del Penedès";"3";"1";"B";"595";"207";"388";"473";"122";"4";"2";"467";"469"
"8";"Barcelona";"1";"Barcelona";"3";"Alt Penedès";"08305";"Vilafranca del Penedès";"3";"2";"U";"794";"328";"536";"631";"163";"3";"2";"626";"628"
"8";"Barcelona";"1";"Barcelona";"3";"Alt Penedès";"08305";"Vilafranca del Penedès";"3";"3";"A";"869";"274";"526";"674";"195";"3";"8";"663";"671"
"8";"Barcelona";"1";"Barcelona";"3";"Alt Penedès";"08305";"Vilafranca del Penedès";"3";"3";"B";"1071";"285";"650";"821";"250";"4";"2";"815";"817"
"8";"Barcelona";"1";"Barcelona";"3";"Alt Penedès";"08305";"Vilafranca del Penedès";"3";"4";"A";"525";"190";"356";"447";"78";"2";"2";"443";"445"
"8";"Barcelona";"1";"Barcelona";"3";"Alt Penedès";"08305";"Vilafranca del Penedès";"3";"4";"B";"621";"223";"436";"516";"105";"0";"1";"515";"516"
"8";"Barcelona";"1";"Barcelona";"3";"Alt Penedès";"08305";"Vilafranca del Penedès";"4";"1";"A";"605";"249";"433";"498";"107";"1";"0";"497";"497"
"8";"Barcelona";"1";"Barcelona";"3";"Alt Penedès";"08305";"Vilafranca del Penedès";"4";"1";"B";"694";"311";"523";"603";"91";"2";"2";"599";"601"
"8";"Barcelona";"1";"Barcelona";"3";"Alt Penedès";"08305";"Vilafranca del Penedès";"4";"2";"A";"590";"267";"413";"480";"110";"2";"2";"476";"478"
"8";"Barcelona";"1";"Barcelona";"3";"Alt Penedès";"08305";"Vilafranca del Penedès";"4";"2";"B";"623";"278";"442";"518";"105";"2";"1";"515";"516"
"8";"Barcelona";"1";"Barcelona";"3";"Alt Penedès";"08305";"Vilafranca del Penedès";"4";"3";"A";"527";"211";"339";"420";"107";"1";"0";"419";"419"
"8";"Barcelona";"1";"Barcelona";"3";"Alt Penedès";"08305";"Vilafranca del Penedès";"4";"3";"B";"617";"259";"420";"515";"102";"2";"3";"510";"513"
"8";"Barcelona";"1";"Barcelona";"3";"Alt Penedès";"08305";"Vilafranca del Penedès";"4";"4";"U";"1078";"414";"720";"868";"210";"2";"5";"861";"866"
"8";"Barcelona";"1";"Barcelona";"3";"Alt Penedès";"08305";"Vilafranca del Penedès";"4";"5";"A";"719";"285";"479";"573";"146";"1";"3";"569";"572"
"8";"Barcelona";"1";"Barcelona";"3";"Alt Penedès";"08305";"Vilafranca del Penedès";"4";"5";"B";"821";"318";"556";"679";"142";"1";"3";"675";"678"
"8";"Barcelona";"1";"Barcelona";"3";"Alt Penedès";"08305";"Vilafranca del Penedès";"4";"6";"U";"931";"379";"656";"763";"168";"5";"2";"756";"758"
"8";"Barcelona";"1";"Barcelona";"3";"Alt Penedès";"08305";"Vilafranca del Penedès";"4";"7";"U";"940";"323";"654";"805";"135";"1";"3";"801";"804"
"8";"Barcelona";"1";"Barcelona";"3";"Alt Penedès";"08305";"Vilafranca del Penedès";"4";"8";"A";"692";"245";"437";"544";"148";"4";"3";"537";"540"
"8";"Barcelona";"1";"Barcelona";"3";"Alt Penedès";"08305";"Vilafranca del Penedès";"4";"8";"B";"778";"258";"488";"609";"169";"2";"4";"603";"607"
"8";"Barcelona";"1";"Barcelona";"3";"Alt Penedès";"08305";"Vilafranca del Penedès";"4";"9";"A";"580";"222";"395";"478";"102";"1";"5";"472";"477"
"8";"Barcelona";"1";"Barcelona";"3";"Alt Penedès";"08305";"Vilafranca del Penedès";"4";"9";"B";"630";"256";"432";"525";"105";"3";"2";"520";"522"
"8";"Barcelona";"1";"Barcelona";"41";"Vallès Oriental";"08306";"Vilalba Sasserra";"1";"1";"U";"511";"185";"299";"384";"127";"5";"2";"377";"379"
"8";"Barcelona";"1";"Barcelona";"41";"Vallès Oriental";"08902";"Vilanova del Vallès";"1";"1";"A";"833";"307";"576";"711";"122";"2";"4";"705";"709"
"8";"Barcelona";"1";"Barcelona";"41";"Vallès Oriental";"08902";"Vilanova del Vallès";"1";"1";"B";"913";"360";"620";"785";"128";"2";"8";"775";"783"
"8";"Barcelona";"1";"Barcelona";"41";"Vallès Oriental";"08902";"Vilanova del Vallès";"1";"2";"A";"634";"251";"424";"515";"119";"3";"0";"512";"512"
"8";"Barcelona";"1";"Barcelona";"41";"Vallès Oriental";"08902";"Vilanova del Vallès";"1";"2";"B";"675";"269";"422";"514";"161";"1";"2";"511";"513"
"8";"Barcelona";"1";"Barcelona";"41";"Vallès Oriental";"08902";"Vilanova del Vallès";"1";"2";"C";"696";"251";"463";"569";"127";"0";"2";"567";"569"
"8";"Barcelona";"1";"Barcelona";"17";"Garraf";"08307";"Vilanova i la Geltrú";"1";"1";"A";"800";"321";"540";"648";"152";"0";"1";"647";"648"
"8";"Barcelona";"1";"Barcelona";"17";"Garraf";"08307";"Vilanova i la Geltrú";"1";"1";"B";"935";"388";"643";"753";"182";"0";"2";"751";"753"
"8";"Barcelona";"1";"Barcelona";"17";"Garraf";"08307";"Vilanova i la Geltrú";"1";"10";"A";"513";"231";"378";"439";"74";"0";"4";"435";"439"
"8";"Barcelona";"1";"Barcelona";"17";"Garraf";"08307";"Vilanova i la Geltrú";"1";"10";"B";"525";"240";"378";"428";"97";"1";"0";"427";"427"
"8";"Barcelona";"1";"Barcelona";"17";"Garraf";"08307";"Vilanova i la Geltrú";"1";"11";"A";"539";"181";"326";"394";"145";"0";"1";"393";"394"
"8";"Barcelona";"1";"Barcelona";"17";"Garraf";"08307";"Vilanova i la Geltrú";"1";"11";"B";"598";"222";"366";"457";"141";"1";"6";"450";"456"
"8";"Barcelona";"1";"Barcelona";"17";"Garraf";"08307";"Vilanova i la Geltrú";"1";"2";"U";"929";"353";"642";"782";"147";"1";"6";"775";"781"
"8";"Barcelona";"1";"Barcelona";"17";"Garraf";"08307";"Vilanova i la Geltrú";"1";"3";"A";"715";"241";"460";"537";"178";"1";"2";"534";"536"
"8";"Barcelona";"1";"Barcelona";"17";"Garraf";"08307";"Vilanova i la Geltrú";"1";"3";"B";"833";"291";"563";"665";"168";"1";"4";"660";"664"
"8";"Barcelona";"1";"Barcelona";"17";"Garraf";"08307";"Vilanova i la Geltrú";"1";"4";"U";"781";"321";"528";"610";"171";"2";"0";"608";"608"
"8";"Barcelona";"1";"Barcelona";"17";"Garraf";"08307";"Vilanova i la Geltrú";"1";"5";"U";"673";"277";"474";"543";"130";"1";"1";"541";"542"
"8";"Barcelona";"1";"Barcelona";"17";"Garraf";"08307";"Vilanova i la Geltrú";"1";"6";"A";"604";"230";"397";"479";"125";"2";"5";"472";"477"
"8";"Barcelona";"1";"Barcelona";"17";"Garraf";"08307";"Vilanova i la Geltrú";"1";"6";"B";"643";"250";"430";"510";"133";"6";"1";"503";"504"
"8";"Barcelona";"1";"Barcelona";"17";"Garraf";"08307";"Vilanova i la Geltrú";"1";"7";"A";"621";"265";"402";"475";"146";"3";"2";"470";"472"
"8";"Barcelona";"1";"Barcelona";"17";"Garraf";"08307";"Vilanova i la Geltrú";"1";"7";"B";"737";"296";"475";"561";"176";"1";"5";"555";"560"
"8";"Barcelona";"1";"Barcelona";"17";"Garraf";"08307";"Vilanova i la Geltrú";"1";"8";"A";"830";"287";"521";"659";"171";"0";"3";"656";"659"
"8";"Barcelona";"1";"Barcelona";"17";"Garraf";"08307";"Vilanova i la Geltrú";"1";"8";"B";"989";"309";"642";"781";"208";"1";"2";"778";"780"
"8";"Barcelona";"1";"Barcelona";"17";"Garraf";"08307";"Vilanova i la Geltrú";"1";"9";"A";"617";"208";"411";"484";"133";"3";"0";"481";"481"
"8";"Barcelona";"1";"Barcelona";"17";"Garraf";"08307";"Vilanova i la Geltrú";"1";"9";"B";"759";"293";"566";"636";"123";"2";"5";"629";"634"
"8";"Barcelona";"1";"Barcelona";"17";"Garraf";"08307";"Vilanova i la Geltrú";"2";"1";"A";"773";"288";"522";"637";"136";"2";"1";"634";"635"
"8";"Barcelona";"1";"Barcelona";"17";"Garraf";"08307";"Vilanova i la Geltrú";"2";"1";"B";"820";"284";"580";"639";"181";"3";"1";"635";"636"
"8";"Barcelona";"1";"Barcelona";"17";"Garraf";"08307";"Vilanova i la Geltrú";"2";"1";"C";"780";"283";"513";"614";"166";"0";"2";"612";"614"
"8";"Barcelona";"1";"Barcelona";"17";"Garraf";"08307";"Vilanova i la Geltrú";"2";"2";"A";"781";"294";"514";"616";"165";"2";"2";"612";"614"
"8";"Barcelona";"1";"Barcelona";"17";"Garraf";"08307";"Vilanova i la Geltrú";"2";"2";"B";"892";"357";"620";"715";"177";"1";"6";"708";"714"
"8";"Barcelona";"1";"Barcelona";"17";"Garraf";"08307";"Vilanova i la Geltrú";"2";"3";"A";"591";"210";"359";"447";"144";"0";"6";"441";"447"
"8";"Barcelona";"1";"Barcelona";"17";"Garraf";"08307";"Vilanova i la Geltrú";"2";"3";"B";"667";"205";"406";"524";"143";"0";"3";"521";"524"
"8";"Barcelona";"1";"Barcelona";"17";"Garraf";"08307";"Vilanova i la Geltrú";"2";"4";"A";"735";"279";"458";"553";"182";"2";"3";"548";"551"
"8";"Barcelona";"1";"Barcelona";"17";"Garraf";"08307";"Vilanova i la Geltrú";"2";"4";"B";"796";"296";"495";"591";"205";"1";"4";"586";"590"
"8";"Barcelona";"1";"Barcelona";"17";"Garraf";"08307";"Vilanova i la Geltrú";"2";"5";"U";"426";"114";"268";"312";"114";"0";"0";"312";"312"
"8";"Barcelona";"1";"Barcelona";"17";"Garraf";"08307";"Vilanova i la Geltrú";"2";"6";"A";"576";"216";"366";"426";"150";"0";"0";"426";"426"
"8";"Barcelona";"1";"Barcelona";"17";"Garraf";"08307";"Vilanova i la Geltrú";"2";"6";"B";"666";"230";"431";"505";"161";"1";"0";"504";"504"
"8";"Barcelona";"1";"Barcelona";"17";"Garraf";"08307";"Vilanova i la Geltrú";"2";"7";"A";"813";"217";"501";"598";"215";"1";"4";"593";"597"
"8";"Barcelona";"1";"Barcelona";"17";"Garraf";"08307";"Vilanova i la Geltrú";"2";"7";"B";"892";"257";"571";"671";"221";"2";"4";"665";"669"
"8";"Barcelona";"1";"Barcelona";"17";"Garraf";"08307";"Vilanova i la Geltrú";"3";"1";"U";"584";"209";"390";"427";"157";"2";"1";"424";"425"
"8";"Barcelona";"1";"Barcelona";"17";"Garraf";"08307";"Vilanova i la Geltrú";"3";"2";"U";"1013";"328";"628";"780";"233";"2";"8";"770";"778"
"8";"Barcelona";"1";"Barcelona";"17";"Garraf";"08307";"Vilanova i la Geltrú";"3";"3";"U";"869";"284";"555";"677";"192";"5";"1";"671";"672"
"8";"Barcelona";"1";"Barcelona";"17";"Garraf";"08307";"Vilanova i la Geltrú";"3";"4";"A";"858";"234";"449";"587";"271";"3";"0";"584";"584"
"8";"Barcelona";"1";"Barcelona";"17";"Garraf";"08307";"Vilanova i la Geltrú";"3";"4";"B";"959";"238";"510";"689";"270";"8";"4";"677";"681"
"8";"Barcelona";"1";"Barcelona";"17";"Garraf";"08307";"Vilanova i la Geltrú";"3";"5";"U";"1056";"305";"597";"740";"316";"3";"2";"735";"737"
"8";"Barcelona";"1";"Barcelona";"17";"Garraf";"08307";"Vilanova i la Geltrú";"4";"1";"U";"846";"306";"564";"673";"173";"1";"2";"670";"672"
"8";"Barcelona";"1";"Barcelona";"17";"Garraf";"08307";"Vilanova i la Geltrú";"4";"10";"A";"717";"258";"445";"549";"168";"2";"4";"543";"547"
"8";"Barcelona";"1";"Barcelona";"17";"Garraf";"08307";"Vilanova i la Geltrú";"4";"10";"B";"825";"299";"566";"642";"183";"0";"3";"639";"642"
"8";"Barcelona";"1";"Barcelona";"17";"Garraf";"08307";"Vilanova i la Geltrú";"4";"11";"A";"587";"222";"344";"412";"175";"1";"0";"411";"411"
"8";"Barcelona";"1";"Barcelona";"17";"Garraf";"08307";"Vilanova i la Geltrú";"4";"11";"B";"704";"291";"426";"511";"193";"1";"1";"509";"510"
"8";"Barcelona";"1";"Barcelona";"17";"Garraf";"08307";"Vilanova i la Geltrú";"4";"12";"A";"522";"205";"349";"421";"101";"0";"0";"421";"421"
"8";"Barcelona";"1";"Barcelona";"17";"Garraf";"08307";"Vilanova i la Geltrú";"4";"12";"B";"639";"223";"393";"499";"140";"1";"2";"496";"498"
"8";"Barcelona";"1";"Barcelona";"17";"Garraf";"08307";"Vilanova i la Geltrú";"4";"13";"U";"1040";"426";"706";"866";"174";"6";"5";"855";"860"
"8";"Barcelona";"1";"Barcelona";"17";"Garraf";"08307";"Vilanova i la Geltrú";"4";"14";"A";"640";"220";"434";"518";"122";"2";"3";"513";"516"
"8";"Barcelona";"1";"Barcelona";"17";"Garraf";"08307";"Vilanova i la Geltrú";"4";"14";"B";"775";"264";"483";"621";"154";"0";"6";"615";"621"
"8";"Barcelona";"1";"Barcelona";"17";"Garraf";"08307";"Vilanova i la Geltrú";"4";"15";"A";"564";"217";"382";"469";"95";"2";"2";"465";"467"
"8";"Barcelona";"1";"Barcelona";"17";"Garraf";"08307";"Vilanova i la Geltrú";"4";"15";"B";"742";"252";"515";"625";"117";"1";"4";"620";"624"
"8";"Barcelona";"1";"Barcelona";"17";"Garraf";"08307";"Vilanova i la Geltrú";"4";"16";"U";"972";"299";"455";"541";"431";"0";"2";"539";"541"
"8";"Barcelona";"1";"Barcelona";"17";"Garraf";"08307";"Vilanova i la Geltrú";"4";"2";"U";"552";"208";"345";"409";"143";"1";"1";"407";"408"
"8";"Barcelona";"1";"Barcelona";"17";"Garraf";"08307";"Vilanova i la Geltrú";"4";"3";"U";"599";"203";"354";"419";"180";"0";"1";"418";"419"
"8";"Barcelona";"1";"Barcelona";"17";"Garraf";"08307";"Vilanova i la Geltrú";"4";"4";"A";"563";"228";"346";"419";"144";"2";"3";"414";"417"
"8";"Barcelona";"1";"Barcelona";"17";"Garraf";"08307";"Vilanova i la Geltrú";"4";"4";"B";"705";"263";"412";"491";"214";"2";"0";"489";"489"
"8";"Barcelona";"1";"Barcelona";"17";"Garraf";"08307";"Vilanova i la Geltrú";"4";"5";"A";"662";"223";"437";"542";"120";"3";"5";"534";"539"
"8";"Barcelona";"1";"Barcelona";"17";"Garraf";"08307";"Vilanova i la Geltrú";"4";"5";"B";"772";"277";"512";"627";"145";"5";"0";"622";"622"
"8";"Barcelona";"1";"Barcelona";"17";"Garraf";"08307";"Vilanova i la Geltrú";"4";"6";"A";"560";"234";"370";"428";"132";"1";"3";"424";"427"
"8";"Barcelona";"1";"Barcelona";"17";"Garraf";"08307";"Vilanova i la Geltrú";"4";"6";"B";"723";"286";"470";"535";"188";"1";"1";"533";"534"
"8";"Barcelona";"1";"Barcelona";"17";"Garraf";"08307";"Vilanova i la Geltrú";"4";"7";"A";"849";"258";"510";"640";"209";"3";"1";"636";"637"
"8";"Barcelona";"1";"Barcelona";"17";"Garraf";"08307";"Vilanova i la Geltrú";"4";"7";"B";"1048";"309";"652";"819";"229";"3";"2";"814";"816"
"8";"Barcelona";"1";"Barcelona";"17";"Garraf";"08307";"Vilanova i la Geltrú";"4";"7";"C";"863";"273";"532";"624";"239";"4";"4";"616";"620"
"8";"Barcelona";"1";"Barcelona";"17";"Garraf";"08307";"Vilanova i la Geltrú";"4";"8";"U";"687";"289";"432";"490";"197";"4";"1";"485";"486"
"8";"Barcelona";"1";"Barcelona";"17";"Garraf";"08307";"Vilanova i la Geltrú";"4";"9";"U";"808";"310";"559";"655";"153";"2";"2";"651";"653"
"8";"Barcelona";"1";"Barcelona";"21";"Maresme";"08214";"Vilassar de Dalt";"1";"1";"A";"510";"196";"334";"423";"87";"0";"4";"419";"423"
"8";"Barcelona";"1";"Barcelona";"21";"Maresme";"08214";"Vilassar de Dalt";"1";"1";"B";"558";"232";"366";"472";"86";"2";"0";"470";"470"
"8";"Barcelona";"1";"Barcelona";"21";"Maresme";"08214";"Vilassar de Dalt";"1";"2";"U";"777";"295";"487";"590";"187";"1";"3";"586";"589"
"8";"Barcelona";"1";"Barcelona";"21";"Maresme";"08214";"Vilassar de Dalt";"1";"3";"A";"569";"250";"392";"464";"105";"3";"3";"458";"461"
"8";"Barcelona";"1";"Barcelona";"21";"Maresme";"08214";"Vilassar de Dalt";"1";"3";"B";"607";"267";"423";"485";"122";"0";"2";"483";"485"
"8";"Barcelona";"1";"Barcelona";"21";"Maresme";"08214";"Vilassar de Dalt";"1";"4";"A";"494";"220";"349";"427";"67";"4";"2";"421";"423"
"8";"Barcelona";"1";"Barcelona";"21";"Maresme";"08214";"Vilassar de Dalt";"1";"4";"B";"573";"231";"406";"504";"69";"3";"0";"501";"501"
"8";"Barcelona";"1";"Barcelona";"21";"Maresme";"08214";"Vilassar de Dalt";"2";"1";"A";"559";"227";"413";"482";"77";"1";"3";"478";"481"
"8";"Barcelona";"1";"Barcelona";"21";"Maresme";"08214";"Vilassar de Dalt";"2";"1";"B";"551";"212";"370";"447";"104";"0";"4";"443";"447"
"8";"Barcelona";"1";"Barcelona";"21";"Maresme";"08214";"Vilassar de Dalt";"2";"1";"C";"593";"260";"452";"524";"69";"5";"2";"517";"519"
"8";"Barcelona";"1";"Barcelona";"21";"Maresme";"08214";"Vilassar de Dalt";"2";"2";"A";"515";"215";"358";"419";"96";"0";"1";"418";"419"
"8";"Barcelona";"1";"Barcelona";"21";"Maresme";"08214";"Vilassar de Dalt";"2";"2";"B";"554";"212";"378";"463";"91";"0";"4";"459";"463"
"8";"Barcelona";"1";"Barcelona";"21";"Maresme";"08219";"Vilassar de Mar";"1";"1";"U";"752";"274";"504";"643";"109";"2";"1";"640";"641"
"8";"Barcelona";"1";"Barcelona";"21";"Maresme";"08219";"Vilassar de Mar";"1";"2";"A";"596";"252";"402";"486";"110";"4";"4";"478";"482"
"8";"Barcelona";"1";"Barcelona";"21";"Maresme";"08219";"Vilassar de Mar";"1";"2";"B";"815";"340";"571";"687";"128";"1";"6";"680";"686"
"8";"Barcelona";"1";"Barcelona";"21";"Maresme";"08219";"Vilassar de Mar";"1";"3";"A";"719";"324";"505";"607";"112";"4";"2";"601";"603"
"8";"Barcelona";"1";"Barcelona";"21";"Maresme";"08219";"Vilassar de Mar";"1";"3";"B";"863";"310";"617";"723";"140";"3";"13";"707";"720"
"8";"Barcelona";"1";"Barcelona";"21";"Maresme";"08219";"Vilassar de Mar";"1";"4";"A";"673";"269";"460";"580";"93";"0";"4";"576";"580"
"8";"Barcelona";"1";"Barcelona";"21";"Maresme";"08219";"Vilassar de Mar";"1";"4";"B";"797";"297";"561";"688";"109";"1";"1";"686";"687"
"8";"Barcelona";"1";"Barcelona";"21";"Maresme";"08219";"Vilassar de Mar";"1";"5";"A";"500";"199";"357";"427";"73";"0";"2";"425";"427"
"8";"Barcelona";"1";"Barcelona";"21";"Maresme";"08219";"Vilassar de Mar";"1";"5";"B";"506";"226";"348";"428";"78";"2";"3";"423";"426"
"8";"Barcelona";"1";"Barcelona";"21";"Maresme";"08219";"Vilassar de Mar";"1";"6";"A";"486";"202";"345";"406";"80";"3";"5";"398";"403"
"8";"Barcelona";"1";"Barcelona";"21";"Maresme";"08219";"Vilassar de Mar";"1";"6";"B";"511";"209";"368";"435";"76";"1";"2";"432";"434"
"8";"Barcelona";"1";"Barcelona";"21";"Maresme";"08219";"Vilassar de Mar";"2";"1";"U";"912";"354";"652";"772";"140";"3";"2";"767";"769"
"8";"Barcelona";"1";"Barcelona";"21";"Maresme";"08219";"Vilassar de Mar";"2";"2";"U";"909";"386";"796";"798";"111";"3";"2";"793";"795"
"8";"Barcelona";"1";"Barcelona";"21";"Maresme";"08219";"Vilassar de Mar";"2";"3";"U";"948";"413";"697";"776";"172";"1";"2";"773";"775"
"8";"Barcelona";"1";"Barcelona";"21";"Maresme";"08219";"Vilassar de Mar";"2";"4";"A";"460";"174";"334";"400";"60";"0";"4";"396";"400"
"8";"Barcelona";"1";"Barcelona";"21";"Maresme";"08219";"Vilassar de Mar";"2";"4";"B";"484";"187";"322";"412";"72";"1";"4";"407";"411"
"8";"Barcelona";"1";"Barcelona";"21";"Maresme";"08219";"Vilassar de Mar";"2";"5";"A";"450";"179";"315";"388";"62";"1";"3";"384";"387"
"8";"Barcelona";"1";"Barcelona";"21";"Maresme";"08219";"Vilassar de Mar";"2";"5";"B";"523";"195";"358";"455";"68";"0";"3";"452";"455"
"8";"Barcelona";"1";"Barcelona";"21";"Maresme";"08219";"Vilassar de Mar";"3";"1";"A";"482";"171";"321";"393";"89";"0";"2";"391";"393"
"8";"Barcelona";"1";"Barcelona";"21";"Maresme";"08219";"Vilassar de Mar";"3";"1";"B";"566";"186";"383";"456";"110";"1";"5";"450";"455"
"8";"Barcelona";"1";"Barcelona";"21";"Maresme";"08219";"Vilassar de Mar";"3";"2";"U";"847";"301";"579";"712";"135";"1";"3";"708";"711"
"8";"Barcelona";"1";"Barcelona";"21";"Maresme";"08219";"Vilassar de Mar";"3";"3";"U";"782";"230";"468";"620";"162";"0";"6";"614";"620"
"8";"Barcelona";"1";"Barcelona";"21";"Maresme";"08219";"Vilassar de Mar";"3";"4";"U";"714";"249";"461";"556";"158";"3";"5";"548";"553"
"8";"Barcelona";"1";"Barcelona";"3";"Alt Penedès";"08304";"Vilobí del Penedès";"1";"1";"U";"820";"315";"560";"698";"122";"3";"2";"693";"695"
"8";"Barcelona";"1";"Barcelona";"21";"Maresme";"08153";"Òrrius";"1";"1";"U";"533";"253";"392";"461";"72";"2";"4";"455";"459"
"8";"Barcelona";"2";"Catalunya Central";"7";"Bages";"08002";"Aguilar de Segarra";"1";"1";"U";"203";"65";"132";"164";"39";"0";"1";"163";"164"
"8";"Barcelona";"2";"Catalunya Central";"24";"Osona";"08004";"Alpens";"1";"1";"U";"234";"104";"175";"218";"16";"0";"0";"218";"218"
"8";"Barcelona";"2";"Catalunya Central";"6";"Anoia";"08008";"Argençola";"1";"1";"U";"188";"78";"119";"152";"36";"4";"1";"147";"148"
"8";"Barcelona";"2";"Catalunya Central";"7";"Bages";"08010";"Artés";"1";"1";"A";"466";"154";"298";"358";"108";"3";"1";"354";"355"
"8";"Barcelona";"2";"Catalunya Central";"7";"Bages";"08010";"Artés";"1";"1";"B";"582";"225";"396";"471";"111";"1";"1";"469";"470"
"8";"Barcelona";"2";"Catalunya Central";"7";"Bages";"08010";"Artés";"2";"1";"A";"526";"229";"350";"425";"101";"2";"5";"418";"423"
"8";"Barcelona";"2";"Catalunya Central";"7";"Bages";"08010";"Artés";"2";"1";"B";"654";"251";"450";"535";"119";"2";"2";"531";"533"
"8";"Barcelona";"2";"Catalunya Central";"7";"Bages";"08010";"Artés";"2";"2";"U";"689";"275";"468";"536";"153";"4";"4";"528";"532"
"8";"Barcelona";"2";"Catalunya Central";"7";"Bages";"08010";"Artés";"2";"3";"A";"587";"235";"428";"497";"90";"2";"4";"491";"495"
"8";"Barcelona";"2";"Catalunya Central";"7";"Bages";"08010";"Artés";"2";"3";"B";"694";"275";"481";"550";"144";"4";"3";"543";"546"
"8";"Barcelona";"2";"Catalunya Central";"7";"Bages";"08012";"Avinyó";"1";"1";"A";"624";"218";"432";"533";"91";"2";"11";"520";"531"
"8";"Barcelona";"2";"Catalunya Central";"7";"Bages";"08012";"Avinyó";"1";"1";"B";"515";"208";"364";"441";"74";"0";"5";"436";"441"
"8";"Barcelona";"2";"Catalunya Central";"7";"Bages";"08012";"Avinyó";"1";"1";"C";"535";"218";"397";"460";"75";"2";"2";"456";"458"
"8";"Barcelona";"2";"Catalunya Central";"14";"Berguedà";"08011";"Avià";"1";"1";"A";"858";"367";"617";"740";"118";"2";"7";"731";"738"
"8";"Barcelona";"2";"Catalunya Central";"14";"Berguedà";"08011";"Avià";"1";"1";"B";"898";"377";"671";"768";"130";"4";"3";"761";"764"
"8";"Barcelona";"2";"Catalunya Central";"14";"Berguedà";"08016";"Bagà";"1";"1";"A";"856";"346";"568";"700";"156";"5";"5";"690";"695"
"8";"Barcelona";"2";"Catalunya Central";"14";"Berguedà";"08016";"Bagà";"1";"1";"B";"968";"394";"669";"793";"175";"6";"5";"782";"787"
"8";"Barcelona";"2";"Catalunya Central";"24";"Osona";"08017";"Balenyà";"1";"1";"A";"687";"255";"467";"553";"134";"4";"3";"546";"549"
"8";"Barcelona";"2";"Catalunya Central";"24";"Osona";"08017";"Balenyà";"1";"1";"B";"564";"208";"386";"440";"124";"2";"3";"435";"438"
"8";"Barcelona";"2";"Catalunya Central";"24";"Osona";"08017";"Balenyà";"1";"1";"C";"712";"275";"515";"592";"120";"1";"1";"590";"591"
"8";"Barcelona";"2";"Catalunya Central";"24";"Osona";"08017";"Balenyà";"1";"2";"U";"792";"297";"571";"643";"149";"1";"2";"640";"642"
"8";"Barcelona";"2";"Catalunya Central";"7";"Bages";"08018";"Balsareny";"1";"1";"A";"423";"149";"264";"334";"89";"1";"0";"333";"333"
"8";"Barcelona";"2";"Catalunya Central";"7";"Bages";"08018";"Balsareny";"1";"1";"B";"442";"172";"291";"346";"96";"1";"5";"340";"345"
"8";"Barcelona";"2";"Catalunya Central";"7";"Bages";"08018";"Balsareny";"1";"1";"C";"427";"136";"265";"339";"88";"2";"3";"334";"337"
"8";"Barcelona";"2";"Catalunya Central";"7";"Bages";"08018";"Balsareny";"1";"2";"A";"505";"162";"303";"388";"117";"0";"5";"383";"388"
"8";"Barcelona";"2";"Catalunya Central";"7";"Bages";"08018";"Balsareny";"1";"2";"B";"507";"165";"365";"402";"105";"1";"0";"401";"401"
"8";"Barcelona";"2";"Catalunya Central";"7";"Bages";"08018";"Balsareny";"1";"3";"U";"347";"125";"215";"282";"65";"0";"2";"280";"282"
"8";"Barcelona";"2";"Catalunya Central";"6";"Anoia";"08021";"Bellprat";"1";"1";"U";"69";"31";"42";"57";"12";"0";"1";"56";"57"
"8";"Barcelona";"2";"Catalunya Central";"14";"Berguedà";"08022";"Berga";"1";"1";"A";"514";"215";"349";"419";"95";"0";"2";"417";"419"
"8";"Barcelona";"2";"Catalunya Central";"14";"Berguedà";"08022";"Berga";"1";"1";"B";"582";"228";"373";"426";"156";"3";"2";"421";"423"
"8";"Barcelona";"2";"Catalunya Central";"14";"Berguedà";"08022";"Berga";"1";"2";"A";"430";"182";"294";"324";"106";"2";"1";"321";"322"
"8";"Barcelona";"2";"Catalunya Central";"14";"Berguedà";"08022";"Berga";"1";"2";"B";"510";"243";"354";"387";"123";"1";"4";"382";"386"
"8";"Barcelona";"2";"Catalunya Central";"14";"Berguedà";"08022";"Berga";"1";"3";"U";"757";"342";"569";"649";"108";"0";"4";"645";"649"
"8";"Barcelona";"2";"Catalunya Central";"14";"Berguedà";"08022";"Berga";"1";"4";"A";"749";"342";"519";"603";"146";"1";"2";"600";"602"
"8";"Barcelona";"2";"Catalunya Central";"14";"Berguedà";"08022";"Berga";"1";"4";"B";"804";"358";"557";"639";"165";"6";"3";"630";"633"
"8";"Barcelona";"2";"Catalunya Central";"14";"Berguedà";"08022";"Berga";"1";"5";"A";"687";"309";"490";"547";"140";"1";"1";"545";"546"
"8";"Barcelona";"2";"Catalunya Central";"14";"Berguedà";"08022";"Berga";"1";"5";"B";"756";"327";"541";"626";"130";"2";"4";"620";"624"
"8";"Barcelona";"2";"Catalunya Central";"14";"Berguedà";"08022";"Berga";"1";"6";"A";"322";"124";"196";"234";"88";"0";"1";"233";"234"
"8";"Barcelona";"2";"Catalunya Central";"14";"Berguedà";"08022";"Berga";"1";"6";"B";"318";"138";"199";"237";"81";"1";"1";"235";"236"
"8";"Barcelona";"2";"Catalunya Central";"14";"Berguedà";"08022";"Berga";"2";"1";"A";"333";"139";"188";"215";"118";"4";"2";"209";"211"
"8";"Barcelona";"2";"Catalunya Central";"14";"Berguedà";"08022";"Berga";"2";"1";"B";"356";"110";"185";"227";"129";"2";"0";"225";"225"
"8";"Barcelona";"2";"Catalunya Central";"14";"Berguedà";"08022";"Berga";"2";"2";"U";"680";"235";"410";"466";"214";"2";"1";"463";"464"
"8";"Barcelona";"2";"Catalunya Central";"14";"Berguedà";"08022";"Berga";"2";"3";"A";"512";"232";"367";"418";"94";"1";"2";"415";"417"
"8";"Barcelona";"2";"Catalunya Central";"14";"Berguedà";"08022";"Berga";"2";"3";"B";"681";"315";"478";"549";"132";"3";"1";"545";"546"
"8";"Barcelona";"2";"Catalunya Central";"14";"Berguedà";"08022";"Berga";"2";"4";"A";"614";"258";"447";"505";"109";"1";"4";"500";"504"
"8";"Barcelona";"2";"Catalunya Central";"14";"Berguedà";"08022";"Berga";"2";"4";"B";"740";"311";"562";"620";"120";"1";"3";"616";"619"
"8";"Barcelona";"2";"Catalunya Central";"14";"Berguedà";"08022";"Berga";"2";"5";"A";"392";"160";"247";"269";"123";"0";"2";"267";"269"
"8";"Barcelona";"2";"Catalunya Central";"14";"Berguedà";"08022";"Berga";"2";"5";"B";"466";"182";"270";"302";"164";"2";"2";"298";"300"
"8";"Barcelona";"2";"Catalunya Central";"14";"Berguedà";"08022";"Berga";"3";"1";"A";"188";"87";"129";"147";"41";"0";"0";"147";"147"
"8";"Barcelona";"2";"Catalunya Central";"14";"Berguedà";"08022";"Berga";"3";"1";"B";"259";"144";"191";"228";"31";"0";"0";"228";"228"
"8";"Barcelona";"2";"Catalunya Central";"14";"Berguedà";"08022";"Berga";"4";"1";"U";"611";"251";"440";"501";"110";"1";"5";"495";"500"
"8";"Barcelona";"2";"Catalunya Central";"14";"Berguedà";"08024";"Borredà";"1";"1";"U";"386";"167";"262";"330";"56";"0";"2";"328";"330"
"8";"Barcelona";"2";"Catalunya Central";"6";"Anoia";"08025";"Bruc, el";"1";"1";"A";"673";"240";"440";"538";"135";"2";"1";"535";"536"
"8";"Barcelona";"2";"Catalunya Central";"6";"Anoia";"08025";"Bruc, el";"1";"1";"B";"813";"304";"540";"646";"167";"0";"2";"644";"646"
"8";"Barcelona";"2";"Catalunya Central";"24";"Osona";"08026";"Brull, el";"1";"1";"U";"188";"83";"137";"167";"21";"0";"0";"167";"167"
"8";"Barcelona";"2";"Catalunya Central";"6";"Anoia";"08028";"Cabrera d'Anoia";"1";"1";"U";"1038";"352";"626";"761";"277";"0";"2";"759";"761"
"8";"Barcelona";"2";"Catalunya Central";"6";"Anoia";"08031";"Calaf";"1";"1";"U";"471";"162";"301";"386";"85";"3";"1";"382";"383"
"8";"Barcelona";"2";"Catalunya Central";"6";"Anoia";"08031";"Calaf";"1";"2";"A";"627";"228";"409";"514";"113";"2";"6";"506";"512"
"8";"Barcelona";"2";"Catalunya Central";"6";"Anoia";"08031";"Calaf";"1";"2";"B";"537";"211";"350";"443";"94";"2";"5";"436";"441"
"8";"Barcelona";"2";"Catalunya Central";"6";"Anoia";"08031";"Calaf";"1";"2";"C";"669";"238";"452";"564";"105";"6";"2";"556";"558"
"8";"Barcelona";"2";"Catalunya Central";"42";"Moianès";"08034";"Calders";"1";"1";"U";"765";"342";"567";"634";"131";"1";"3";"630";"633"
"8";"Barcelona";"2";"Catalunya Central";"24";"Osona";"08037";"Calldetenes";"1";"1";"A";"724";"275";"490";"624";"100";"0";"4";"620";"624"
"8";"Barcelona";"2";"Catalunya Central";"24";"Osona";"08037";"Calldetenes";"1";"1";"B";"409";"238";"261";"334";"75";"0";"2";"332";"334"
"8";"Barcelona";"2";"Catalunya Central";"24";"Osona";"08037";"Calldetenes";"1";"1";"C";"718";"278";"501";"636";"82";"1";"6";"629";"635"
"8";"Barcelona";"2";"Catalunya Central";"7";"Bages";"08038";"Callús";"1";"1";"A";"658";"224";"444";"522";"136";"4";"9";"509";"518"
"8";"Barcelona";"2";"Catalunya Central";"7";"Bages";"08038";"Callús";"1";"1";"B";"817";"286";"550";"646";"171";"3";"4";"639";"643"
"8";"Barcelona";"2";"Catalunya Central";"6";"Anoia";"08036";"Calonge de Segarra";"1";"1";"U";"160";"62";"104";"132";"28";"0";"1";"131";"132"
"8";"Barcelona";"2";"Catalunya Central";"6";"Anoia";"08044";"Capellades";"1";"1";"A";"848";"311";"537";"660";"188";"4";"3";"653";"656"
"8";"Barcelona";"2";"Catalunya Central";"6";"Anoia";"08044";"Capellades";"1";"1";"B";"964";"331";"589";"740";"224";"4";"2";"734";"736"
"8";"Barcelona";"2";"Catalunya Central";"6";"Anoia";"08044";"Capellades";"2";"1";"A";"473";"183";"319";"389";"84";"0";"0";"389";"389"
"8";"Barcelona";"2";"Catalunya Central";"6";"Anoia";"08044";"Capellades";"2";"1";"B";"586";"233";"403";"475";"111";"1";"0";"474";"474"
"8";"Barcelona";"2";"Catalunya Central";"6";"Anoia";"08044";"Capellades";"2";"2";"A";"581";"198";"399";"484";"97";"1";"4";"479";"483"
"8";"Barcelona";"2";"Catalunya Central";"6";"Anoia";"08044";"Capellades";"2";"2";"B";"710";"238";"510";"593";"117";"2";"10";"581";"591"
"8";"Barcelona";"2";"Catalunya Central";"14";"Berguedà";"08045";"Capolat";"1";"1";"U";"72";"24";"45";"61";"11";"0";"0";"61";"61"
"8";"Barcelona";"2";"Catalunya Central";"7";"Bages";"08047";"Cardona";"1";"1";"U";"831";"318";"538";"649";"182";"3";"4";"642";"646"
"8";"Barcelona";"2";"Catalunya Central";"7";"Bages";"08047";"Cardona";"1";"2";"A";"696";"234";"412";"547";"149";"4";"4";"539";"543"
"8";"Barcelona";"2";"Catalunya Central";"7";"Bages";"08047";"Cardona";"1";"2";"B";"640";"228";"395";"483";"157";"3";"3";"477";"480"
"8";"Barcelona";"2";"Catalunya Central";"7";"Bages";"08047";"Cardona";"1";"3";"U";"815";"245";"464";"621";"194";"2";"10";"609";"619"
"8";"Barcelona";"2";"Catalunya Central";"7";"Bages";"08047";"Cardona";"2";"1";"A";"565";"201";"355";"429";"136";"1";"2";"426";"428"
"8";"Barcelona";"2";"Catalunya Central";"7";"Bages";"08047";"Cardona";"2";"1";"B";"444";"175";"263";"324";"120";"2";"4";"318";"322"
"8";"Barcelona";"2";"Catalunya Central";"6";"Anoia";"08048";"Carme";"1";"1";"U";"591";"211";"412";"498";"93";"0";"3";"495";"498"
"8";"Barcelona";"2";"Catalunya Central";"14";"Berguedà";"08049";"Casserres";"1";"1";"A";"538";"240";"390";"462";"76";"2";"2";"458";"460"
"8";"Barcelona";"2";"Catalunya Central";"14";"Berguedà";"08049";"Casserres";"1";"1";"B";"551";"245";"396";"468";"83";"5";"1";"462";"463"
"8";"Barcelona";"2";"Catalunya Central";"14";"Berguedà";"08049";"Casserres";"1";"1";"C";"205";"77";"141";"162";"43";"0";"0";"162";"162"
"8";"Barcelona";"2";"Catalunya Central";"14";"Berguedà";"08057";"Castell de l'Areny";"1";"1";"U";"60";"25";"30";"54";"6";"0";"1";"53";"54"
"8";"Barcelona";"2";"Catalunya Central";"14";"Berguedà";"08052";"Castellar de n'Hug";"1";"1";"U";"140";"50";"91";"122";"18";"0";"1";"121";"122"
"8";"Barcelona";"2";"Catalunya Central";"14";"Berguedà";"08050";"Castellar del Riu";"1";"1";"U";"143";"63";"100";"122";"21";"0";"1";"121";"122"
"8";"Barcelona";"2";"Catalunya Central";"7";"Bages";"08053";"Castellbell i el Vilar";"1";"1";"A";"625";"208";"421";"507";"118";"2";"0";"505";"505"
"8";"Barcelona";"2";"Catalunya Central";"7";"Bages";"08053";"Castellbell i el Vilar";"1";"1";"B";"795";"268";"534";"625";"170";"6";"3";"616";"619"
"8";"Barcelona";"2";"Catalunya Central";"7";"Bages";"08053";"Castellbell i el Vilar";"1";"2";"A";"650";"226";"383";"458";"192";"0";"3";"455";"458"
"8";"Barcelona";"2";"Catalunya Central";"7";"Bages";"08053";"Castellbell i el Vilar";"1";"2";"B";"727";"249";"427";"507";"220";"2";"5";"500";"505"
"8";"Barcelona";"1";"Barcelona";"42";"Moianès";"08055";"Castellcir";"1";"1";"U";"517";"218";"357";"423";"94";"0";"5";"418";"423"
"8";"Barcelona";"2";"Catalunya Central";"6";"Anoia";"08060";"Castellfollit de Riubregós";"1";"1";"U";"144";"55";"114";"133";"11";"4";"1";"128";"129"
"8";"Barcelona";"2";"Catalunya Central";"7";"Bages";"08059";"Castellfollit del Boix";"1";"1";"U";"341";"138";"236";"293";"48";"0";"0";"293";"293"
"8";"Barcelona";"2";"Catalunya Central";"7";"Bages";"08061";"Castellgalí";"1";"1";"A";"706";"262";"468";"547";"159";"6";"5";"536";"541"
"8";"Barcelona";"2";"Catalunya Central";"7";"Bages";"08061";"Castellgalí";"1";"1";"B";"779";"289";"522";"622";"157";"5";"9";"608";"617"
"8";"Barcelona";"2";"Catalunya Central";"7";"Bages";"08062";"Castellnou de Bages";"1";"1";"A";"404";"167";"274";"343";"61";"0";"2";"341";"343"
"8";"Barcelona";"2";"Catalunya Central";"7";"Bages";"08062";"Castellnou de Bages";"1";"1";"B";"539";"235";"373";"457";"82";"4";"2";"451";"453"
"8";"Barcelona";"2";"Catalunya Central";"6";"Anoia";"08063";"Castellolí";"1";"1";"U";"446";"173";"343";"405";"41";"0";"3";"402";"405"
"8";"Barcelona";"1";"Barcelona";"42";"Moianès";"08064";"Castellterçol";"1";"1";"A";"754";"274";"518";"626";"128";"3";"3";"620";"623"
"8";"Barcelona";"1";"Barcelona";"42";"Moianès";"08064";"Castellterçol";"1";"1";"B";"501";"144";"307";"377";"124";"0";"0";"377";"377"
"8";"Barcelona";"1";"Barcelona";"42";"Moianès";"08064";"Castellterçol";"1";"1";"C";"600";"247";"417";"509";"91";"1";"5";"503";"508"
"8";"Barcelona";"2";"Catalunya Central";"24";"Osona";"08067";"Centelles";"1";"1";"A";"630";"303";"455";"525";"105";"4";"3";"518";"521"
"8";"Barcelona";"2";"Catalunya Central";"24";"Osona";"08067";"Centelles";"1";"1";"B";"664";"273";"447";"553";"111";"1";"5";"547";"552"
"8";"Barcelona";"2";"Catalunya Central";"24";"Osona";"08067";"Centelles";"1";"2";"A";"529";"202";"354";"408";"121";"1";"4";"403";"407"
"8";"Barcelona";"2";"Catalunya Central";"24";"Osona";"08067";"Centelles";"1";"2";"B";"549";"251";"388";"462";"87";"2";"1";"459";"460"
"8";"Barcelona";"2";"Catalunya Central";"24";"Osona";"08067";"Centelles";"1";"3";"A";"600";"214";"361";"462";"138";"2";"2";"458";"460"
"8";"Barcelona";"2";"Catalunya Central";"24";"Osona";"08067";"Centelles";"1";"3";"B";"793";"333";"520";"656";"137";"0";"3";"653";"656"
"8";"Barcelona";"2";"Catalunya Central";"24";"Osona";"08067";"Centelles";"1";"4";"A";"746";"277";"473";"577";"169";"1";"5";"571";"576"
"8";"Barcelona";"2";"Catalunya Central";"24";"Osona";"08067";"Centelles";"1";"4";"B";"652";"247";"439";"542";"110";"0";"9";"533";"542"
"8";"Barcelona";"2";"Catalunya Central";"24";"Osona";"08067";"Centelles";"1";"4";"C";"551";"230";"374";"441";"110";"0";"3";"438";"441"
"8";"Barcelona";"2";"Catalunya Central";"14";"Berguedà";"08268";"Cercs";"1";"1";"A";"237";"95";"172";"187";"50";"1";"2";"184";"186"
"8";"Barcelona";"2";"Catalunya Central";"14";"Berguedà";"08268";"Cercs";"1";"1";"B";"234";"84";"141";"177";"57";"1";"0";"176";"176"
"8";"Barcelona";"2";"Catalunya Central";"14";"Berguedà";"08268";"Cercs";"1";"2";"U";"543";"246";"406";"464";"79";"1";"4";"459";"463"
"8";"Barcelona";"2";"Catalunya Central";"42";"Moianès";"08070";"Collsuspina";"1";"1";"U";"264";"134";"199";"234";"30";"1";"6";"227";"233"
"8";"Barcelona";"2";"Catalunya Central";"6";"Anoia";"08071";"Copons";"1";"1";"U";"240";"95";"167";"210";"30";"2";"1";"207";"208"
"8";"Barcelona";"2";"Catalunya Central";"14";"Berguedà";"08078";"Espunyola, l'";"1";"1";"U";"219";"65";"131";"180";"39";"1";"1";"178";"179"
"8";"Barcelona";"2";"Catalunya Central";"24";"Osona";"08254";"Esquirol, l'";"1";"1";"A";"610";"278";"450";"546";"64";"0";"0";"546";"546"
"8";"Barcelona";"2";"Catalunya Central";"24";"Osona";"08254";"Esquirol, l'";"1";"1";"B";"679";"301";"526";"618";"61";"0";"4";"614";"618"
"8";"Barcelona";"2";"Catalunya Central";"24";"Osona";"08254";"Esquirol, l'";"1";"1";"C";"146";"58";"100";"119";"27";"2";"4";"113";"117"
"8";"Barcelona";"2";"Catalunya Central";"24";"Osona";"08254";"Esquirol, l'";"1";"1";"D";"313";"172";"246";"279";"34";"1";"1";"277";"278"
"8";"Barcelona";"2";"Catalunya Central";"42";"Moianès";"08079";"Estany, l'";"1";"1";"U";"340";"173";"279";"306";"34";"0";"3";"303";"306"
"8";"Barcelona";"2";"Catalunya Central";"24";"Osona";"08083";"Folgueroles";"1";"1";"A";"805";"369";"636";"736";"69";"0";"3";"733";"736"
"8";"Barcelona";"2";"Catalunya Central";"24";"Osona";"08083";"Folgueroles";"1";"1";"B";"854";"414";"694";"791";"63";"2";"6";"783";"789"
"8";"Barcelona";"2";"Catalunya Central";"7";"Bages";"08084";"Fonollosa";"1";"1";"A";"279";"120";"213";"260";"19";"0";"3";"257";"260"
"8";"Barcelona";"2";"Catalunya Central";"7";"Bages";"08084";"Fonollosa";"1";"1";"B";"265";"122";"194";"237";"28";"0";"0";"237";"237"
"8";"Barcelona";"2";"Catalunya Central";"7";"Bages";"08084";"Fonollosa";"1";"1";"C";"593";"213";"380";"456";"137";"1";"2";"453";"455"
"8";"Barcelona";"2";"Catalunya Central";"14";"Berguedà";"08080";"Fígols";"1";"1";"U";"36";"14";"22";"30";"6";"0";"1";"29";"30"
"8";"Barcelona";"2";"Catalunya Central";"7";"Bages";"08090";"Gaià";"1";"1";"U";"129";"58";"96";"112";"17";"0";"1";"111";"112"
"8";"Barcelona";"2";"Catalunya Central";"14";"Berguedà";"08092";"Gironella";"1";"1";"A";"583";"261";"399";"475";"108";"2";"1";"472";"473"
"8";"Barcelona";"2";"Catalunya Central";"14";"Berguedà";"08092";"Gironella";"1";"1";"B";"703";"317";"492";"573";"130";"1";"6";"566";"572"
"8";"Barcelona";"2";"Catalunya Central";"14";"Berguedà";"08092";"Gironella";"2";"1";"U";"348";"145";"214";"260";"88";"3";"1";"256";"257"
"8";"Barcelona";"2";"Catalunya Central";"14";"Berguedà";"08092";"Gironella";"2";"2";"A";"506";"250";"375";"431";"75";"3";"2";"426";"428"
"8";"Barcelona";"2";"Catalunya Central";"14";"Berguedà";"08092";"Gironella";"2";"2";"B";"595";"249";"436";"490";"105";"6";"1";"483";"484"
"8";"Barcelona";"2";"Catalunya Central";"14";"Berguedà";"08092";"Gironella";"2";"3";"A";"488";"189";"338";"398";"90";"5";"3";"390";"393"
"8";"Barcelona";"2";"Catalunya Central";"14";"Berguedà";"08092";"Gironella";"2";"3";"B";"553";"225";"370";"452";"101";"2";"2";"448";"450"
"8";"Barcelona";"2";"Catalunya Central";"14";"Berguedà";"08093";"Gisclareny";"1";"1";"U";"26";"9";"15";"23";"3";"0";"0";"23";"23"
"8";"Barcelona";"1";"Barcelona";"42";"Moianès";"08095";"Granera";"1";"1";"U";"72";"31";"52";"58";"14";"0";"0";"58";"58"
"8";"Barcelona";"2";"Catalunya Central";"14";"Berguedà";"08099";"Guardiola de Berguedà";"1";"1";"U";"753";"310";"498";"595";"158";"3";"6";"586";"592"
"8";"Barcelona";"2";"Catalunya Central";"24";"Osona";"08100";"Gurb";"1";"1";"A";"750";"280";"565";"671";"79";"0";"9";"662";"671"
"8";"Barcelona";"2";"Catalunya Central";"24";"Osona";"08100";"Gurb";"1";"1";"B";"649";"261";"488";"581";"68";"0";"3";"578";"581"
"8";"Barcelona";"2";"Catalunya Central";"24";"Osona";"08100";"Gurb";"1";"1";"C";"589";"208";"434";"525";"64";"0";"3";"522";"525"
"8";"Barcelona";"2";"Catalunya Central";"6";"Anoia";"08162";"Hostalets de Pierola, els";"1";"1";"A";"726";"267";"494";"595";"131";"8";"2";"585";"587"
"8";"Barcelona";"2";"Catalunya Central";"6";"Anoia";"08162";"Hostalets de Pierola, els";"1";"1";"B";"770";"266";"500";"627";"143";"1";"3";"623";"626"
"8";"Barcelona";"2";"Catalunya Central";"6";"Anoia";"08162";"Hostalets de Pierola, els";"1";"1";"C";"519";"204";"311";"385";"134";"3";"3";"379";"382"
"8";"Barcelona";"2";"Catalunya Central";"6";"Anoia";"08102";"Igualada";"1";"1";"A";"491";"172";"273";"332";"159";"0";"3";"329";"332"
"8";"Barcelona";"2";"Catalunya Central";"6";"Anoia";"08102";"Igualada";"1";"1";"B";"694";"246";"420";"490";"204";"1";"2";"487";"489"
"8";"Barcelona";"2";"Catalunya Central";"6";"Anoia";"08102";"Igualada";"2";"1";"U";"522";"215";"367";"431";"91";"0";"2";"429";"431"
"8";"Barcelona";"2";"Catalunya Central";"6";"Anoia";"08102";"Igualada";"2";"2";"U";"876";"295";"575";"680";"196";"1";"5";"674";"679"
"8";"Barcelona";"2";"Catalunya Central";"6";"Anoia";"08102";"Igualada";"2";"3";"A";"633";"231";"425";"505";"128";"0";"0";"505";"505"
"8";"Barcelona";"2";"Catalunya Central";"6";"Anoia";"08102";"Igualada";"2";"3";"B";"619";"249";"430";"494";"125";"1";"1";"492";"493"
"8";"Barcelona";"2";"Catalunya Central";"6";"Anoia";"08102";"Igualada";"3";"1";"U";"891";"266";"548";"650";"241";"5";"3";"642";"645"
"8";"Barcelona";"2";"Catalunya Central";"6";"Anoia";"08102";"Igualada";"3";"10";"A";"522";"212";"361";"441";"81";"1";"4";"436";"440"
"8";"Barcelona";"2";"Catalunya Central";"6";"Anoia";"08102";"Igualada";"3";"10";"B";"626";"225";"426";"542";"84";"0";"4";"538";"542"
"8";"Barcelona";"2";"Catalunya Central";"6";"Anoia";"08102";"Igualada";"3";"2";"A";"667";"184";"440";"528";"139";"0";"5";"523";"528"
"8";"Barcelona";"2";"Catalunya Central";"6";"Anoia";"08102";"Igualada";"3";"2";"B";"742";"234";"516";"618";"124";"1";"3";"614";"617"
"8";"Barcelona";"2";"Catalunya Central";"6";"Anoia";"08102";"Igualada";"3";"3";"A";"435";"192";"311";"361";"74";"3";"1";"357";"358"
"8";"Barcelona";"2";"Catalunya Central";"6";"Anoia";"08102";"Igualada";"3";"3";"B";"532";"230";"311";"422";"110";"2";"3";"417";"420"
"8";"Barcelona";"2";"Catalunya Central";"6";"Anoia";"08102";"Igualada";"3";"4";"A";"728";"254";"459";"554";"174";"6";"4";"544";"548"
"8";"Barcelona";"2";"Catalunya Central";"6";"Anoia";"08102";"Igualada";"3";"4";"B";"847";"326";"582";"686";"161";"3";"3";"680";"683"
"8";"Barcelona";"2";"Catalunya Central";"6";"Anoia";"08102";"Igualada";"3";"5";"A";"368";"145";"233";"275";"93";"0";"2";"273";"275"
"8";"Barcelona";"2";"Catalunya Central";"6";"Anoia";"08102";"Igualada";"3";"5";"B";"413";"189";"293";"327";"86";"1";"0";"326";"326"
"8";"Barcelona";"2";"Catalunya Central";"6";"Anoia";"08102";"Igualada";"3";"6";"A";"619";"324";"480";"521";"98";"0";"3";"518";"521"
"8";"Barcelona";"2";"Catalunya Central";"6";"Anoia";"08102";"Igualada";"3";"6";"B";"769";"306";"536";"666";"103";"0";"4";"662";"666"
"8";"Barcelona";"2";"Catalunya Central";"6";"Anoia";"08102";"Igualada";"3";"7";"A";"818";"315";"608";"689";"129";"0";"3";"686";"689"
"8";"Barcelona";"2";"Catalunya Central";"6";"Anoia";"08102";"Igualada";"3";"7";"B";"900";"301";"619";"763";"137";"3";"2";"758";"760"
"8";"Barcelona";"2";"Catalunya Central";"6";"Anoia";"08102";"Igualada";"3";"8";"A";"505";"171";"318";"389";"116";"1";"0";"388";"388"
"8";"Barcelona";"2";"Catalunya Central";"6";"Anoia";"08102";"Igualada";"3";"8";"B";"563";"213";"385";"463";"100";"1";"3";"459";"462"
"8";"Barcelona";"2";"Catalunya Central";"6";"Anoia";"08102";"Igualada";"3";"9";"A";"572";"215";"406";"495";"77";"2";"2";"491";"493"
"8";"Barcelona";"2";"Catalunya Central";"6";"Anoia";"08102";"Igualada";"3";"9";"B";"651";"248";"466";"562";"89";"2";"4";"556";"560"
"8";"Barcelona";"2";"Catalunya Central";"6";"Anoia";"08102";"Igualada";"4";"1";"U";"687";"293";"469";"532";"155";"2";"1";"529";"530"
"8";"Barcelona";"2";"Catalunya Central";"6";"Anoia";"08102";"Igualada";"4";"2";"U";"723";"313";"486";"561";"162";"1";"6";"554";"560"
"8";"Barcelona";"2";"Catalunya Central";"6";"Anoia";"08102";"Igualada";"4";"3";"U";"798";"340";"560";"625";"173";"2";"5";"618";"623"
"8";"Barcelona";"2";"Catalunya Central";"6";"Anoia";"08102";"Igualada";"4";"4";"A";"429";"166";"297";"348";"81";"0";"4";"344";"348"
"8";"Barcelona";"2";"Catalunya Central";"6";"Anoia";"08102";"Igualada";"4";"4";"B";"452";"187";"306";"362";"90";"0";"1";"361";"362"
"8";"Barcelona";"2";"Catalunya Central";"6";"Anoia";"08102";"Igualada";"4";"5";"A";"575";"219";"361";"448";"127";"1";"1";"446";"447"
"8";"Barcelona";"2";"Catalunya Central";"6";"Anoia";"08102";"Igualada";"4";"5";"B";"690";"240";"457";"571";"119";"3";"2";"566";"568"
"8";"Barcelona";"2";"Catalunya Central";"6";"Anoia";"08102";"Igualada";"5";"1";"A";"525";"229";"351";"422";"103";"3";"5";"414";"419"
"8";"Barcelona";"2";"Catalunya Central";"6";"Anoia";"08102";"Igualada";"5";"1";"B";"573";"237";"386";"448";"125";"3";"5";"440";"445"
"8";"Barcelona";"2";"Catalunya Central";"6";"Anoia";"08102";"Igualada";"5";"2";"A";"539";"198";"334";"403";"136";"0";"1";"402";"403"
"8";"Barcelona";"2";"Catalunya Central";"6";"Anoia";"08102";"Igualada";"5";"2";"B";"688";"265";"436";"510";"178";"3";"4";"503";"507"
"8";"Barcelona";"2";"Catalunya Central";"6";"Anoia";"08102";"Igualada";"5";"3";"A";"639";"254";"436";"504";"135";"0";"4";"500";"504"
"8";"Barcelona";"2";"Catalunya Central";"6";"Anoia";"08102";"Igualada";"5";"3";"B";"846";"367";"589";"683";"163";"6";"5";"672";"677"
"8";"Barcelona";"2";"Catalunya Central";"6";"Anoia";"08102";"Igualada";"5";"4";"A";"547";"243";"392";"456";"91";"1";"3";"452";"455"
"8";"Barcelona";"2";"Catalunya Central";"6";"Anoia";"08102";"Igualada";"5";"4";"B";"609";"240";"419";"494";"115";"0";"4";"490";"494"
"8";"Barcelona";"2";"Catalunya Central";"6";"Anoia";"08102";"Igualada";"5";"5";"U";"502";"199";"288";"342";"160";"2";"5";"335";"340"
"8";"Barcelona";"2";"Catalunya Central";"6";"Anoia";"08102";"Igualada";"5";"6";"A";"318";"122";"173";"206";"112";"1";"0";"205";"205"
"8";"Barcelona";"2";"Catalunya Central";"6";"Anoia";"08102";"Igualada";"5";"6";"B";"297";"114";"165";"187";"110";"2";"0";"185";"185"
"8";"Barcelona";"2";"Catalunya Central";"6";"Anoia";"08102";"Igualada";"5";"7";"A";"830";"261";"523";"664";"166";"1";"3";"660";"663"
"8";"Barcelona";"2";"Catalunya Central";"6";"Anoia";"08102";"Igualada";"5";"7";"B";"1001";"304";"658";"821";"180";"0";"9";"812";"821"
"8";"Barcelona";"2";"Catalunya Central";"6";"Anoia";"08103";"Jorba";"1";"1";"U";"635";"225";"420";"520";"115";"5";"5";"510";"515"
"8";"Barcelona";"2";"Catalunya Central";"6";"Anoia";"08104";"Llacuna, la";"1";"1";"U";"685";"276";"503";"578";"107";"0";"8";"570";"578"
"8";"Barcelona";"2";"Catalunya Central";"24";"Osona";"08109";"Lluçà";"1";"1";"U";"213";"93";"158";"192";"21";"0";"0";"192";"192"
"8";"Barcelona";"2";"Catalunya Central";"24";"Osona";"08111";"Malla";"1";"1";"U";"217";"99";"162";"201";"16";"0";"0";"201";"201"
"8";"Barcelona";"2";"Catalunya Central";"24";"Osona";"08112";"Manlleu";"1";"1";"A";"638";"278";"442";"521";"117";"1";"1";"519";"520"
"8";"Barcelona";"2";"Catalunya Central";"24";"Osona";"08112";"Manlleu";"1";"1";"B";"742";"337";"510";"605";"137";"2";"0";"603";"603"
"8";"Barcelona";"2";"Catalunya Central";"24";"Osona";"08112";"Manlleu";"1";"2";"U";"626";"222";"420";"505";"121";"0";"4";"501";"505"
"8";"Barcelona";"2";"Catalunya Central";"24";"Osona";"08112";"Manlleu";"2";"1";"A";"589";"243";"411";"474";"115";"3";"0";"471";"471"
"8";"Barcelona";"2";"Catalunya Central";"24";"Osona";"08112";"Manlleu";"2";"1";"B";"638";"278";"462";"547";"91";"0";"5";"542";"547"
"8";"Barcelona";"2";"Catalunya Central";"24";"Osona";"08112";"Manlleu";"2";"2";"A";"580";"216";"380";"454";"126";"1";"2";"451";"453"
"8";"Barcelona";"2";"Catalunya Central";"24";"Osona";"08112";"Manlleu";"2";"2";"B";"657";"265";"439";"510";"147";"2";"5";"503";"508"
"8";"Barcelona";"2";"Catalunya Central";"24";"Osona";"08112";"Manlleu";"2";"3";"A";"378";"168";"256";"294";"84";"2";"1";"291";"292"
"8";"Barcelona";"2";"Catalunya Central";"24";"Osona";"08112";"Manlleu";"2";"3";"B";"402";"201";"295";"336";"66";"1";"1";"334";"335"
"8";"Barcelona";"2";"Catalunya Central";"24";"Osona";"08112";"Manlleu";"2";"4";"A";"495";"170";"309";"363";"132";"1";"0";"362";"362"
"8";"Barcelona";"2";"Catalunya Central";"24";"Osona";"08112";"Manlleu";"2";"4";"B";"484";"190";"331";"375";"109";"0";"1";"374";"375"
"8";"Barcelona";"2";"Catalunya Central";"24";"Osona";"08112";"Manlleu";"3";"1";"A";"556";"165";"339";"415";"141";"2";"4";"409";"413"
"8";"Barcelona";"2";"Catalunya Central";"24";"Osona";"08112";"Manlleu";"3";"1";"B";"549";"188";"360";"422";"127";"3";"5";"414";"419"
"8";"Barcelona";"2";"Catalunya Central";"24";"Osona";"08112";"Manlleu";"3";"2";"A";"648";"239";"415";"497";"151";"2";"4";"491";"495"
"8";"Barcelona";"2";"Catalunya Central";"24";"Osona";"08112";"Manlleu";"3";"2";"B";"683";"274";"462";"553";"130";"4";"2";"547";"549"
"8";"Barcelona";"2";"Catalunya Central";"24";"Osona";"08112";"Manlleu";"3";"3";"A";"578";"194";"330";"378";"200";"0";"2";"376";"378"
"8";"Barcelona";"2";"Catalunya Central";"24";"Osona";"08112";"Manlleu";"3";"3";"B";"540";"221";"357";"412";"128";"1";"5";"406";"411"
"8";"Barcelona";"2";"Catalunya Central";"24";"Osona";"08112";"Manlleu";"3";"4";"A";"573";"204";"389";"454";"119";"0";"5";"449";"454"
"8";"Barcelona";"2";"Catalunya Central";"24";"Osona";"08112";"Manlleu";"3";"4";"B";"582";"192";"380";"462";"120";"2";"7";"453";"460"
"8";"Barcelona";"2";"Catalunya Central";"24";"Osona";"08112";"Manlleu";"4";"1";"U";"616";"231";"416";"485";"131";"0";"4";"481";"485"
"8";"Barcelona";"2";"Catalunya Central";"24";"Osona";"08112";"Manlleu";"4";"2";"A";"644";"258";"454";"523";"121";"2";"4";"517";"521"
"8";"Barcelona";"2";"Catalunya Central";"24";"Osona";"08112";"Manlleu";"4";"2";"B";"738";"315";"522";"600";"138";"0";"1";"599";"600"
"8";"Barcelona";"2";"Catalunya Central";"7";"Bages";"08113";"Manresa";"1";"1";"U";"553";"205";"312";"365";"188";"1";"1";"363";"364"
"8";"Barcelona";"2";"Catalunya Central";"7";"Bages";"08113";"Manresa";"1";"2";"U";"519";"178";"292";"335";"184";"0";"3";"332";"335"
"8";"Barcelona";"2";"Catalunya Central";"7";"Bages";"08113";"Manresa";"2";"1";"U";"620";"257";"425";"503";"117";"0";"2";"501";"503"
"8";"Barcelona";"2";"Catalunya Central";"7";"Bages";"08113";"Manresa";"2";"10";"A";"598";"231";"386";"468";"130";"1";"1";"466";"467"
"8";"Barcelona";"2";"Catalunya Central";"7";"Bages";"08113";"Manresa";"2";"10";"B";"713";"276";"513";"599";"114";"3";"1";"595";"596"
"8";"Barcelona";"2";"Catalunya Central";"7";"Bages";"08113";"Manresa";"2";"11";"A";"622";"232";"429";"503";"119";"0";"3";"500";"503"
"8";"Barcelona";"2";"Catalunya Central";"7";"Bages";"08113";"Manresa";"2";"11";"B";"714";"282";"480";"576";"138";"4";"2";"570";"572"
"8";"Barcelona";"2";"Catalunya Central";"7";"Bages";"08113";"Manresa";"2";"12";"A";"502";"213";"352";"425";"77";"0";"2";"423";"425"
"8";"Barcelona";"2";"Catalunya Central";"7";"Bages";"08113";"Manresa";"2";"12";"B";"566";"209";"375";"484";"82";"1";"1";"482";"483"
"8";"Barcelona";"2";"Catalunya Central";"7";"Bages";"08113";"Manresa";"2";"13";"A";"439";"159";"286";"339";"100";"0";"0";"339";"339"
"8";"Barcelona";"2";"Catalunya Central";"7";"Bages";"08113";"Manresa";"2";"13";"B";"537";"209";"375";"434";"103";"1";"3";"430";"433"
"8";"Barcelona";"2";"Catalunya Central";"7";"Bages";"08113";"Manresa";"2";"14";"U";"709";"246";"437";"541";"168";"2";"3";"536";"539"
"8";"Barcelona";"2";"Catalunya Central";"7";"Bages";"08113";"Manresa";"2";"2";"A";"698";"261";"488";"585";"113";"2";"1";"582";"583"
"8";"Barcelona";"2";"Catalunya Central";"7";"Bages";"08113";"Manresa";"2";"2";"B";"862";"353";"608";"702";"160";"1";"6";"695";"701"
"8";"Barcelona";"2";"Catalunya Central";"7";"Bages";"08113";"Manresa";"2";"3";"A";"623";"246";"424";"507";"116";"1";"2";"504";"506"
"8";"Barcelona";"2";"Catalunya Central";"7";"Bages";"08113";"Manresa";"2";"3";"B";"781";"273";"537";"635";"146";"5";"4";"626";"630"
"8";"Barcelona";"2";"Catalunya Central";"7";"Bages";"08113";"Manresa";"2";"4";"A";"685";"243";"467";"554";"131";"5";"2";"547";"549"
"8";"Barcelona";"2";"Catalunya Central";"7";"Bages";"08113";"Manresa";"2";"4";"B";"829";"283";"573";"682";"147";"1";"1";"680";"681"
"8";"Barcelona";"2";"Catalunya Central";"7";"Bages";"08113";"Manresa";"2";"5";"A";"707";"254";"445";"538";"169";"1";"3";"534";"537"
"8";"Barcelona";"2";"Catalunya Central";"7";"Bages";"08113";"Manresa";"2";"5";"B";"859";"346";"563";"675";"184";"2";"5";"668";"673"
"8";"Barcelona";"2";"Catalunya Central";"7";"Bages";"08113";"Manresa";"2";"6";"U";"569";"194";"358";"420";"149";"0";"3";"417";"420"
"8";"Barcelona";"2";"Catalunya Central";"7";"Bages";"08113";"Manresa";"2";"7";"A";"438";"185";"272";"331";"107";"3";"5";"323";"328"
"8";"Barcelona";"2";"Catalunya Central";"7";"Bages";"08113";"Manresa";"2";"7";"B";"606";"227";"386";"466";"140";"2";"1";"463";"464"
"8";"Barcelona";"2";"Catalunya Central";"7";"Bages";"08113";"Manresa";"2";"8";"U";"653";"256";"408";"492";"161";"1";"3";"488";"491"
"8";"Barcelona";"2";"Catalunya Central";"7";"Bages";"08113";"Manresa";"2";"9";"A";"570";"197";"345";"413";"157";"2";"1";"410";"411"
"8";"Barcelona";"2";"Catalunya Central";"7";"Bages";"08113";"Manresa";"2";"9";"B";"628";"247";"412";"491";"137";"1";"8";"482";"490"
"8";"Barcelona";"2";"Catalunya Central";"7";"Bages";"08113";"Manresa";"3";"1";"U";"602";"229";"362";"422";"180";"0";"2";"420";"422"
"8";"Barcelona";"2";"Catalunya Central";"7";"Bages";"08113";"Manresa";"3";"2";"U";"600";"213";"350";"400";"200";"1";"0";"399";"399"
"8";"Barcelona";"2";"Catalunya Central";"7";"Bages";"08113";"Manresa";"3";"4";"A";"417";"145";"254";"309";"108";"4";"2";"303";"305"
"8";"Barcelona";"2";"Catalunya Central";"7";"Bages";"08113";"Manresa";"3";"4";"B";"507";"162";"297";"336";"171";"3";"2";"331";"333"
"8";"Barcelona";"2";"Catalunya Central";"7";"Bages";"08113";"Manresa";"3";"5";"A";"668";"232";"422";"515";"153";"1";"5";"509";"514"
"8";"Barcelona";"2";"Catalunya Central";"7";"Bages";"08113";"Manresa";"3";"5";"B";"758";"240";"461";"593";"165";"7";"2";"584";"586"
"8";"Barcelona";"2";"Catalunya Central";"7";"Bages";"08113";"Manresa";"3";"6";"U";"721";"290";"461";"555";"166";"3";"0";"552";"552"
"8";"Barcelona";"2";"Catalunya Central";"7";"Bages";"08113";"Manresa";"4";"1";"A";"617";"227";"387";"440";"177";"3";"5";"432";"437"
"8";"Barcelona";"2";"Catalunya Central";"7";"Bages";"08113";"Manresa";"4";"1";"B";"701";"286";"441";"497";"204";"5";"2";"490";"492"
"8";"Barcelona";"2";"Catalunya Central";"7";"Bages";"08113";"Manresa";"4";"11";"U";"656";"240";"421";"490";"166";"1";"0";"489";"489"
"8";"Barcelona";"2";"Catalunya Central";"7";"Bages";"08113";"Manresa";"4";"12";"U";"499";"180";"315";"383";"116";"4";"1";"378";"379"
"8";"Barcelona";"2";"Catalunya Central";"7";"Bages";"08113";"Manresa";"4";"13";"A";"500";"190";"350";"408";"92";"2";"3";"403";"406"
"8";"Barcelona";"2";"Catalunya Central";"7";"Bages";"08113";"Manresa";"4";"13";"B";"570";"243";"407";"474";"96";"1";"2";"471";"473"
"8";"Barcelona";"2";"Catalunya Central";"7";"Bages";"08113";"Manresa";"4";"14";"A";"578";"250";"410";"495";"83";"2";"4";"489";"493"
"8";"Barcelona";"2";"Catalunya Central";"7";"Bages";"08113";"Manresa";"4";"14";"B";"728";"290";"508";"601";"127";"0";"0";"601";"601"
"8";"Barcelona";"2";"Catalunya Central";"7";"Bages";"08113";"Manresa";"4";"15";"A";"779";"276";"520";"634";"145";"3";"2";"629";"631"
"8";"Barcelona";"2";"Catalunya Central";"7";"Bages";"08113";"Manresa";"4";"15";"B";"894";"316";"628";"745";"149";"2";"6";"737";"743"
"8";"Barcelona";"2";"Catalunya Central";"7";"Bages";"08113";"Manresa";"4";"3";"U";"603";"227";"390";"464";"139";"1";"2";"461";"463"
"8";"Barcelona";"2";"Catalunya Central";"7";"Bages";"08113";"Manresa";"4";"4";"A";"594";"255";"418";"477";"117";"2";"2";"473";"475"
"8";"Barcelona";"2";"Catalunya Central";"7";"Bages";"08113";"Manresa";"4";"4";"B";"735";"270";"497";"600";"135";"1";"1";"598";"599"
"8";"Barcelona";"2";"Catalunya Central";"7";"Bages";"08113";"Manresa";"4";"5";"A";"530";"220";"373";"440";"90";"1";"4";"435";"439"
"8";"Barcelona";"2";"Catalunya Central";"7";"Bages";"08113";"Manresa";"4";"5";"B";"594";"237";"395";"473";"121";"2";"2";"469";"471"
"8";"Barcelona";"2";"Catalunya Central";"7";"Bages";"08113";"Manresa";"4";"6";"A";"542";"203";"345";"404";"138";"0";"0";"404";"404"
"8";"Barcelona";"2";"Catalunya Central";"7";"Bages";"08113";"Manresa";"4";"6";"B";"664";"268";"434";"505";"159";"1";"2";"502";"504"
"8";"Barcelona";"2";"Catalunya Central";"7";"Bages";"08113";"Manresa";"4";"7";"A";"674";"253";"430";"512";"162";"1";"4";"507";"511"
"8";"Barcelona";"2";"Catalunya Central";"7";"Bages";"08113";"Manresa";"4";"7";"B";"848";"312";"555";"657";"191";"2";"3";"652";"655"
"8";"Barcelona";"2";"Catalunya Central";"7";"Bages";"08113";"Manresa";"4";"8";"A";"524";"191";"358";"427";"97";"0";"2";"425";"427"
"8";"Barcelona";"2";"Catalunya Central";"7";"Bages";"08113";"Manresa";"4";"8";"B";"606";"228";"429";"490";"116";"0";"1";"489";"490"
"8";"Barcelona";"2";"Catalunya Central";"7";"Bages";"08113";"Manresa";"4";"9";"A";"527";"199";"333";"391";"136";"0";"10";"381";"391"
"8";"Barcelona";"2";"Catalunya Central";"7";"Bages";"08113";"Manresa";"4";"9";"B";"645";"242";"427";"503";"142";"0";"4";"499";"503"
"8";"Barcelona";"2";"Catalunya Central";"7";"Bages";"08113";"Manresa";"5";"1";"U";"701";"215";"384";"466";"235";"6";"3";"457";"460"
"8";"Barcelona";"2";"Catalunya Central";"7";"Bages";"08113";"Manresa";"5";"10";"A";"482";"182";"295";"338";"144";"2";"4";"332";"336"
"8";"Barcelona";"2";"Catalunya Central";"7";"Bages";"08113";"Manresa";"5";"10";"B";"618";"231";"368";"436";"182";"0";"3";"433";"436"
"8";"Barcelona";"2";"Catalunya Central";"7";"Bages";"08113";"Manresa";"5";"11";"A";"541";"161";"311";"390";"151";"4";"2";"384";"386"
"8";"Barcelona";"2";"Catalunya Central";"7";"Bages";"08113";"Manresa";"5";"11";"B";"671";"228";"433";"516";"155";"0";"0";"516";"516"
"8";"Barcelona";"2";"Catalunya Central";"7";"Bages";"08113";"Manresa";"5";"12";"U";"659";"243";"398";"481";"178";"0";"2";"479";"481"
"8";"Barcelona";"2";"Catalunya Central";"7";"Bages";"08113";"Manresa";"5";"13";"U";"746";"295";"502";"582";"164";"2";"6";"574";"580"
"8";"Barcelona";"2";"Catalunya Central";"7";"Bages";"08113";"Manresa";"5";"14";"A";"603";"247";"384";"472";"131";"2";"0";"470";"470"
"8";"Barcelona";"2";"Catalunya Central";"7";"Bages";"08113";"Manresa";"5";"14";"B";"710";"259";"478";"568";"142";"6";"3";"559";"562"
"8";"Barcelona";"2";"Catalunya Central";"7";"Bages";"08113";"Manresa";"5";"15";"A";"441";"148";"258";"320";"121";"0";"5";"315";"320"
"8";"Barcelona";"2";"Catalunya Central";"7";"Bages";"08113";"Manresa";"5";"15";"B";"498";"175";"301";"363";"135";"2";"2";"359";"361"
"8";"Barcelona";"2";"Catalunya Central";"7";"Bages";"08113";"Manresa";"5";"17";"A";"531";"198";"377";"441";"90";"0";"3";"438";"441"
"8";"Barcelona";"2";"Catalunya Central";"7";"Bages";"08113";"Manresa";"5";"17";"B";"772";"259";"531";"646";"126";"0";"2";"644";"646"
"8";"Barcelona";"2";"Catalunya Central";"7";"Bages";"08113";"Manresa";"5";"18";"U";"719";"238";"430";"540";"179";"3";"5";"532";"537"
"8";"Barcelona";"2";"Catalunya Central";"7";"Bages";"08113";"Manresa";"5";"2";"U";"883";"254";"466";"556";"327";"2";"6";"548";"554"
"8";"Barcelona";"2";"Catalunya Central";"7";"Bages";"08113";"Manresa";"5";"3";"A";"478";"147";"321";"371";"107";"5";"2";"364";"366"
"8";"Barcelona";"2";"Catalunya Central";"7";"Bages";"08113";"Manresa";"5";"3";"B";"577";"183";"356";"431";"146";"2";"4";"425";"429"
"8";"Barcelona";"2";"Catalunya Central";"7";"Bages";"08113";"Manresa";"5";"4";"U";"662";"244";"420";"504";"158";"3";"4";"497";"501"
"8";"Barcelona";"2";"Catalunya Central";"7";"Bages";"08113";"Manresa";"5";"5";"A";"685";"253";"410";"491";"194";"4";"1";"486";"487"
"8";"Barcelona";"2";"Catalunya Central";"7";"Bages";"08113";"Manresa";"5";"5";"B";"759";"269";"484";"569";"190";"5";"2";"562";"564"
"8";"Barcelona";"2";"Catalunya Central";"7";"Bages";"08113";"Manresa";"5";"6";"A";"563";"190";"346";"407";"156";"0";"1";"406";"407"
"8";"Barcelona";"2";"Catalunya Central";"7";"Bages";"08113";"Manresa";"5";"6";"B";"673";"246";"455";"518";"155";"2";"8";"508";"516"
"8";"Barcelona";"2";"Catalunya Central";"7";"Bages";"08113";"Manresa";"5";"7";"U";"348";"137";"221";"261";"87";"0";"2";"259";"261"
"8";"Barcelona";"2";"Catalunya Central";"7";"Bages";"08113";"Manresa";"5";"8";"U";"793";"259";"480";"586";"207";"5";"2";"579";"581"
"8";"Barcelona";"2";"Catalunya Central";"7";"Bages";"08113";"Manresa";"6";"1";"U";"680";"261";"429";"433";"247";"1";"3";"429";"432"
"8";"Barcelona";"2";"Catalunya Central";"7";"Bages";"08113";"Manresa";"6";"2";"U";"763";"295";"473";"549";"214";"1";"2";"546";"548"
"8";"Barcelona";"2";"Catalunya Central";"7";"Bages";"08242";"Marganell";"1";"1";"U";"218";"98";"146";"182";"36";"0";"0";"182";"182"
"8";"Barcelona";"2";"Catalunya Central";"24";"Osona";"08116";"Masies de Roda, les";"1";"1";"U";"584";"222";"437";"515";"69";"0";"1";"514";"515"
"8";"Barcelona";"2";"Catalunya Central";"24";"Osona";"08117";"Masies de Voltregà, les";"1";"1";"A";"744";"328";"542";"639";"105";"2";"3";"634";"637"
"8";"Barcelona";"2";"Catalunya Central";"24";"Osona";"08117";"Masies de Voltregà, les";"1";"1";"B";"520";"251";"400";"459";"61";"3";"0";"456";"456"
"8";"Barcelona";"2";"Catalunya Central";"24";"Osona";"08117";"Masies de Voltregà, les";"1";"1";"C";"518";"243";"384";"452";"66";"3";"1";"448";"449"
"8";"Barcelona";"2";"Catalunya Central";"24";"Osona";"08117";"Masies de Voltregà, les";"2";"1";"U";"665";"264";"448";"526";"139";"3";"6";"517";"523"
"8";"Barcelona";"2";"Catalunya Central";"6";"Anoia";"08119";"Masquefa";"1";"1";"A";"469";"194";"310";"382";"87";"1";"3";"378";"381"
"8";"Barcelona";"2";"Catalunya Central";"6";"Anoia";"08119";"Masquefa";"1";"1";"B";"697";"244";"455";"553";"144";"1";"4";"548";"552"
"8";"Barcelona";"2";"Catalunya Central";"6";"Anoia";"08119";"Masquefa";"1";"1";"C";"747";"294";"491";"607";"140";"6";"3";"598";"601"
"8";"Barcelona";"2";"Catalunya Central";"6";"Anoia";"08119";"Masquefa";"1";"1";"D";"644";"249";"445";"523";"121";"1";"1";"521";"522"
"8";"Barcelona";"2";"Catalunya Central";"6";"Anoia";"08119";"Masquefa";"1";"1";"E";"569";"258";"383";"460";"109";"5";"3";"452";"455"
"8";"Barcelona";"2";"Catalunya Central";"6";"Anoia";"08119";"Masquefa";"1";"1";"F";"542";"214";"355";"434";"108";"0";"2";"432";"434"
"8";"Barcelona";"2";"Catalunya Central";"6";"Anoia";"08119";"Masquefa";"1";"2";"A";"231";"97";"149";"184";"47";"0";"0";"184";"184"
"8";"Barcelona";"2";"Catalunya Central";"6";"Anoia";"08119";"Masquefa";"1";"2";"B";"671";"286";"430";"518";"153";"1";"1";"516";"517"
"8";"Barcelona";"2";"Catalunya Central";"6";"Anoia";"08119";"Masquefa";"1";"2";"C";"802";"298";"468";"578";"224";"4";"2";"572";"574"
"8";"Barcelona";"2";"Catalunya Central";"6";"Anoia";"08119";"Masquefa";"1";"2";"D";"799";"295";"462";"589";"210";"6";"2";"581";"583"
"8";"Barcelona";"2";"Catalunya Central";"42";"Moianès";"08138";"Moià";"1";"1";"A";"784";"287";"538";"630";"154";"4";"4";"622";"626"
"8";"Barcelona";"2";"Catalunya Central";"42";"Moianès";"08138";"Moià";"1";"1";"B";"850";"310";"569";"669";"181";"5";"2";"662";"664"
"8";"Barcelona";"2";"Catalunya Central";"42";"Moianès";"08138";"Moià";"1";"2";"A";"824";"312";"557";"657";"167";"7";"4";"646";"650"
"8";"Barcelona";"2";"Catalunya Central";"42";"Moianès";"08138";"Moià";"1";"2";"B";"873";"363";"596";"708";"165";"4";"4";"700";"704"
"8";"Barcelona";"2";"Catalunya Central";"42";"Moianès";"08138";"Moià";"1";"3";"U";"894";"299";"623";"732";"162";"3";"6";"723";"729"
"8";"Barcelona";"2";"Catalunya Central";"42";"Moianès";"08128";"Monistrol de Calders";"1";"1";"U";"569";"211";"374";"481";"88";"4";"3";"474";"477"
"8";"Barcelona";"2";"Catalunya Central";"7";"Bages";"08127";"Monistrol de Montserrat";"1";"1";"U";"655";"227";"409";"505";"150";"8";"2";"495";"497"
"8";"Barcelona";"2";"Catalunya Central";"7";"Bages";"08127";"Monistrol de Montserrat";"1";"2";"A";"710";"203";"413";"523";"187";"2";"2";"519";"521"
"8";"Barcelona";"2";"Catalunya Central";"7";"Bages";"08127";"Monistrol de Montserrat";"1";"2";"B";"847";"269";"477";"630";"217";"2";"4";"624";"628"
"8";"Barcelona";"2";"Catalunya Central";"14";"Berguedà";"08130";"Montclar";"1";"1";"U";"96";"25";"61";"83";"13";"0";"1";"82";"83"
"8";"Barcelona";"2";"Catalunya Central";"24";"Osona";"08131";"Montesquiu";"1";"1";"U";"709";"303";"509";"581";"128";"5";"3";"573";"576"
"8";"Barcelona";"2";"Catalunya Central";"14";"Berguedà";"08132";"Montmajor";"1";"1";"U";"382";"132";"271";"328";"54";"0";"6";"322";"328"
"8";"Barcelona";"2";"Catalunya Central";"6";"Anoia";"08133";"Montmaneu";"1";"1";"U";"131";"42";"81";"99";"32";"1";"1";"97";"98"
"8";"Barcelona";"2";"Catalunya Central";"24";"Osona";"08129";"Muntanyola";"1";"1";"U";"457";"216";"324";"394";"63";"1";"2";"391";"393"
"8";"Barcelona";"2";"Catalunya Central";"7";"Bages";"08139";"Mura";"1";"1";"U";"171";"78";"127";"161";"10";"0";"0";"161";"161"
"8";"Barcelona";"2";"Catalunya Central";"7";"Bages";"08140";"Navarcles";"1";"1";"A";"669";"246";"437";"532";"137";"3";"8";"521";"529"
"8";"Barcelona";"2";"Catalunya Central";"7";"Bages";"08140";"Navarcles";"1";"1";"B";"761";"260";"438";"587";"174";"3";"2";"582";"584"
"8";"Barcelona";"2";"Catalunya Central";"7";"Bages";"08140";"Navarcles";"1";"2";"A";"775";"318";"523";"644";"131";"1";"8";"635";"643"
"8";"Barcelona";"2";"Catalunya Central";"7";"Bages";"08140";"Navarcles";"1";"2";"B";"897";"341";"600";"740";"157";"1";"5";"734";"739"
"8";"Barcelona";"2";"Catalunya Central";"7";"Bages";"08140";"Navarcles";"1";"3";"A";"744";"292";"512";"610";"134";"1";"6";"603";"609"
"8";"Barcelona";"2";"Catalunya Central";"7";"Bages";"08140";"Navarcles";"1";"3";"B";"943";"355";"617";"760";"183";"4";"1";"755";"756"
"8";"Barcelona";"2";"Catalunya Central";"7";"Bages";"08141";"Navàs";"1";"1";"A";"407";"164";"272";"341";"66";"1";"3";"337";"340"
"8";"Barcelona";"2";"Catalunya Central";"7";"Bages";"08141";"Navàs";"1";"1";"B";"536";"233";"382";"462";"74";"1";"8";"453";"461"
"8";"Barcelona";"2";"Catalunya Central";"7";"Bages";"08141";"Navàs";"1";"2";"U";"552";"205";"373";"451";"101";"8";"0";"443";"443"
"8";"Barcelona";"2";"Catalunya Central";"7";"Bages";"08141";"Navàs";"1";"3";"A";"578";"208";"358";"443";"135";"0";"1";"442";"443"
"8";"Barcelona";"2";"Catalunya Central";"7";"Bages";"08141";"Navàs";"1";"3";"B";"522";"196";"338";"406";"116";"1";"2";"403";"405"
"8";"Barcelona";"2";"Catalunya Central";"7";"Bages";"08141";"Navàs";"1";"3";"C";"679";"224";"400";"520";"159";"1";"1";"518";"519"
"8";"Barcelona";"2";"Catalunya Central";"7";"Bages";"08141";"Navàs";"1";"4";"A";"478";"177";"307";"388";"90";"0";"5";"383";"388"
"8";"Barcelona";"2";"Catalunya Central";"7";"Bages";"08141";"Navàs";"1";"4";"B";"634";"234";"440";"537";"97";"0";"5";"532";"537"
"8";"Barcelona";"2";"Catalunya Central";"7";"Bages";"08141";"Navàs";"2";"1";"U";"210";"107";"158";"173";"37";"1";"0";"172";"172"
"8";"Barcelona";"2";"Catalunya Central";"14";"Berguedà";"08142";"Nou de Berguedà, la";"1";"1";"U";"129";"56";"110";"123";"6";"0";"0";"123";"123"
"8";"Barcelona";"2";"Catalunya Central";"24";"Osona";"08149";"Olost";"1";"1";"A";"428";"159";"315";"365";"63";"0";"0";"365";"365"
"8";"Barcelona";"2";"Catalunya Central";"24";"Osona";"08149";"Olost";"1";"1";"B";"565";"264";"420";"482";"83";"0";"1";"481";"482"
"8";"Barcelona";"2";"Catalunya Central";"14";"Berguedà";"08144";"Olvan";"1";"1";"A";"384";"134";"248";"315";"69";"1";"1";"313";"314"
"8";"Barcelona";"2";"Catalunya Central";"14";"Berguedà";"08144";"Olvan";"1";"1";"B";"331";"150";"235";"269";"62";"2";"5";"262";"267"
"8";"Barcelona";"2";"Catalunya Central";"24";"Osona";"08151";"Oristà";"1";"1";"U";"465";"160";"347";"409";"56";"0";"3";"406";"409"
"8";"Barcelona";"2";"Catalunya Central";"6";"Anoia";"08152";"Orpí";"1";"1";"U";"114";"47";"81";"102";"12";"1";"0";"101";"101"
"8";"Barcelona";"2";"Catalunya Central";"24";"Osona";"08150";"Orís";"1";"1";"U";"255";"109";"190";"231";"24";"0";"0";"231";"231"
"8";"Barcelona";"2";"Catalunya Central";"24";"Osona";"08160";"Perafita";"1";"1";"U";"329";"162";"219";"266";"63";"0";"1";"265";"266"
"8";"Barcelona";"2";"Catalunya Central";"6";"Anoia";"08161";"Piera";"1";"1";"U";"839";"282";"530";"629";"210";"1";"2";"626";"628"
"8";"Barcelona";"2";"Catalunya Central";"6";"Anoia";"08161";"Piera";"1";"2";"A";"1088";"309";"647";"794";"294";"3";"4";"787";"791"
"8";"Barcelona";"2";"Catalunya Central";"6";"Anoia";"08161";"Piera";"1";"2";"B";"1155";"360";"674";"818";"337";"4";"4";"810";"814"
"8";"Barcelona";"2";"Catalunya Central";"6";"Anoia";"08161";"Piera";"1";"3";"A";"842";"302";"516";"641";"201";"5";"8";"628";"636"
"8";"Barcelona";"2";"Catalunya Central";"6";"Anoia";"08161";"Piera";"1";"3";"B";"930";"345";"582";"709";"221";"5";"4";"700";"704"
"8";"Barcelona";"2";"Catalunya Central";"6";"Anoia";"08161";"Piera";"1";"4";"A";"228";"93";"150";"191";"37";"0";"1";"190";"191"
"8";"Barcelona";"2";"Catalunya Central";"6";"Anoia";"08161";"Piera";"1";"4";"B";"1088";"338";"704";"781";"307";"5";"0";"776";"776"
"8";"Barcelona";"2";"Catalunya Central";"6";"Anoia";"08161";"Piera";"1";"5";"A";"635";"264";"401";"458";"177";"4";"0";"454";"454"
"8";"Barcelona";"2";"Catalunya Central";"6";"Anoia";"08161";"Piera";"1";"5";"B";"784";"279";"486";"591";"193";"1";"2";"588";"590"
"8";"Barcelona";"2";"Catalunya Central";"6";"Anoia";"08161";"Piera";"1";"6";"U";"985";"375";"630";"726";"259";"10";"5";"711";"716"
"8";"Barcelona";"2";"Catalunya Central";"6";"Anoia";"08161";"Piera";"1";"7";"U";"648";"250";"427";"502";"146";"2";"2";"498";"500"
"8";"Barcelona";"2";"Catalunya Central";"6";"Anoia";"08161";"Piera";"1";"8";"U";"1143";"410";"689";"845";"298";"4";"7";"834";"841"
"8";"Barcelona";"2";"Catalunya Central";"6";"Anoia";"08161";"Piera";"1";"9";"U";"777";"309";"489";"571";"206";"3";"3";"565";"568"
"8";"Barcelona";"2";"Catalunya Central";"6";"Anoia";"08165";"Pobla de Claramunt, la";"1";"1";"A";"765";"300";"531";"616";"149";"0";"2";"614";"616"
"8";"Barcelona";"2";"Catalunya Central";"6";"Anoia";"08165";"Pobla de Claramunt, la";"1";"1";"B";"886";"327";"604";"704";"182";"1";"3";"700";"703"
"8";"Barcelona";"2";"Catalunya Central";"14";"Berguedà";"08166";"Pobla de Lillet, la";"1";"1";"U";"302";"137";"215";"243";"59";"0";"4";"239";"243"
"8";"Barcelona";"2";"Catalunya Central";"14";"Berguedà";"08166";"Pobla de Lillet, la";"1";"2";"U";"713";"280";"563";"567";"146";"5";"5";"557";"562"
"8";"Barcelona";"2";"Catalunya Central";"7";"Bages";"08182";"Pont de Vilomara i Rocafort, el";"1";"1";"A";"741";"254";"471";"568";"173";"4";"5";"559";"564"
"8";"Barcelona";"2";"Catalunya Central";"7";"Bages";"08182";"Pont de Vilomara i Rocafort, el";"1";"1";"B";"1058";"314";"665";"824";"234";"1";"3";"820";"823"
"8";"Barcelona";"2";"Catalunya Central";"7";"Bages";"08182";"Pont de Vilomara i Rocafort, el";"1";"1";"C";"996";"338";"659";"785";"211";"3";"4";"778";"782"
"8";"Barcelona";"2";"Catalunya Central";"24";"Osona";"08171";"Prats de Lluçanès";"1";"1";"A";"514";"243";"372";"434";"80";"1";"1";"432";"433"
"8";"Barcelona";"2";"Catalunya Central";"24";"Osona";"08171";"Prats de Lluçanès";"1";"1";"B";"519";"234";"360";"423";"96";"1";"3";"419";"422"
"8";"Barcelona";"2";"Catalunya Central";"24";"Osona";"08171";"Prats de Lluçanès";"1";"2";"A";"496";"225";"368";"414";"82";"1";"4";"409";"413"
"8";"Barcelona";"2";"Catalunya Central";"24";"Osona";"08171";"Prats de Lluçanès";"1";"2";"B";"577";"259";"429";"487";"90";"0";"1";"486";"487"
"8";"Barcelona";"2";"Catalunya Central";"6";"Anoia";"08170";"Prats de Rei, els";"1";"1";"U";"446";"149";"286";"353";"93";"0";"4";"349";"353"
"8";"Barcelona";"2";"Catalunya Central";"14";"Berguedà";"08175";"Puig-reig";"1";"1";"A";"632";"237";"427";"495";"137";"2";"4";"489";"493"
"8";"Barcelona";"2";"Catalunya Central";"14";"Berguedà";"08175";"Puig-reig";"1";"1";"B";"446";"142";"270";"316";"130";"2";"4";"310";"314"
"8";"Barcelona";"2";"Catalunya Central";"14";"Berguedà";"08175";"Puig-reig";"1";"1";"C";"650";"241";"442";"519";"131";"0";"5";"514";"519"
"8";"Barcelona";"2";"Catalunya Central";"14";"Berguedà";"08175";"Puig-reig";"1";"2";"A";"515";"201";"360";"427";"88";"1";"1";"425";"426"
"8";"Barcelona";"2";"Catalunya Central";"14";"Berguedà";"08175";"Puig-reig";"1";"2";"B";"618";"200";"407";"495";"123";"3";"1";"491";"492"
"8";"Barcelona";"2";"Catalunya Central";"14";"Berguedà";"08175";"Puig-reig";"2";"1";"A";"236";"103";"153";"194";"42";"1";"1";"192";"193"
"8";"Barcelona";"2";"Catalunya Central";"14";"Berguedà";"08175";"Puig-reig";"2";"1";"B";"280";"99";"181";"215";"65";"0";"1";"214";"215"
"8";"Barcelona";"2";"Catalunya Central";"6";"Anoia";"08176";"Pujalt";"1";"1";"U";"157";"58";"102";"130";"27";"1";"0";"129";"129"
"8";"Barcelona";"2";"Catalunya Central";"14";"Berguedà";"08177";"Quar, la";"1";"1";"U";"40";"17";"27";"33";"7";"0";"0";"33";"33"
"8";"Barcelona";"2";"Catalunya Central";"7";"Bages";"08178";"Rajadell";"1";"1";"U";"427";"200";"307";"368";"59";"2";"4";"362";"366"
"8";"Barcelona";"2";"Catalunya Central";"24";"Osona";"08183";"Roda de Ter";"1";"1";"A";"664";"260";"448";"531";"133";"2";"1";"528";"529"
"8";"Barcelona";"2";"Catalunya Central";"24";"Osona";"08183";"Roda de Ter";"1";"1";"B";"746";"285";"487";"602";"144";"0";"2";"600";"602"
"8";"Barcelona";"2";"Catalunya Central";"24";"Osona";"08183";"Roda de Ter";"1";"2";"A";"538";"212";"383";"461";"77";"0";"1";"460";"461"
"8";"Barcelona";"2";"Catalunya Central";"24";"Osona";"08183";"Roda de Ter";"1";"2";"B";"673";"236";"474";"559";"114";"3";"3";"553";"556"
"8";"Barcelona";"2";"Catalunya Central";"24";"Osona";"08183";"Roda de Ter";"1";"3";"A";"523";"200";"336";"394";"129";"0";"6";"388";"394"
"8";"Barcelona";"2";"Catalunya Central";"24";"Osona";"08183";"Roda de Ter";"1";"3";"B";"537";"220";"383";"441";"96";"0";"6";"435";"441"
"8";"Barcelona";"2";"Catalunya Central";"24";"Osona";"08183";"Roda de Ter";"2";"1";"U";"828";"324";"591";"680";"148";"2";"1";"677";"678"
"8";"Barcelona";"2";"Catalunya Central";"6";"Anoia";"08185";"Rubió";"1";"1";"U";"193";"78";"138";"166";"27";"0";"0";"166";"166"
"8";"Barcelona";"2";"Catalunya Central";"24";"Osona";"08901";"Rupit i Pruit";"1";"1";"U";"230";"121";"181";"207";"23";"1";"0";"206";"206"
"8";"Barcelona";"2";"Catalunya Central";"14";"Berguedà";"08188";"Sagàs";"1";"1";"U";"114";"60";"86";"104";"10";"0";"1";"103";"104"
"8";"Barcelona";"2";"Catalunya Central";"14";"Berguedà";"08190";"Saldes";"1";"1";"U";"256";"113";"169";"216";"40";"2";"1";"213";"214"
"8";"Barcelona";"2";"Catalunya Central";"7";"Bages";"08191";"Sallent";"1";"1";"U";"495";"197";"294";"359";"136";"1";"0";"358";"358"
"8";"Barcelona";"2";"Catalunya Central";"7";"Bages";"08191";"Sallent";"1";"2";"U";"486";"178";"280";"370";"116";"0";"0";"370";"370"
"8";"Barcelona";"2";"Catalunya Central";"7";"Bages";"08191";"Sallent";"1";"3";"A";"532";"215";"345";"420";"112";"0";"4";"416";"420"
"8";"Barcelona";"2";"Catalunya Central";"7";"Bages";"08191";"Sallent";"1";"3";"B";"546";"243";"387";"437";"109";"0";"0";"437";"437"
"8";"Barcelona";"2";"Catalunya Central";"7";"Bages";"08191";"Sallent";"1";"4";"A";"493";"194";"312";"379";"114";"1";"5";"373";"378"
"8";"Barcelona";"2";"Catalunya Central";"7";"Bages";"08191";"Sallent";"1";"4";"B";"535";"213";"347";"425";"110";"3";"4";"418";"422"
"8";"Barcelona";"2";"Catalunya Central";"7";"Bages";"08191";"Sallent";"1";"5";"A";"484";"194";"319";"383";"101";"0";"0";"383";"383"
"8";"Barcelona";"2";"Catalunya Central";"7";"Bages";"08191";"Sallent";"1";"5";"B";"641";"273";"439";"538";"103";"1";"4";"533";"537"
"8";"Barcelona";"2";"Catalunya Central";"7";"Bages";"08191";"Sallent";"1";"6";"U";"649";"263";"437";"518";"131";"2";"4";"512";"516"
"8";"Barcelona";"2";"Catalunya Central";"7";"Bages";"08191";"Sallent";"2";"1";"A";"142";"53";"86";"106";"36";"0";"0";"106";"106"
"8";"Barcelona";"2";"Catalunya Central";"7";"Bages";"08191";"Sallent";"2";"1";"B";"286";"155";"230";"255";"31";"1";"1";"253";"254"
"8";"Barcelona";"2";"Catalunya Central";"24";"Osona";"08195";"Sant Agustí de Lluçanès";"1";"1";"U";"81";"38";"70";"76";"5";"0";"0";"76";"76"
"8";"Barcelona";"2";"Catalunya Central";"24";"Osona";"08199";"Sant Bartomeu del Grau";"1";"1";"U";"668";"255";"483";"556";"112";"1";"5";"550";"555"
"8";"Barcelona";"2";"Catalunya Central";"24";"Osona";"08201";"Sant Boi de Lluçanès";"1";"1";"U";"443";"168";"311";"364";"79";"0";"2";"362";"364"
"8";"Barcelona";"2";"Catalunya Central";"7";"Bages";"08212";"Sant Feliu Sasserra";"1";"1";"U";"500";"205";"366";"434";"66";"1";"3";"430";"433"
"8";"Barcelona";"2";"Catalunya Central";"7";"Bages";"08213";"Sant Fruitós de Bages";"1";"1";"A";"498";"188";"334";"393";"105";"0";"0";"393";"393"
"8";"Barcelona";"2";"Catalunya Central";"7";"Bages";"08213";"Sant Fruitós de Bages";"1";"1";"B";"407";"138";"254";"314";"93";"2";"0";"312";"312"
"8";"Barcelona";"2";"Catalunya Central";"7";"Bages";"08213";"Sant Fruitós de Bages";"1";"1";"C";"575";"206";"365";"459";"116";"1";"6";"452";"458"
"8";"Barcelona";"2";"Catalunya Central";"7";"Bages";"08213";"Sant Fruitós de Bages";"1";"1";"D";"493";"191";"320";"395";"98";"3";"5";"387";"392"
"8";"Barcelona";"2";"Catalunya Central";"7";"Bages";"08213";"Sant Fruitós de Bages";"1";"2";"A";"668";"264";"427";"506";"162";"2";"5";"499";"504"
"8";"Barcelona";"2";"Catalunya Central";"7";"Bages";"08213";"Sant Fruitós de Bages";"1";"2";"B";"742";"239";"442";"552";"190";"3";"3";"546";"549"
"8";"Barcelona";"2";"Catalunya Central";"7";"Bages";"08213";"Sant Fruitós de Bages";"1";"2";"C";"695";"251";"432";"523";"172";"2";"3";"518";"521"
"8";"Barcelona";"2";"Catalunya Central";"7";"Bages";"08213";"Sant Fruitós de Bages";"1";"3";"A";"663";"247";"531";"536";"127";"0";"2";"534";"536"
"8";"Barcelona";"2";"Catalunya Central";"7";"Bages";"08213";"Sant Fruitós de Bages";"1";"3";"B";"802";"304";"446";"631";"171";"1";"3";"627";"630"
"8";"Barcelona";"2";"Catalunya Central";"7";"Bages";"08213";"Sant Fruitós de Bages";"1";"4";"U";"745";"330";"541";"651";"94";"1";"4";"646";"650"
"8";"Barcelona";"2";"Catalunya Central";"24";"Osona";"08215";"Sant Hipòlit de Voltregà";"1";"1";"U";"848";"450";"604";"703";"145";"0";"9";"694";"703"
"8";"Barcelona";"2";"Catalunya Central";"24";"Osona";"08215";"Sant Hipòlit de Voltregà";"1";"2";"U";"848";"392";"620";"712";"136";"8";"2";"702";"704"
"8";"Barcelona";"2";"Catalunya Central";"24";"Osona";"08215";"Sant Hipòlit de Voltregà";"1";"3";"A";"359";"164";"243";"305";"54";"1";"7";"297";"304"
"8";"Barcelona";"2";"Catalunya Central";"24";"Osona";"08215";"Sant Hipòlit de Voltregà";"1";"3";"B";"511";"229";"342";"429";"82";"1";"4";"424";"428"
"8";"Barcelona";"2";"Catalunya Central";"14";"Berguedà";"08216";"Sant Jaume de Frontanyà";"1";"1";"U";"25";"8";"12";"23";"2";"0";"0";"23";"23"
"8";"Barcelona";"2";"Catalunya Central";"7";"Bages";"08218";"Sant Joan de Vilatorrada";"1";"1";"A";"514";"180";"326";"407";"107";"1";"4";"402";"406"
"8";"Barcelona";"2";"Catalunya Central";"7";"Bages";"08218";"Sant Joan de Vilatorrada";"1";"1";"B";"531";"180";"335";"412";"119";"3";"4";"405";"409"
"8";"Barcelona";"2";"Catalunya Central";"7";"Bages";"08218";"Sant Joan de Vilatorrada";"1";"1";"C";"622";"236";"397";"474";"148";"1";"3";"470";"473"
"8";"Barcelona";"2";"Catalunya Central";"7";"Bages";"08218";"Sant Joan de Vilatorrada";"1";"2";"A";"464";"162";"299";"376";"88";"1";"3";"372";"375"
"8";"Barcelona";"2";"Catalunya Central";"7";"Bages";"08218";"Sant Joan de Vilatorrada";"1";"2";"B";"589";"196";"370";"465";"124";"3";"1";"461";"462"
"8";"Barcelona";"2";"Catalunya Central";"7";"Bages";"08218";"Sant Joan de Vilatorrada";"1";"2";"C";"546";"179";"328";"439";"107";"1";"5";"433";"438"
"8";"Barcelona";"2";"Catalunya Central";"7";"Bages";"08218";"Sant Joan de Vilatorrada";"1";"3";"A";"614";"220";"384";"472";"142";"4";"3";"465";"468"
"8";"Barcelona";"2";"Catalunya Central";"7";"Bages";"08218";"Sant Joan de Vilatorrada";"1";"3";"B";"836";"250";"507";"634";"202";"2";"0";"632";"632"
"8";"Barcelona";"2";"Catalunya Central";"7";"Bages";"08218";"Sant Joan de Vilatorrada";"1";"3";"C";"208";"83";"146";"173";"35";"0";"2";"171";"173"
"8";"Barcelona";"2";"Catalunya Central";"7";"Bages";"08218";"Sant Joan de Vilatorrada";"1";"5";"A";"586";"215";"380";"471";"115";"3";"2";"466";"468"
"8";"Barcelona";"2";"Catalunya Central";"7";"Bages";"08218";"Sant Joan de Vilatorrada";"1";"5";"B";"756";"249";"498";"597";"159";"3";"3";"591";"594"
"8";"Barcelona";"2";"Catalunya Central";"7";"Bages";"08218";"Sant Joan de Vilatorrada";"1";"6";"A";"529";"185";"338";"396";"133";"1";"3";"392";"395"
"8";"Barcelona";"2";"Catalunya Central";"7";"Bages";"08218";"Sant Joan de Vilatorrada";"1";"6";"B";"629";"230";"406";"490";"139";"2";"3";"485";"488"
"8";"Barcelona";"2";"Catalunya Central";"7";"Bages";"08218";"Sant Joan de Vilatorrada";"1";"6";"C";"628";"198";"418";"491";"137";"1";"6";"484";"490"
"8";"Barcelona";"2";"Catalunya Central";"14";"Berguedà";"08903";"Sant Julià de Cerdanyola";"1";"1";"U";"213";"115";"174";"197";"16";"2";"0";"195";"195"
"8";"Barcelona";"2";"Catalunya Central";"24";"Osona";"08220";"Sant Julià de Vilatorta";"1";"1";"A";"579";"281";"471";"531";"48";"7";"0";"524";"524"
"8";"Barcelona";"2";"Catalunya Central";"24";"Osona";"08220";"Sant Julià de Vilatorta";"1";"1";"B";"641";"280";"516";"583";"58";"0";"0";"583";"583"
"8";"Barcelona";"2";"Catalunya Central";"24";"Osona";"08220";"Sant Julià de Vilatorta";"1";"2";"A";"566";"239";"448";"522";"44";"0";"2";"520";"522"
"8";"Barcelona";"2";"Catalunya Central";"24";"Osona";"08220";"Sant Julià de Vilatorta";"1";"2";"B";"568";"258";"451";"522";"46";"0";"1";"521";"522"
"8";"Barcelona";"2";"Catalunya Central";"6";"Anoia";"08228";"Sant Martí Sesgueioles";"1";"1";"U";"296";"105";"203";"245";"51";"1";"0";"244";"244"
"8";"Barcelona";"2";"Catalunya Central";"24";"Osona";"08225";"Sant Martí d'Albars";"1";"1";"U";"94";"46";"71";"86";"8";"0";"2";"84";"86"
"8";"Barcelona";"2";"Catalunya Central";"24";"Osona";"08224";"Sant Martí de Centelles";"1";"1";"U";"821";"381";"558";"664";"157";"5";"2";"657";"659"
"8";"Barcelona";"2";"Catalunya Central";"6";"Anoia";"08226";"Sant Martí de Tous";"1";"1";"U";"875";"436";"735";"793";"82";"2";"3";"788";"791"
"8";"Barcelona";"2";"Catalunya Central";"7";"Bages";"08229";"Sant Mateu de Bages";"1";"1";"A";"132";"53";"90";"112";"20";"0";"0";"112";"112"
"8";"Barcelona";"2";"Catalunya Central";"7";"Bages";"08229";"Sant Mateu de Bages";"1";"1";"B";"404";"186";"297";"349";"55";"1";"1";"347";"348"
"8";"Barcelona";"2";"Catalunya Central";"6";"Anoia";"08189";"Sant Pere Sallavinera";"1";"1";"U";"131";"57";"98";"114";"17";"1";"0";"113";"113"
"8";"Barcelona";"2";"Catalunya Central";"24";"Osona";"08233";"Sant Pere de Torelló";"1";"1";"U";"731";"403";"526";"618";"113";"4";"5";"609";"614"
"8";"Barcelona";"2";"Catalunya Central";"24";"Osona";"08233";"Sant Pere de Torelló";"1";"2";"A";"497";"253";"326";"405";"92";"1";"1";"403";"404"
"8";"Barcelona";"2";"Catalunya Central";"24";"Osona";"08233";"Sant Pere de Torelló";"1";"2";"B";"643";"338";"448";"528";"115";"2";"2";"524";"526"
"8";"Barcelona";"1";"Barcelona";"42";"Moianès";"08239";"Sant Quirze Safaja";"1";"1";"U";"450";"198";"333";"386";"64";"0";"0";"386";"386"
"8";"Barcelona";"2";"Catalunya Central";"24";"Osona";"08237";"Sant Quirze de Besora";"1";"1";"A";"481";"210";"337";"396";"85";"2";"2";"392";"394"
"8";"Barcelona";"2";"Catalunya Central";"24";"Osona";"08237";"Sant Quirze de Besora";"1";"1";"B";"529";"251";"390";"449";"80";"1";"3";"445";"448"
"8";"Barcelona";"2";"Catalunya Central";"24";"Osona";"08237";"Sant Quirze de Besora";"1";"2";"U";"634";"292";"468";"550";"84";"1";"2";"547";"549"
"8";"Barcelona";"2";"Catalunya Central";"24";"Osona";"08241";"Sant Sadurní d'Osormort";"1";"1";"U";"74";"22";"48";"64";"10";"0";"0";"64";"64"
"8";"Barcelona";"2";"Catalunya Central";"7";"Bages";"08098";"Sant Salvador de Guardiola";"1";"1";"A";"666";"284";"486";"557";"109";"1";"4";"552";"556"
"8";"Barcelona";"2";"Catalunya Central";"7";"Bages";"08098";"Sant Salvador de Guardiola";"1";"1";"B";"653";"258";"459";"561";"92";"0";"2";"559";"561"
"8";"Barcelona";"2";"Catalunya Central";"7";"Bages";"08098";"Sant Salvador de Guardiola";"1";"2";"A";"527";"180";"331";"397";"130";"2";"7";"388";"395"
"8";"Barcelona";"2";"Catalunya Central";"7";"Bages";"08098";"Sant Salvador de Guardiola";"1";"2";"B";"534";"209";"344";"413";"121";"2";"3";"408";"411"
"8";"Barcelona";"2";"Catalunya Central";"7";"Bages";"08262";"Sant Vicenç de Castellet";"1";"1";"A";"572";"187";"318";"412";"160";"2";"2";"408";"410"
"8";"Barcelona";"2";"Catalunya Central";"7";"Bages";"08262";"Sant Vicenç de Castellet";"1";"1";"B";"763";"225";"415";"526";"237";"2";"3";"521";"524"
"8";"Barcelona";"2";"Catalunya Central";"7";"Bages";"08262";"Sant Vicenç de Castellet";"1";"2";"A";"559";"196";"356";"450";"109";"1";"4";"445";"449"
"8";"Barcelona";"2";"Catalunya Central";"7";"Bages";"08262";"Sant Vicenç de Castellet";"1";"2";"B";"664";"257";"418";"512";"152";"1";"3";"508";"511"
"8";"Barcelona";"2";"Catalunya Central";"7";"Bages";"08262";"Sant Vicenç de Castellet";"1";"3";"A";"655";"212";"389";"489";"166";"4";"6";"479";"485"
"8";"Barcelona";"2";"Catalunya Central";"7";"Bages";"08262";"Sant Vicenç de Castellet";"1";"3";"B";"843";"246";"501";"634";"209";"5";"4";"625";"629"
"8";"Barcelona";"2";"Catalunya Central";"7";"Bages";"08262";"Sant Vicenç de Castellet";"2";"1";"A";"532";"185";"320";"388";"144";"2";"0";"386";"386"
"8";"Barcelona";"2";"Catalunya Central";"7";"Bages";"08262";"Sant Vicenç de Castellet";"2";"1";"B";"642";"202";"372";"456";"186";"0";"3";"453";"456"
"8";"Barcelona";"2";"Catalunya Central";"7";"Bages";"08262";"Sant Vicenç de Castellet";"2";"1";"C";"620";"201";"374";"457";"163";"0";"1";"456";"457"
"8";"Barcelona";"2";"Catalunya Central";"7";"Bages";"08262";"Sant Vicenç de Castellet";"2";"2";"A";"480";"166";"282";"343";"137";"1";"0";"342";"342"
"8";"Barcelona";"2";"Catalunya Central";"7";"Bages";"08262";"Sant Vicenç de Castellet";"2";"2";"B";"529";"179";"310";"376";"153";"2";"4";"370";"374"
"8";"Barcelona";"2";"Catalunya Central";"24";"Osona";"08265";"Sant Vicenç de Torelló";"1";"1";"A";"561";"230";"400";"478";"83";"1";"1";"476";"477"
"8";"Barcelona";"2";"Catalunya Central";"24";"Osona";"08265";"Sant Vicenç de Torelló";"1";"1";"B";"694";"298";"525";"606";"88";"3";"3";"600";"603"
"8";"Barcelona";"2";"Catalunya Central";"24";"Osona";"08265";"Sant Vicenç de Torelló";"1";"1";"C";"291";"125";"218";"252";"39";"0";"0";"252";"252"
"8";"Barcelona";"2";"Catalunya Central";"24";"Osona";"08243";"Santa Cecília de Voltregà";"1";"1";"U";"160";"68";"126";"149";"11";"0";"2";"147";"149"
"8";"Barcelona";"2";"Catalunya Central";"24";"Osona";"08246";"Santa Eugènia de Berga";"1";"1";"A";"796";"326";"576";"677";"119";"0";"4";"673";"677"
"8";"Barcelona";"2";"Catalunya Central";"24";"Osona";"08246";"Santa Eugènia de Berga";"1";"1";"B";"886";"356";"681";"780";"106";"4";"4";"772";"776"
"8";"Barcelona";"2";"Catalunya Central";"24";"Osona";"08247";"Santa Eulàlia de Riuprimer";"1";"1";"U";"963";"399";"757";"840";"123";"4";"3";"833";"836"
"8";"Barcelona";"2";"Catalunya Central";"6";"Anoia";"08250";"Santa Margarida de Montbui";"1";"1";"U";"676";"278";"489";"588";"88";"2";"1";"585";"586"
"8";"Barcelona";"2";"Catalunya Central";"6";"Anoia";"08250";"Santa Margarida de Montbui";"1";"2";"A";"797";"300";"481";"592";"205";"7";"4";"581";"585"
"8";"Barcelona";"2";"Catalunya Central";"6";"Anoia";"08250";"Santa Margarida de Montbui";"1";"2";"B";"760";"311";"501";"577";"183";"7";"7";"563";"570"
"8";"Barcelona";"2";"Catalunya Central";"6";"Anoia";"08250";"Santa Margarida de Montbui";"1";"3";"U";"884";"278";"577";"669";"215";"9";"6";"654";"660"
"8";"Barcelona";"2";"Catalunya Central";"6";"Anoia";"08250";"Santa Margarida de Montbui";"1";"4";"U";"678";"260";"428";"540";"138";"1";"9";"530";"539"
"8";"Barcelona";"2";"Catalunya Central";"6";"Anoia";"08250";"Santa Margarida de Montbui";"1";"5";"A";"596";"185";"328";"419";"177";"1";"4";"414";"418"
"8";"Barcelona";"2";"Catalunya Central";"6";"Anoia";"08250";"Santa Margarida de Montbui";"1";"5";"B";"654";"238";"407";"486";"168";"0";"3";"483";"486"
"8";"Barcelona";"2";"Catalunya Central";"6";"Anoia";"08250";"Santa Margarida de Montbui";"1";"5";"C";"561";"200";"354";"425";"136";"0";"2";"423";"425"
"8";"Barcelona";"2";"Catalunya Central";"6";"Anoia";"08250";"Santa Margarida de Montbui";"1";"6";"U";"880";"300";"502";"624";"256";"1";"3";"620";"623"
"8";"Barcelona";"2";"Catalunya Central";"6";"Anoia";"08250";"Santa Margarida de Montbui";"1";"7";"U";"551";"210";"343";"406";"145";"2";"4";"400";"404"
"8";"Barcelona";"2";"Catalunya Central";"42";"Moianès";"08258";"Santa Maria d'Oló";"1";"1";"U";"839";"340";"629";"754";"85";"1";"6";"747";"753"
"8";"Barcelona";"2";"Catalunya Central";"24";"Osona";"08253";"Santa Maria de Besora";"1";"1";"U";"132";"61";"91";"108";"24";"0";"1";"107";"108"
"8";"Barcelona";"2";"Catalunya Central";"14";"Berguedà";"08255";"Santa Maria de Merlès";"1";"1";"U";"140";"44";"86";"105";"35";"0";"0";"105";"105"
"8";"Barcelona";"2";"Catalunya Central";"6";"Anoia";"08257";"Santa Maria de Miralles";"1";"1";"U";"111";"42";"81";"96";"15";"0";"0";"96";"96"
"8";"Barcelona";"2";"Catalunya Central";"7";"Bages";"08192";"Santpedor";"1";"1";"A";"643";"271";"442";"528";"115";"4";"1";"523";"524"
"8";"Barcelona";"2";"Catalunya Central";"7";"Bages";"08192";"Santpedor";"1";"1";"B";"470";"227";"344";"391";"79";"2";"2";"387";"389"
"8";"Barcelona";"2";"Catalunya Central";"7";"Bages";"08192";"Santpedor";"1";"2";"A";"638";"249";"420";"508";"130";"1";"2";"505";"507"
"8";"Barcelona";"2";"Catalunya Central";"7";"Bages";"08192";"Santpedor";"1";"2";"B";"565";"191";"344";"440";"125";"0";"1";"439";"440"
"8";"Barcelona";"2";"Catalunya Central";"7";"Bages";"08192";"Santpedor";"1";"2";"C";"704";"286";"485";"571";"133";"3";"3";"565";"568"
"8";"Barcelona";"2";"Catalunya Central";"7";"Bages";"08192";"Santpedor";"1";"3";"A";"657";"247";"457";"567";"90";"2";"1";"564";"565"
"8";"Barcelona";"2";"Catalunya Central";"7";"Bages";"08192";"Santpedor";"1";"3";"B";"615";"266";"426";"518";"97";"4";"4";"510";"514"
"8";"Barcelona";"2";"Catalunya Central";"7";"Bages";"08192";"Santpedor";"1";"3";"C";"689";"291";"467";"590";"99";"2";"3";"585";"588"
"8";"Barcelona";"2";"Catalunya Central";"7";"Bages";"08192";"Santpedor";"1";"4";"U";"709";"295";"510";"585";"124";"1";"0";"584";"584"
"8";"Barcelona";"2";"Catalunya Central";"24";"Osona";"08269";"Seva";"1";"1";"A";"769";"327";"555";"647";"122";"5";"1";"641";"642"
"8";"Barcelona";"2";"Catalunya Central";"24";"Osona";"08269";"Seva";"1";"1";"B";"877";"334";"641";"746";"131";"3";"3";"740";"743"
"8";"Barcelona";"2";"Catalunya Central";"24";"Osona";"08269";"Seva";"1";"2";"A";"472";"210";"352";"407";"65";"1";"2";"404";"406"
"8";"Barcelona";"2";"Catalunya Central";"24";"Osona";"08269";"Seva";"1";"2";"B";"527";"243";"400";"459";"68";"3";"1";"455";"456"
"8";"Barcelona";"2";"Catalunya Central";"24";"Osona";"08271";"Sobremunt";"1";"1";"U";"69";"32";"54";"63";"6";"0";"0";"63";"63"
"8";"Barcelona";"2";"Catalunya Central";"24";"Osona";"08272";"Sora";"1";"1";"U";"154";"64";"114";"137";"17";"0";"1";"136";"137"
"8";"Barcelona";"2";"Catalunya Central";"7";"Bages";"08274";"Súria";"1";"1";"A";"714";"247";"475";"576";"138";"4";"2";"570";"572"
"8";"Barcelona";"2";"Catalunya Central";"7";"Bages";"08274";"Súria";"1";"1";"B";"740";"264";"482";"599";"141";"2";"4";"593";"597"
"8";"Barcelona";"2";"Catalunya Central";"7";"Bages";"08274";"Súria";"1";"2";"U";"795";"339";"495";"609";"186";"3";"4";"602";"606"
"8";"Barcelona";"2";"Catalunya Central";"7";"Bages";"08274";"Súria";"1";"4";"A";"737";"206";"449";"546";"191";"0";"3";"543";"546"
"8";"Barcelona";"2";"Catalunya Central";"7";"Bages";"08274";"Súria";"1";"4";"B";"759";"242";"470";"581";"178";"2";"2";"577";"579"
"8";"Barcelona";"2";"Catalunya Central";"7";"Bages";"08274";"Súria";"1";"5";"A";"464";"203";"331";"375";"89";"0";"4";"371";"375"
"8";"Barcelona";"2";"Catalunya Central";"7";"Bages";"08274";"Súria";"1";"5";"B";"501";"203";"341";"413";"88";"3";"5";"405";"410"
"8";"Barcelona";"2";"Catalunya Central";"7";"Bages";"08277";"Talamanca";"1";"1";"U";"159";"83";"118";"143";"16";"0";"0";"143";"143"
"8";"Barcelona";"2";"Catalunya Central";"24";"Osona";"08278";"Taradell";"1";"1";"A";"639";"200";"424";"548";"91";"1";"4";"543";"547"
"8";"Barcelona";"2";"Catalunya Central";"24";"Osona";"08278";"Taradell";"1";"1";"B";"677";"211";"451";"573";"104";"2";"0";"571";"571"
"8";"Barcelona";"2";"Catalunya Central";"24";"Osona";"08278";"Taradell";"1";"2";"A";"526";"218";"396";"459";"67";"0";"3";"456";"459"
"8";"Barcelona";"2";"Catalunya Central";"24";"Osona";"08278";"Taradell";"1";"2";"B";"679";"271";"488";"570";"109";"0";"7";"563";"570"
"8";"Barcelona";"2";"Catalunya Central";"24";"Osona";"08278";"Taradell";"1";"3";"A";"435";"148";"295";"375";"60";"1";"1";"373";"374"
"8";"Barcelona";"2";"Catalunya Central";"24";"Osona";"08278";"Taradell";"1";"3";"B";"491";"190";"364";"444";"47";"0";"2";"442";"444"
"8";"Barcelona";"2";"Catalunya Central";"24";"Osona";"08278";"Taradell";"1";"4";"A";"559";"195";"321";"484";"75";"1";"4";"479";"483"
"8";"Barcelona";"2";"Catalunya Central";"24";"Osona";"08278";"Taradell";"1";"4";"B";"743";"223";"414";"627";"116";"2";"7";"618";"625"
"8";"Barcelona";"2";"Catalunya Central";"24";"Osona";"08280";"Tavertet";"1";"1";"U";"102";"46";"74";"88";"14";"1";"1";"86";"87"
"8";"Barcelona";"2";"Catalunya Central";"24";"Osona";"08275";"Tavèrnoles";"1";"1";"U";"252";"103";"201";"234";"18";"0";"3";"231";"234"
"8";"Barcelona";"2";"Catalunya Central";"24";"Osona";"08283";"Tona";"1";"1";"A";"631";"251";"425";"502";"129";"3";"3";"496";"499"
"8";"Barcelona";"2";"Catalunya Central";"24";"Osona";"08283";"Tona";"1";"1";"B";"688";"280";"457";"545";"143";"2";"6";"537";"543"
"8";"Barcelona";"2";"Catalunya Central";"24";"Osona";"08283";"Tona";"1";"1";"C";"415";"149";"279";"335";"80";"1";"5";"329";"334"
"8";"Barcelona";"2";"Catalunya Central";"24";"Osona";"08283";"Tona";"1";"2";"A";"688";"275";"501";"578";"110";"0";"2";"576";"578"
"8";"Barcelona";"2";"Catalunya Central";"24";"Osona";"08283";"Tona";"1";"2";"B";"660";"264";"467";"542";"118";"1";"3";"538";"541"
"8";"Barcelona";"2";"Catalunya Central";"24";"Osona";"08283";"Tona";"1";"3";"A";"608";"241";"420";"496";"112";"1";"3";"492";"495"
"8";"Barcelona";"2";"Catalunya Central";"24";"Osona";"08283";"Tona";"1";"3";"B";"676";"252";"443";"534";"142";"1";"7";"526";"533"
"8";"Barcelona";"2";"Catalunya Central";"24";"Osona";"08283";"Tona";"1";"3";"C";"432";"175";"310";"363";"69";"5";"1";"357";"358"
"8";"Barcelona";"2";"Catalunya Central";"24";"Osona";"08283";"Tona";"1";"4";"A";"578";"220";"399";"473";"105";"2";"1";"470";"471"
"8";"Barcelona";"2";"Catalunya Central";"24";"Osona";"08283";"Tona";"1";"4";"B";"615";"229";"413";"503";"112";"2";"3";"498";"501"
"8";"Barcelona";"2";"Catalunya Central";"24";"Osona";"08285";"Torelló";"1";"1";"U";"714";"207";"441";"549";"165";"1";"1";"547";"548"
"8";"Barcelona";"2";"Catalunya Central";"24";"Osona";"08285";"Torelló";"1";"2";"A";"590";"246";"413";"482";"108";"4";"2";"476";"478"
"8";"Barcelona";"2";"Catalunya Central";"24";"Osona";"08285";"Torelló";"1";"2";"B";"585";"206";"364";"473";"112";"0";"2";"471";"473"
"8";"Barcelona";"2";"Catalunya Central";"24";"Osona";"08285";"Torelló";"1";"2";"C";"456";"163";"318";"378";"78";"1";"1";"376";"377"
"8";"Barcelona";"2";"Catalunya Central";"24";"Osona";"08285";"Torelló";"1";"4";"A";"541";"197";"353";"423";"118";"0";"8";"415";"423"
"8";"Barcelona";"2";"Catalunya Central";"24";"Osona";"08285";"Torelló";"1";"4";"B";"561";"180";"366";"455";"106";"4";"3";"448";"451"
"8";"Barcelona";"2";"Catalunya Central";"24";"Osona";"08285";"Torelló";"1";"4";"C";"413";"145";"266";"335";"78";"1";"4";"330";"334"
"8";"Barcelona";"2";"Catalunya Central";"24";"Osona";"08285";"Torelló";"2";"1";"A";"659";"234";"433";"538";"121";"1";"1";"536";"537"
"8";"Barcelona";"2";"Catalunya Central";"24";"Osona";"08285";"Torelló";"2";"1";"B";"626";"241";"420";"503";"123";"3";"3";"497";"500"
"8";"Barcelona";"2";"Catalunya Central";"24";"Osona";"08285";"Torelló";"2";"2";"A";"509";"201";"362";"430";"79";"1";"0";"429";"429"
"8";"Barcelona";"2";"Catalunya Central";"24";"Osona";"08285";"Torelló";"2";"2";"B";"504";"209";"348";"415";"89";"0";"2";"413";"415"
"8";"Barcelona";"2";"Catalunya Central";"24";"Osona";"08285";"Torelló";"3";"1";"A";"572";"218";"391";"462";"110";"2";"2";"458";"460"
"8";"Barcelona";"2";"Catalunya Central";"24";"Osona";"08285";"Torelló";"3";"1";"B";"733";"287";"519";"619";"114";"4";"1";"614";"615"
"8";"Barcelona";"2";"Catalunya Central";"24";"Osona";"08285";"Torelló";"3";"2";"A";"549";"231";"366";"435";"114";"6";"3";"426";"429"
"8";"Barcelona";"2";"Catalunya Central";"24";"Osona";"08285";"Torelló";"3";"2";"B";"597";"265";"429";"491";"106";"2";"2";"487";"489"
"8";"Barcelona";"2";"Catalunya Central";"24";"Osona";"08285";"Torelló";"3";"3";"A";"546";"218";"388";"464";"82";"1";"2";"461";"463"
"8";"Barcelona";"2";"Catalunya Central";"24";"Osona";"08285";"Torelló";"3";"3";"B";"637";"251";"440";"515";"122";"2";"2";"511";"513"
"8";"Barcelona";"2";"Catalunya Central";"24";"Osona";"08285";"Torelló";"3";"3";"C";"477";"208";"347";"409";"68";"3";"1";"405";"406"
"8";"Barcelona";"2";"Catalunya Central";"6";"Anoia";"08286";"Torre de Claramunt, la";"1";"1";"A";"792";"323";"568";"668";"124";"3";"6";"659";"665"
"8";"Barcelona";"2";"Catalunya Central";"6";"Anoia";"08286";"Torre de Claramunt, la";"1";"1";"B";"952";"347";"674";"775";"177";"4";"4";"767";"771"
"8";"Barcelona";"2";"Catalunya Central";"6";"Anoia";"08286";"Torre de Claramunt, la";"1";"2";"A";"501";"192";"283";"345";"156";"0";"1";"344";"345"
"8";"Barcelona";"2";"Catalunya Central";"6";"Anoia";"08286";"Torre de Claramunt, la";"1";"2";"B";"649";"225";"381";"462";"187";"3";"4";"455";"459"
"8";"Barcelona";"2";"Catalunya Central";"6";"Anoia";"08292";"Vallbona d'Anoia";"1";"1";"A";"476";"193";"328";"388";"88";"5";"1";"382";"383"
"8";"Barcelona";"2";"Catalunya Central";"6";"Anoia";"08292";"Vallbona d'Anoia";"1";"1";"B";"606";"239";"432";"508";"98";"2";"4";"502";"506"
"8";"Barcelona";"2";"Catalunya Central";"14";"Berguedà";"08293";"Vallcebre";"1";"1";"U";"221";"111";"166";"192";"29";"0";"0";"192";"192"
"8";"Barcelona";"2";"Catalunya Central";"6";"Anoia";"08297";"Veciana";"1";"1";"U";"139";"43";"85";"108";"31";"0";"0";"108";"108"
"8";"Barcelona";"2";"Catalunya Central";"24";"Osona";"08298";"Vic";"1";"1";"A";"502";"225";"339";"400";"102";"3";"4";"393";"397"
"8";"Barcelona";"2";"Catalunya Central";"24";"Osona";"08298";"Vic";"1";"1";"B";"337";"143";"201";"240";"97";"1";"1";"238";"239"
"8";"Barcelona";"2";"Catalunya Central";"24";"Osona";"08298";"Vic";"1";"1";"C";"553";"269";"390";"462";"91";"1";"0";"461";"461"
"8";"Barcelona";"2";"Catalunya Central";"24";"Osona";"08298";"Vic";"2";"1";"U";"640";"288";"433";"514";"126";"2";"3";"509";"512"
"8";"Barcelona";"2";"Catalunya Central";"24";"Osona";"08298";"Vic";"2";"2";"A";"585";"205";"433";"496";"89";"1";"0";"495";"495"
"8";"Barcelona";"2";"Catalunya Central";"24";"Osona";"08298";"Vic";"2";"2";"B";"457";"171";"327";"385";"72";"0";"4";"381";"385"
"8";"Barcelona";"2";"Catalunya Central";"24";"Osona";"08298";"Vic";"2";"2";"C";"595";"237";"445";"516";"79";"1";"2";"513";"515"
"8";"Barcelona";"2";"Catalunya Central";"24";"Osona";"08298";"Vic";"2";"3";"A";"646";"240";"445";"528";"118";"1";"1";"526";"527"
"8";"Barcelona";"2";"Catalunya Central";"24";"Osona";"08298";"Vic";"2";"3";"B";"769";"273";"537";"642";"127";"1";"4";"637";"641"
"8";"Barcelona";"2";"Catalunya Central";"24";"Osona";"08298";"Vic";"2";"4";"A";"554";"246";"381";"437";"117";"1";"2";"434";"436"
"8";"Barcelona";"2";"Catalunya Central";"24";"Osona";"08298";"Vic";"2";"4";"B";"606";"248";"418";"485";"121";"4";"4";"477";"481"
"8";"Barcelona";"2";"Catalunya Central";"24";"Osona";"08298";"Vic";"2";"5";"A";"643";"238";"412";"496";"147";"0";"2";"494";"496"
"8";"Barcelona";"2";"Catalunya Central";"24";"Osona";"08298";"Vic";"2";"5";"B";"743";"300";"520";"610";"133";"0";"0";"610";"610"
"8";"Barcelona";"2";"Catalunya Central";"24";"Osona";"08298";"Vic";"2";"6";"A";"614";"232";"379";"454";"160";"0";"2";"452";"454"
"8";"Barcelona";"2";"Catalunya Central";"24";"Osona";"08298";"Vic";"2";"6";"B";"750";"312";"507";"602";"148";"1";"3";"598";"601"
"8";"Barcelona";"2";"Catalunya Central";"24";"Osona";"08298";"Vic";"3";"1";"U";"877";"346";"642";"762";"115";"2";"4";"756";"760"
"8";"Barcelona";"2";"Catalunya Central";"24";"Osona";"08298";"Vic";"3";"10";"U";"680";"267";"497";"587";"93";"0";"2";"585";"587"
"8";"Barcelona";"2";"Catalunya Central";"24";"Osona";"08298";"Vic";"3";"11";"U";"718";"268";"433";"507";"211";"0";"2";"505";"507"
"8";"Barcelona";"2";"Catalunya Central";"24";"Osona";"08298";"Vic";"3";"12";"A";"654";"278";"482";"575";"79";"0";"1";"574";"575"
"8";"Barcelona";"2";"Catalunya Central";"24";"Osona";"08298";"Vic";"3";"12";"B";"809";"309";"579";"705";"104";"3";"2";"700";"702"
"8";"Barcelona";"2";"Catalunya Central";"24";"Osona";"08298";"Vic";"3";"3";"A";"473";"196";"307";"358";"115";"1";"0";"357";"357"
"8";"Barcelona";"2";"Catalunya Central";"24";"Osona";"08298";"Vic";"3";"3";"B";"385";"149";"256";"303";"82";"3";"1";"299";"300"
"8";"Barcelona";"2";"Catalunya Central";"24";"Osona";"08298";"Vic";"3";"3";"C";"469";"205";"331";"395";"74";"3";"1";"391";"392"
"8";"Barcelona";"2";"Catalunya Central";"24";"Osona";"08298";"Vic";"3";"4";"U";"596";"263";"413";"464";"132";"1";"2";"461";"463"
"8";"Barcelona";"2";"Catalunya Central";"24";"Osona";"08298";"Vic";"3";"5";"A";"516";"170";"304";"350";"166";"3";"1";"346";"347"
"8";"Barcelona";"2";"Catalunya Central";"24";"Osona";"08298";"Vic";"3";"5";"B";"426";"169";"261";"313";"113";"1";"1";"311";"312"
"8";"Barcelona";"2";"Catalunya Central";"24";"Osona";"08298";"Vic";"3";"5";"C";"452";"169";"285";"330";"122";"2";"1";"327";"328"
"8";"Barcelona";"2";"Catalunya Central";"24";"Osona";"08298";"Vic";"3";"6";"U";"834";"290";"511";"586";"248";"2";"1";"583";"584"
"8";"Barcelona";"2";"Catalunya Central";"24";"Osona";"08298";"Vic";"3";"7";"A";"567";"240";"416";"474";"93";"0";"1";"473";"474"
"8";"Barcelona";"2";"Catalunya Central";"24";"Osona";"08298";"Vic";"3";"7";"B";"363";"143";"248";"292";"71";"0";"4";"288";"292"
"8";"Barcelona";"2";"Catalunya Central";"24";"Osona";"08298";"Vic";"3";"7";"C";"491";"226";"358";"408";"83";"1";"0";"407";"407"
"8";"Barcelona";"2";"Catalunya Central";"24";"Osona";"08298";"Vic";"3";"7";"D";"577";"252";"422";"501";"76";"2";"4";"495";"499"
"8";"Barcelona";"2";"Catalunya Central";"24";"Osona";"08298";"Vic";"3";"8";"A";"609";"197";"364";"430";"179";"3";"1";"426";"427"
"8";"Barcelona";"2";"Catalunya Central";"24";"Osona";"08298";"Vic";"3";"8";"B";"588";"216";"359";"429";"159";"3";"4";"422";"426"
"8";"Barcelona";"2";"Catalunya Central";"24";"Osona";"08298";"Vic";"3";"9";"U";"589";"237";"426";"490";"99";"1";"1";"488";"489"
"8";"Barcelona";"2";"Catalunya Central";"24";"Osona";"08298";"Vic";"4";"1";"A";"696";"303";"493";"556";"140";"1";"2";"553";"555"
"8";"Barcelona";"2";"Catalunya Central";"24";"Osona";"08298";"Vic";"4";"1";"B";"755";"332";"516";"601";"154";"0";"2";"599";"601"
"8";"Barcelona";"2";"Catalunya Central";"24";"Osona";"08298";"Vic";"4";"2";"A";"575";"220";"386";"452";"123";"0";"2";"450";"452"
"8";"Barcelona";"2";"Catalunya Central";"24";"Osona";"08298";"Vic";"4";"2";"B";"526";"189";"323";"378";"148";"0";"3";"375";"378"
"8";"Barcelona";"2";"Catalunya Central";"24";"Osona";"08298";"Vic";"4";"2";"C";"588";"246";"403";"464";"124";"1";"2";"461";"463"
"8";"Barcelona";"2";"Catalunya Central";"24";"Osona";"08298";"Vic";"4";"3";"A";"413";"185";"288";"342";"71";"0";"3";"339";"342"
"8";"Barcelona";"2";"Catalunya Central";"24";"Osona";"08298";"Vic";"4";"3";"B";"514";"214";"372";"427";"87";"0";"1";"426";"427"
"8";"Barcelona";"2";"Catalunya Central";"24";"Osona";"08298";"Vic";"4";"4";"A";"521";"214";"347";"395";"126";"0";"1";"394";"395"
"8";"Barcelona";"2";"Catalunya Central";"24";"Osona";"08298";"Vic";"4";"4";"B";"544";"220";"361";"426";"118";"1";"1";"424";"425"
"8";"Barcelona";"2";"Catalunya Central";"24";"Osona";"08298";"Vic";"5";"1";"U";"572";"238";"425";"513";"59";"0";"1";"512";"513"
"8";"Barcelona";"2";"Catalunya Central";"14";"Berguedà";"08299";"Vilada";"1";"1";"U";"394";"192";"297";"330";"64";"4";"0";"326";"326"
"8";"Barcelona";"2";"Catalunya Central";"24";"Osona";"08303";"Vilanova de Sau";"1";"1";"U";"274";"107";"198";"239";"35";"2";"2";"235";"237"
"8";"Barcelona";"2";"Catalunya Central";"6";"Anoia";"08302";"Vilanova del Camí";"1";"1";"A";"651";"225";"392";"488";"163";"1";"2";"485";"487"
"8";"Barcelona";"2";"Catalunya Central";"6";"Anoia";"08302";"Vilanova del Camí";"1";"1";"B";"694";"269";"429";"502";"192";"2";"2";"498";"500"
"8";"Barcelona";"2";"Catalunya Central";"6";"Anoia";"08302";"Vilanova del Camí";"1";"2";"A";"676";"219";"416";"494";"182";"1";"6";"487";"493"
"8";"Barcelona";"2";"Catalunya Central";"6";"Anoia";"08302";"Vilanova del Camí";"1";"2";"B";"737";"252";"451";"546";"191";"3";"5";"538";"543"
"8";"Barcelona";"2";"Catalunya Central";"6";"Anoia";"08302";"Vilanova del Camí";"1";"3";"A";"633";"205";"368";"462";"171";"1";"5";"456";"461"
"8";"Barcelona";"2";"Catalunya Central";"6";"Anoia";"08302";"Vilanova del Camí";"1";"3";"B";"722";"235";"438";"551";"171";"1";"4";"546";"550"
"8";"Barcelona";"2";"Catalunya Central";"6";"Anoia";"08302";"Vilanova del Camí";"1";"4";"A";"637";"240";"400";"499";"138";"2";"6";"491";"497"
"8";"Barcelona";"2";"Catalunya Central";"6";"Anoia";"08302";"Vilanova del Camí";"1";"4";"B";"708";"273";"443";"554";"154";"2";"5";"547";"552"
"8";"Barcelona";"2";"Catalunya Central";"6";"Anoia";"08302";"Vilanova del Camí";"1";"5";"A";"550";"185";"336";"409";"141";"2";"3";"404";"407"
"8";"Barcelona";"2";"Catalunya Central";"6";"Anoia";"08302";"Vilanova del Camí";"1";"5";"B";"649";"252";"397";"500";"149";"5";"3";"492";"495"
"8";"Barcelona";"2";"Catalunya Central";"6";"Anoia";"08302";"Vilanova del Camí";"1";"5";"C";"482";"184";"315";"387";"95";"1";"2";"384";"386"
"8";"Barcelona";"2";"Catalunya Central";"6";"Anoia";"08302";"Vilanova del Camí";"1";"6";"U";"832";"300";"506";"630";"202";"3";"6";"621";"627"
"8";"Barcelona";"2";"Catalunya Central";"6";"Anoia";"08302";"Vilanova del Camí";"1";"7";"A";"565";"227";"357";"447";"118";"0";"3";"444";"447"
"8";"Barcelona";"2";"Catalunya Central";"6";"Anoia";"08302";"Vilanova del Camí";"1";"7";"B";"685";"250";"416";"514";"171";"0";"8";"506";"514"
"8";"Barcelona";"2";"Catalunya Central";"14";"Berguedà";"08308";"Viver i Serrateix";"1";"1";"U";"131";"56";"97";"117";"14";"0";"0";"117";"117"
"8";"Barcelona";"2";"Catalunya Central";"6";"Anoia";"08143";"Òdena";"1";"1";"A";"261";"97";"192";"237";"24";"1";"3";"233";"236"
"8";"Barcelona";"2";"Catalunya Central";"6";"Anoia";"08143";"Òdena";"1";"1";"B";"447";"167";"289";"360";"87";"0";"3";"357";"360"
"8";"Barcelona";"2";"Catalunya Central";"6";"Anoia";"08143";"Òdena";"1";"1";"C";"485";"159";"292";"368";"117";"0";"4";"364";"368"
"8";"Barcelona";"2";"Catalunya Central";"6";"Anoia";"08143";"Òdena";"1";"1";"D";"495";"167";"309";"403";"92";"0";"4";"399";"403"
"8";"Barcelona";"2";"Catalunya Central";"6";"Anoia";"08143";"Òdena";"1";"2";"A";"461";"158";"288";"338";"123";"1";"2";"335";"337"
"8";"Barcelona";"2";"Catalunya Central";"6";"Anoia";"08143";"Òdena";"1";"2";"B";"527";"170";"302";"381";"146";"1";"5";"375";"380"
"8";"Barcelona";"3";"Girona";"34";"Selva";"08082";"Fogars de la Selva";"1";"1";"A";"543";"191";"353";"407";"136";"2";"1";"404";"405"
"8";"Barcelona";"3";"Girona";"34";"Selva";"08082";"Fogars de la Selva";"1";"1";"B";"602";"208";"361";"436";"166";"5";"2";"429";"431"
"17";"Girona";"5";"Alt Pirineu i territori d'Aran";"15";"Cerdanya";"17006";"Alp";"1";"1";"A";"554";"206";"360";"450";"104";"1";"3";"446";"449"
"17";"Girona";"5";"Alt Pirineu i territori d'Aran";"15";"Cerdanya";"17006";"Alp";"1";"1";"B";"576";"226";"345";"453";"123";"0";"1";"452";"453"
"17";"Girona";"5";"Alt Pirineu i territori d'Aran";"15";"Cerdanya";"17024";"Bolvir";"1";"1";"U";"281";"85";"159";"225";"56";"3";"4";"218";"222"
"17";"Girona";"5";"Alt Pirineu i territori d'Aran";"15";"Cerdanya";"17061";"Das";"1";"1";"U";"164";"57";"106";"137";"27";"0";"1";"136";"137"
"17";"Girona";"5";"Alt Pirineu i territori d'Aran";"15";"Cerdanya";"17069";"Fontanals de Cerdanya";"1";"1";"U";"371";"147";"230";"319";"52";"4";"1";"314";"315"
"17";"Girona";"5";"Alt Pirineu i territori d'Aran";"15";"Cerdanya";"17078";"Ger";"1";"1";"U";"327";"161";"249";"271";"56";"2";"1";"268";"269"
"17";"Girona";"5";"Alt Pirineu i territori d'Aran";"15";"Cerdanya";"17082";"Guils de Cerdanya";"1";"1";"U";"412";"146";"272";"342";"70";"4";"4";"334";"338"
"17";"Girona";"5";"Alt Pirineu i territori d'Aran";"15";"Cerdanya";"17084";"Isòvol";"1";"1";"U";"235";"94";"151";"204";"31";"2";"4";"198";"202"
"17";"Girona";"5";"Alt Pirineu i territori d'Aran";"15";"Cerdanya";"17094";"Llívia";"1";"1";"A";"524";"190";"327";"410";"114";"4";"0";"406";"406"
"17";"Girona";"5";"Alt Pirineu i territori d'Aran";"15";"Cerdanya";"17094";"Llívia";"1";"1";"B";"516";"186";"306";"394";"122";"3";"2";"389";"391"
"17";"Girona";"5";"Alt Pirineu i territori d'Aran";"15";"Cerdanya";"17099";"Meranges";"1";"1";"U";"79";"20";"50";"67";"12";"0";"0";"67";"67"
"17";"Girona";"5";"Alt Pirineu i territori d'Aran";"15";"Cerdanya";"17141";"Puigcerdà";"1";"1";"U";"617";"147";"293";"371";"246";"0";"3";"368";"371"
"17";"Girona";"5";"Alt Pirineu i territori d'Aran";"15";"Cerdanya";"17141";"Puigcerdà";"1";"2";"A";"703";"215";"451";"544";"159";"2";"2";"540";"542"
"17";"Girona";"5";"Alt Pirineu i territori d'Aran";"15";"Cerdanya";"17141";"Puigcerdà";"1";"2";"B";"670";"217";"424";"523";"147";"6";"3";"514";"517"
"17";"Girona";"5";"Alt Pirineu i territori d'Aran";"15";"Cerdanya";"17141";"Puigcerdà";"1";"3";"A";"715";"236";"436";"550";"165";"3";"11";"536";"547"
"17";"Girona";"5";"Alt Pirineu i territori d'Aran";"15";"Cerdanya";"17141";"Puigcerdà";"1";"3";"B";"674";"215";"403";"522";"152";"2";"3";"517";"520"
"17";"Girona";"5";"Alt Pirineu i territori d'Aran";"15";"Cerdanya";"17141";"Puigcerdà";"1";"4";"A";"797";"199";"430";"551";"246";"5";"5";"541";"546"
"17";"Girona";"5";"Alt Pirineu i territori d'Aran";"15";"Cerdanya";"17141";"Puigcerdà";"1";"4";"B";"869";"240";"475";"621";"248";"2";"4";"615";"619"
"17";"Girona";"5";"Alt Pirineu i territori d'Aran";"15";"Cerdanya";"17141";"Puigcerdà";"1";"5";"U";"795";"217";"469";"614";"181";"2";"6";"606";"612"
"17";"Girona";"5";"Alt Pirineu i territori d'Aran";"15";"Cerdanya";"17206";"Urús";"1";"1";"U";"143";"53";"92";"115";"28";"1";"1";"113";"114"
"17";"Girona";"2";"Catalunya Central";"24";"Osona";"17063";"Espinelves";"1";"1";"U";"164";"93";"128";"150";"14";"3";"0";"147";"147"
"17";"Girona";"2";"Catalunya Central";"24";"Osona";"17212";"Vidrà";"1";"1";"U";"135";"55";"94";"119";"16";"0";"3";"116";"119"
"17";"Girona";"2";"Catalunya Central";"24";"Osona";"17220";"Viladrau";"1";"1";"U";"810";"370";"603";"707";"103";"3";"2";"702";"704"
"17";"Girona";"3";"Girona";"2";"Alt Empordà";"17001";"Agullana";"1";"1";"U";"579";"261";"426";"482";"97";"5";"1";"476";"477"
"17";"Girona";"3";"Girona";"20";"Gironès";"17002";"Aiguaviva";"1";"1";"U";"559";"235";"421";"501";"58";"2";"3";"496";"499"
"17";"Girona";"3";"Girona";"2";"Alt Empordà";"17003";"Albanyà";"1";"1";"U";"102";"40";"67";"86";"16";"0";"0";"86";"86"
"17";"Girona";"3";"Girona";"10";"Baix Empordà";"17004";"Albons";"1";"1";"U";"514";"255";"376";"449";"65";"4";"0";"445";"445"
"17";"Girona";"3";"Girona";"34";"Selva";"17007";"Amer";"1";"1";"A";"555";"264";"413";"463";"92";"3";"2";"458";"460"
"17";"Girona";"3";"Girona";"34";"Selva";"17007";"Amer";"1";"1";"B";"560";"276";"425";"465";"95";"1";"1";"463";"464"
"17";"Girona";"3";"Girona";"34";"Selva";"17007";"Amer";"1";"1";"C";"609";"303";"473";"531";"78";"4";"1";"526";"527"
"17";"Girona";"3";"Girona";"34";"Selva";"17008";"Anglès";"1";"1";"U";"823";"288";"630";"640";"183";"8";"6";"626";"632"
"17";"Girona";"3";"Girona";"34";"Selva";"17008";"Anglès";"1";"2";"A";"824";"306";"552";"650";"174";"12";"4";"634";"638"
"17";"Girona";"3";"Girona";"34";"Selva";"17008";"Anglès";"1";"2";"B";"786";"333";"549";"621";"165";"13";"2";"606";"608"
"17";"Girona";"3";"Girona";"34";"Selva";"17008";"Anglès";"1";"3";"A";"572";"215";"377";"451";"121";"7";"0";"444";"444"
"17";"Girona";"3";"Girona";"34";"Selva";"17008";"Anglès";"1";"3";"B";"644";"246";"436";"514";"130";"12";"1";"501";"502"
"17";"Girona";"3";"Girona";"34";"Selva";"17009";"Arbúcies";"1";"1";"A";"741";"278";"523";"620";"121";"16";"1";"603";"604"
"17";"Girona";"3";"Girona";"34";"Selva";"17009";"Arbúcies";"1";"1";"B";"802";"321";"570";"681";"121";"12";"6";"663";"669"
"17";"Girona";"3";"Girona";"34";"Selva";"17009";"Arbúcies";"1";"2";"A";"754";"297";"534";"629";"125";"3";"3";"623";"626"
"17";"Girona";"3";"Girona";"34";"Selva";"17009";"Arbúcies";"1";"2";"B";"756";"327";"554";"643";"113";"2";"4";"637";"641"
"17";"Girona";"3";"Girona";"34";"Selva";"17009";"Arbúcies";"2";"1";"A";"478";"191";"324";"396";"82";"1";"2";"393";"395"
"17";"Girona";"3";"Girona";"34";"Selva";"17009";"Arbúcies";"2";"1";"B";"512";"171";"371";"442";"70";"1";"0";"441";"441"
"17";"Girona";"3";"Girona";"19";"Garrotxa";"17010";"Argelaguer";"1";"1";"U";"332";"153";"250";"292";"40";"1";"5";"286";"291"
"17";"Girona";"3";"Girona";"2";"Alt Empordà";"17011";"Armentera, l'";"1";"1";"U";"642";"307";"525";"563";"79";"2";"5";"556";"561"
"17";"Girona";"3";"Girona";"2";"Alt Empordà";"17012";"Avinyonet de Puigventós";"1";"1";"A";"590";"244";"391";"478";"112";"6";"0";"472";"472"
"17";"Girona";"3";"Girona";"2";"Alt Empordà";"17012";"Avinyonet de Puigventós";"1";"1";"B";"552";"204";"343";"436";"116";"0";"1";"435";"436"
"17";"Girona";"3";"Girona";"28";"Pla de l'Estany";"17015";"Banyoles";"1";"1";"A";"559";"257";"386";"437";"122";"3";"0";"434";"434"
"17";"Girona";"3";"Girona";"28";"Pla de l'Estany";"17015";"Banyoles";"1";"1";"B";"604";"267";"437";"491";"113";"1";"0";"490";"490"
"17";"Girona";"3";"Girona";"28";"Pla de l'Estany";"17015";"Banyoles";"1";"2";"U";"727";"322";"490";"606";"121";"3";"2";"601";"603"
"17";"Girona";"3";"Girona";"28";"Pla de l'Estany";"17015";"Banyoles";"1";"3";"A";"454";"194";"320";"367";"87";"1";"1";"365";"366"
"17";"Girona";"3";"Girona";"28";"Pla de l'Estany";"17015";"Banyoles";"1";"3";"B";"493";"222";"346";"417";"76";"2";"0";"415";"415"
"17";"Girona";"3";"Girona";"28";"Pla de l'Estany";"17015";"Banyoles";"1";"4";"A";"612";"258";"405";"468";"144";"6";"1";"461";"462"
"17";"Girona";"3";"Girona";"28";"Pla de l'Estany";"17015";"Banyoles";"1";"4";"B";"678";"306";"466";"538";"140";"3";"1";"534";"535"
"17";"Girona";"3";"Girona";"28";"Pla de l'Estany";"17015";"Banyoles";"1";"5";"A";"519";"231";"365";"443";"76";"0";"2";"441";"443"
"17";"Girona";"3";"Girona";"28";"Pla de l'Estany";"17015";"Banyoles";"1";"5";"B";"520";"218";"369";"433";"87";"0";"3";"430";"433"
"17";"Girona";"3";"Girona";"28";"Pla de l'Estany";"17015";"Banyoles";"2";"1";"A";"624";"246";"456";"533";"91";"3";"2";"528";"530"
"17";"Girona";"3";"Girona";"28";"Pla de l'Estany";"17015";"Banyoles";"2";"1";"B";"660";"273";"483";"564";"96";"3";"2";"559";"561"
"17";"Girona";"3";"Girona";"28";"Pla de l'Estany";"17015";"Banyoles";"2";"2";"U";"930";"400";"683";"778";"152";"3";"3";"772";"775"
"17";"Girona";"3";"Girona";"28";"Pla de l'Estany";"17015";"Banyoles";"2";"3";"A";"634";"360";"443";"515";"119";"5";"2";"508";"510"
"17";"Girona";"3";"Girona";"28";"Pla de l'Estany";"17015";"Banyoles";"2";"3";"B";"685";"329";"500";"582";"103";"1";"2";"579";"581"
"17";"Girona";"3";"Girona";"28";"Pla de l'Estany";"17015";"Banyoles";"2";"4";"U";"544";"208";"360";"435";"109";"0";"2";"433";"435"
"17";"Girona";"3";"Girona";"28";"Pla de l'Estany";"17015";"Banyoles";"2";"5";"U";"932";"364";"681";"815";"117";"6";"5";"804";"809"
"17";"Girona";"3";"Girona";"28";"Pla de l'Estany";"17015";"Banyoles";"3";"1";"A";"634";"285";"466";"542";"92";"1";"0";"541";"541"
"17";"Girona";"3";"Girona";"28";"Pla de l'Estany";"17015";"Banyoles";"3";"1";"B";"685";"295";"504";"576";"109";"1";"4";"571";"575"
"17";"Girona";"3";"Girona";"28";"Pla de l'Estany";"17015";"Banyoles";"3";"2";"A";"512";"170";"285";"334";"178";"0";"2";"332";"334"
"17";"Girona";"3";"Girona";"28";"Pla de l'Estany";"17015";"Banyoles";"3";"2";"B";"472";"162";"254";"316";"156";"2";"0";"314";"314"
"17";"Girona";"3";"Girona";"10";"Baix Empordà";"17013";"Begur";"1";"1";"A";"611";"238";"392";"477";"134";"2";"0";"475";"475"
"17";"Girona";"3";"Girona";"10";"Baix Empordà";"17013";"Begur";"1";"1";"B";"612";"255";"386";"466";"146";"1";"1";"464";"465"
"17";"Girona";"3";"Girona";"10";"Baix Empordà";"17013";"Begur";"1";"2";"U";"616";"231";"434";"500";"116";"2";"1";"497";"498"
"17";"Girona";"3";"Girona";"10";"Baix Empordà";"17013";"Begur";"1";"3";"A";"488";"227";"335";"410";"78";"1";"1";"408";"409"
"17";"Girona";"3";"Girona";"10";"Baix Empordà";"17013";"Begur";"1";"3";"B";"450";"181";"283";"353";"97";"3";"0";"350";"350"
"17";"Girona";"3";"Girona";"10";"Baix Empordà";"17018";"Bellcaire d'Empordà";"1";"1";"U";"488";"228";"362";"418";"70";"2";"2";"414";"416"
"17";"Girona";"3";"Girona";"19";"Garrotxa";"17019";"Besalú";"1";"1";"A";"856";"343";"638";"719";"137";"4";"5";"710";"715"
"17";"Girona";"3";"Girona";"19";"Garrotxa";"17019";"Besalú";"1";"1";"B";"920";"414";"677";"788";"132";"5";"2";"781";"783"
"17";"Girona";"3";"Girona";"20";"Gironès";"17020";"Bescanó";"1";"1";"A";"591";"233";"403";"492";"99";"0";"1";"491";"492"
"17";"Girona";"3";"Girona";"20";"Gironès";"17020";"Bescanó";"1";"1";"B";"636";"287";"450";"546";"90";"3";"3";"540";"543"
"17";"Girona";"3";"Girona";"20";"Gironès";"17020";"Bescanó";"1";"2";"A";"443";"218";"334";"379";"64";"2";"2";"375";"377"
"17";"Girona";"3";"Girona";"20";"Gironès";"17020";"Bescanó";"1";"2";"B";"388";"155";"271";"335";"53";"0";"6";"329";"335"
"17";"Girona";"3";"Girona";"20";"Gironès";"17020";"Bescanó";"1";"3";"A";"731";"317";"545";"633";"98";"13";"8";"612";"620"
"17";"Girona";"3";"Girona";"20";"Gironès";"17020";"Bescanó";"1";"3";"B";"787";"310";"576";"673";"114";"14";"4";"655";"659"
"17";"Girona";"3";"Girona";"19";"Garrotxa";"17021";"Beuda";"1";"1";"U";"139";"44";"91";"114";"25";"0";"0";"114";"114"
"17";"Girona";"3";"Girona";"10";"Baix Empordà";"17022";"Bisbal d'Empordà, la";"1";"2";"A";"571";"262";"415";"462";"109";"3";"2";"457";"459"
"17";"Girona";"3";"Girona";"10";"Baix Empordà";"17022";"Bisbal d'Empordà, la";"1";"2";"B";"537";"225";"363";"421";"116";"0";"2";"419";"421"
"17";"Girona";"3";"Girona";"10";"Baix Empordà";"17022";"Bisbal d'Empordà, la";"1";"3";"A";"680";"323";"438";"511";"169";"1";"6";"504";"510"
"17";"Girona";"3";"Girona";"10";"Baix Empordà";"17022";"Bisbal d'Empordà, la";"1";"3";"B";"629";"271";"404";"486";"143";"1";"1";"484";"485"
"17";"Girona";"3";"Girona";"10";"Baix Empordà";"17022";"Bisbal d'Empordà, la";"1";"4";"A";"752";"295";"504";"620";"132";"0";"1";"619";"620"
"17";"Girona";"3";"Girona";"10";"Baix Empordà";"17022";"Bisbal d'Empordà, la";"1";"4";"B";"764";"321";"532";"629";"135";"2";"1";"626";"627"
"17";"Girona";"3";"Girona";"10";"Baix Empordà";"17022";"Bisbal d'Empordà, la";"2";"1";"A";"618";"231";"379";"458";"160";"1";"0";"457";"457"
"17";"Girona";"3";"Girona";"10";"Baix Empordà";"17022";"Bisbal d'Empordà, la";"2";"1";"B";"688";"267";"427";"519";"169";"3";"3";"513";"516"
"17";"Girona";"3";"Girona";"10";"Baix Empordà";"17022";"Bisbal d'Empordà, la";"2";"2";"U";"888";"322";"550";"655";"233";"8";"2";"645";"647"
"17";"Girona";"3";"Girona";"10";"Baix Empordà";"17022";"Bisbal d'Empordà, la";"2";"3";"U";"789";"304";"500";"601";"188";"3";"4";"594";"598"
"17";"Girona";"3";"Girona";"2";"Alt Empordà";"17234";"Biure";"1";"1";"U";"183";"87";"127";"147";"36";"0";"2";"145";"147"
"17";"Girona";"3";"Girona";"34";"Selva";"17023";"Blanes";"1";"1";"A";"478";"200";"309";"371";"107";"1";"1";"369";"370"
"17";"Girona";"3";"Girona";"34";"Selva";"17023";"Blanes";"1";"1";"B";"493";"222";"332";"394";"99";"0";"0";"394";"394"
"17";"Girona";"3";"Girona";"34";"Selva";"17023";"Blanes";"1";"2";"A";"640";"264";"420";"514";"126";"1";"0";"513";"513"
"17";"Girona";"3";"Girona";"34";"Selva";"17023";"Blanes";"1";"2";"B";"659";"298";"522";"543";"116";"1";"5";"537";"542"
"17";"Girona";"3";"Girona";"34";"Selva";"17023";"Blanes";"1";"4";"A";"745";"319";"466";"533";"212";"5";"2";"526";"528"
"17";"Girona";"3";"Girona";"34";"Selva";"17023";"Blanes";"1";"4";"B";"647";"277";"425";"477";"170";"5";"1";"471";"472"
"17";"Girona";"3";"Girona";"34";"Selva";"17023";"Blanes";"1";"6";"A";"710";"225";"385";"486";"224";"5";"1";"480";"481"
"17";"Girona";"3";"Girona";"34";"Selva";"17023";"Blanes";"1";"6";"B";"656";"227";"369";"460";"196";"10";"7";"443";"450"
"17";"Girona";"3";"Girona";"34";"Selva";"17023";"Blanes";"1";"7";"U";"740";"288";"531";"625";"115";"4";"1";"620";"621"
"17";"Girona";"3";"Girona";"34";"Selva";"17023";"Blanes";"2";"1";"A";"793";"312";"511";"612";"181";"3";"5";"604";"609"
"17";"Girona";"3";"Girona";"34";"Selva";"17023";"Blanes";"2";"1";"B";"816";"306";"502";"613";"203";"6";"4";"603";"607"
"17";"Girona";"3";"Girona";"34";"Selva";"17023";"Blanes";"2";"10";"A";"857";"214";"412";"519";"338";"2";"11";"506";"517"
"17";"Girona";"3";"Girona";"34";"Selva";"17023";"Blanes";"2";"10";"B";"766";"208";"411";"496";"270";"3";"5";"488";"493"
"17";"Girona";"3";"Girona";"34";"Selva";"17023";"Blanes";"2";"11";"A";"915";"252";"519";"682";"233";"5";"4";"673";"677"
"17";"Girona";"3";"Girona";"34";"Selva";"17023";"Blanes";"2";"11";"B";"810";"245";"476";"616";"194";"2";"5";"609";"614"
"17";"Girona";"3";"Girona";"34";"Selva";"17023";"Blanes";"2";"12";"U";"724";"283";"438";"524";"200";"4";"5";"515";"520"
"17";"Girona";"3";"Girona";"34";"Selva";"17023";"Blanes";"2";"13";"U";"800";"307";"504";"638";"162";"3";"2";"633";"635"
"17";"Girona";"3";"Girona";"34";"Selva";"17023";"Blanes";"2";"2";"A";"519";"173";"292";"352";"167";"5";"0";"347";"347"
"17";"Girona";"3";"Girona";"34";"Selva";"17023";"Blanes";"2";"2";"B";"478";"184";"284";"334";"144";"5";"4";"325";"329"
"17";"Girona";"3";"Girona";"34";"Selva";"17023";"Blanes";"2";"3";"A";"659";"225";"380";"462";"197";"2";"1";"459";"460"
"17";"Girona";"3";"Girona";"34";"Selva";"17023";"Blanes";"2";"3";"B";"645";"218";"375";"443";"202";"4";"3";"436";"439"
"17";"Girona";"3";"Girona";"34";"Selva";"17023";"Blanes";"2";"4";"A";"845";"294";"530";"631";"214";"4";"4";"623";"627"
"17";"Girona";"3";"Girona";"34";"Selva";"17023";"Blanes";"2";"4";"B";"829";"305";"499";"617";"212";"3";"3";"611";"614"
"17";"Girona";"3";"Girona";"34";"Selva";"17023";"Blanes";"2";"5";"A";"929";"235";"533";"664";"265";"7";"6";"651";"657"
"17";"Girona";"3";"Girona";"34";"Selva";"17023";"Blanes";"2";"5";"B";"827";"181";"461";"611";"216";"5";"4";"602";"606"
"17";"Girona";"3";"Girona";"34";"Selva";"17023";"Blanes";"2";"6";"A";"588";"202";"385";"454";"134";"2";"3";"449";"452"
"17";"Girona";"3";"Girona";"34";"Selva";"17023";"Blanes";"2";"6";"B";"551";"189";"388";"452";"99";"1";"2";"449";"451"
"17";"Girona";"3";"Girona";"34";"Selva";"17023";"Blanes";"2";"7";"A";"837";"248";"505";"655";"182";"10";"5";"640";"645"
"17";"Girona";"3";"Girona";"34";"Selva";"17023";"Blanes";"2";"7";"B";"858";"278";"510";"647";"211";"7";"3";"637";"640"
"17";"Girona";"3";"Girona";"34";"Selva";"17023";"Blanes";"2";"8";"U";"903";"323";"585";"738";"165";"6";"2";"730";"732"
"17";"Girona";"3";"Girona";"34";"Selva";"17023";"Blanes";"2";"9";"U";"645";"246";"414";"504";"141";"0";"2";"502";"504"
"17";"Girona";"3";"Girona";"34";"Selva";"17023";"Blanes";"3";"1";"A";"555";"198";"338";"398";"157";"2";"2";"394";"396"
"17";"Girona";"3";"Girona";"34";"Selva";"17023";"Blanes";"3";"1";"B";"547";"178";"340";"407";"140";"7";"2";"398";"400"
"17";"Girona";"3";"Girona";"34";"Selva";"17023";"Blanes";"3";"2";"U";"850";"247";"522";"606";"244";"2";"6";"598";"604"
"17";"Girona";"3";"Girona";"34";"Selva";"17023";"Blanes";"3";"3";"A";"578";"192";"328";"412";"166";"5";"0";"407";"407"
"17";"Girona";"3";"Girona";"34";"Selva";"17023";"Blanes";"3";"3";"B";"587";"207";"341";"408";"179";"5";"2";"401";"403"
"17";"Girona";"3";"Girona";"34";"Selva";"17023";"Blanes";"3";"3";"C";"252";"130";"190";"208";"44";"0";"1";"207";"208"
"17";"Girona";"3";"Girona";"34";"Selva";"17023";"Blanes";"3";"4";"A";"595";"192";"342";"395";"200";"6";"3";"386";"389"
"17";"Girona";"3";"Girona";"34";"Selva";"17023";"Blanes";"3";"4";"B";"497";"175";"318";"376";"121";"3";"2";"371";"373"
"17";"Girona";"3";"Girona";"34";"Selva";"17023";"Blanes";"3";"4";"C";"504";"165";"322";"390";"114";"3";"3";"384";"387"
"17";"Girona";"3";"Girona";"2";"Alt Empordà";"17029";"Boadella i les Escaules";"1";"1";"U";"201";"87";"143";"163";"38";"1";"2";"160";"162"
"17";"Girona";"3";"Girona";"20";"Gironès";"17025";"Bordils";"1";"1";"A";"571";"259";"454";"497";"74";"3";"0";"494";"494"
"17";"Girona";"3";"Girona";"20";"Gironès";"17025";"Bordils";"1";"1";"B";"544";"277";"422";"459";"85";"2";"1";"456";"457"
"17";"Girona";"3";"Girona";"2";"Alt Empordà";"17026";"Borrassà";"1";"1";"U";"536";"252";"411";"466";"70";"2";"1";"463";"464"
"17";"Girona";"3";"Girona";"34";"Selva";"17027";"Breda";"1";"1";"A";"772";"303";"572";"649";"123";"19";"2";"628";"630"
"17";"Girona";"3";"Girona";"34";"Selva";"17027";"Breda";"1";"1";"B";"777";"316";"551";"647";"130";"13";"0";"634";"634"
"17";"Girona";"3";"Girona";"34";"Selva";"17027";"Breda";"1";"2";"A";"625";"249";"454";"527";"98";"2";"2";"523";"525"
"17";"Girona";"3";"Girona";"34";"Selva";"17027";"Breda";"1";"2";"B";"648";"261";"471";"543";"105";"1";"1";"541";"542"
"17";"Girona";"3";"Girona";"34";"Selva";"17028";"Brunyola";"1";"1";"U";"301";"135";"201";"243";"58";"2";"1";"240";"241"
"17";"Girona";"3";"Girona";"2";"Alt Empordà";"17016";"Bàscara";"1";"1";"U";"721";"300";"514";"610";"111";"4";"7";"599";"606"
"17";"Girona";"3";"Girona";"2";"Alt Empordà";"17031";"Cabanelles";"1";"1";"U";"167";"56";"95";"132";"35";"0";"1";"131";"132"
"17";"Girona";"3";"Girona";"2";"Alt Empordà";"17030";"Cabanes";"1";"1";"U";"642";"256";"432";"511";"131";"0";"6";"505";"511"
"17";"Girona";"3";"Girona";"2";"Alt Empordà";"17032";"Cadaqués";"1";"1";"A";"858";"309";"516";"624";"234";"2";"2";"620";"622"
"17";"Girona";"3";"Girona";"2";"Alt Empordà";"17032";"Cadaqués";"1";"1";"B";"848";"308";"486";"625";"223";"6";"6";"613";"619"
"17";"Girona";"3";"Girona";"34";"Selva";"17033";"Caldes de Malavella";"1";"1";"A";"741";"320";"476";"577";"164";"4";"3";"570";"573"
"17";"Girona";"3";"Girona";"34";"Selva";"17033";"Caldes de Malavella";"1";"1";"B";"763";"323";"489";"598";"165";"1";"1";"596";"597"
"17";"Girona";"3";"Girona";"34";"Selva";"17033";"Caldes de Malavella";"1";"2";"A";"860";"246";"476";"661";"199";"1";"8";"652";"660"
"17";"Girona";"3";"Girona";"34";"Selva";"17033";"Caldes de Malavella";"1";"2";"B";"770";"314";"539";"573";"197";"3";"4";"566";"570"
"17";"Girona";"3";"Girona";"34";"Selva";"17033";"Caldes de Malavella";"1";"3";"A";"477";"214";"311";"373";"104";"0";"2";"371";"373"
"17";"Girona";"3";"Girona";"34";"Selva";"17033";"Caldes de Malavella";"1";"3";"B";"526";"228";"360";"430";"96";"1";"1";"428";"429"
"17";"Girona";"3";"Girona";"34";"Selva";"17033";"Caldes de Malavella";"1";"4";"A";"584";"252";"367";"436";"148";"2";"5";"429";"434"
"17";"Girona";"3";"Girona";"34";"Selva";"17033";"Caldes de Malavella";"1";"4";"B";"568";"231";"344";"420";"148";"1";"1";"418";"419"
"17";"Girona";"3";"Girona";"10";"Baix Empordà";"17034";"Calonge";"1";"1";"A";"570";"209";"349";"423";"147";"7";"4";"412";"416"
"17";"Girona";"3";"Girona";"10";"Baix Empordà";"17034";"Calonge";"1";"1";"B";"606";"219";"370";"443";"163";"6";"2";"435";"437"
"17";"Girona";"3";"Girona";"10";"Baix Empordà";"17034";"Calonge";"1";"1";"C";"708";"242";"436";"518";"190";"5";"2";"511";"513"
"17";"Girona";"3";"Girona";"10";"Baix Empordà";"17034";"Calonge";"1";"2";"A";"508";"216";"338";"398";"110";"3";"1";"394";"395"
"17";"Girona";"3";"Girona";"10";"Baix Empordà";"17034";"Calonge";"1";"2";"B";"582";"247";"373";"430";"152";"3";"1";"426";"427"
"17";"Girona";"3";"Girona";"10";"Baix Empordà";"17034";"Calonge";"1";"3";"A";"689";"260";"448";"537";"152";"0";"3";"534";"537"
"17";"Girona";"3";"Girona";"10";"Baix Empordà";"17034";"Calonge";"1";"3";"B";"671";"268";"447";"529";"142";"3";"0";"526";"526"
"17";"Girona";"3";"Girona";"10";"Baix Empordà";"17034";"Calonge";"1";"4";"A";"675";"254";"422";"520";"155";"2";"3";"515";"518"
"17";"Girona";"3";"Girona";"10";"Baix Empordà";"17034";"Calonge";"1";"4";"B";"723";"278";"446";"553";"170";"0";"4";"549";"553"
"17";"Girona";"3";"Girona";"10";"Baix Empordà";"17034";"Calonge";"1";"5";"A";"545";"193";"317";"409";"136";"1";"4";"404";"408"
"17";"Girona";"3";"Girona";"10";"Baix Empordà";"17034";"Calonge";"1";"5";"B";"561";"218";"344";"419";"142";"2";"1";"416";"417"
"17";"Girona";"3";"Girona";"31";"Ripollès";"17036";"Campdevànol";"1";"1";"A";"552";"200";"390";"476";"76";"5";"3";"468";"471"
"17";"Girona";"3";"Girona";"31";"Ripollès";"17036";"Campdevànol";"1";"1";"B";"569";"246";"415";"503";"66";"2";"0";"501";"501"
"17";"Girona";"3";"Girona";"31";"Ripollès";"17036";"Campdevànol";"1";"2";"U";"823";"278";"539";"665";"158";"1";"5";"659";"664"
"17";"Girona";"3";"Girona";"31";"Ripollès";"17036";"Campdevànol";"1";"3";"U";"790";"277";"503";"610";"180";"2";"4";"604";"608"
"17";"Girona";"3";"Girona";"31";"Ripollès";"17037";"Campelles";"1";"1";"U";"104";"30";"69";"92";"12";"0";"0";"92";"92"
"17";"Girona";"3";"Girona";"20";"Gironès";"17038";"Campllong";"1";"1";"U";"366";"156";"292";"331";"35";"1";"3";"327";"330"
"17";"Girona";"3";"Girona";"31";"Ripollès";"17039";"Camprodon";"1";"1";"A";"553";"262";"307";"473";"80";"0";"1";"472";"473"
"17";"Girona";"3";"Girona";"31";"Ripollès";"17039";"Camprodon";"1";"1";"B";"573";"254";"405";"485";"88";"1";"2";"482";"484"
"17";"Girona";"3";"Girona";"31";"Ripollès";"17039";"Camprodon";"1";"2";"U";"648";"268";"427";"534";"114";"1";"2";"531";"533"
"17";"Girona";"3";"Girona";"28";"Pla de l'Estany";"17035";"Camós";"1";"1";"U";"549";"230";"422";"491";"58";"1";"3";"487";"490"
"17";"Girona";"3";"Girona";"20";"Gironès";"17040";"Canet d'Adri";"1";"1";"U";"538";"240";"425";"479";"59";"1";"5";"473";"478"
"17";"Girona";"3";"Girona";"2";"Alt Empordà";"17041";"Cantallops";"1";"1";"U";"217";"83";"151";"181";"36";"3";"2";"176";"178"
"17";"Girona";"3";"Girona";"2";"Alt Empordà";"17042";"Capmany";"1";"1";"U";"412";"146";"276";"323";"89";"0";"3";"320";"323"
"17";"Girona";"3";"Girona";"20";"Gironès";"17044";"Cassà de la Selva";"1";"1";"A";"802";"363";"600";"699";"103";"3";"1";"695";"696"
"17";"Girona";"3";"Girona";"20";"Gironès";"17044";"Cassà de la Selva";"1";"1";"B";"753";"361";"579";"669";"84";"3";"3";"663";"666"
"17";"Girona";"3";"Girona";"20";"Gironès";"17044";"Cassà de la Selva";"1";"2";"A";"539";"253";"387";"430";"109";"3";"2";"425";"427"
"17";"Girona";"3";"Girona";"20";"Gironès";"17044";"Cassà de la Selva";"1";"2";"B";"599";"261";"411";"487";"112";"1";"1";"485";"486"
"17";"Girona";"3";"Girona";"20";"Gironès";"17044";"Cassà de la Selva";"2";"1";"A";"907";"397";"632";"721";"186";"1";"3";"717";"720"
"17";"Girona";"3";"Girona";"20";"Gironès";"17044";"Cassà de la Selva";"2";"1";"B";"930";"391";"649";"755";"175";"6";"5";"744";"749"
"17";"Girona";"3";"Girona";"20";"Gironès";"17044";"Cassà de la Selva";"2";"2";"A";"819";"325";"561";"656";"163";"6";"3";"647";"650"
"17";"Girona";"3";"Girona";"20";"Gironès";"17044";"Cassà de la Selva";"2";"2";"B";"747";"334";"515";"612";"135";"3";"4";"605";"609"
"17";"Girona";"3";"Girona";"20";"Gironès";"17044";"Cassà de la Selva";"2";"3";"U";"677";"400";"500";"582";"95";"0";"6";"576";"582"
"17";"Girona";"3";"Girona";"10";"Baix Empordà";"17048";"Castell-Platja d'Aro";"1";"1";"A";"610";"229";"396";"478";"132";"4";"1";"473";"474"
"17";"Girona";"3";"Girona";"10";"Baix Empordà";"17048";"Castell-Platja d'Aro";"1";"1";"B";"607";"247";"413";"493";"114";"4";"1";"488";"489"
"17";"Girona";"3";"Girona";"10";"Baix Empordà";"17048";"Castell-Platja d'Aro";"1";"2";"A";"582";"190";"347";"424";"158";"1";"5";"418";"423"
"17";"Girona";"3";"Girona";"10";"Baix Empordà";"17048";"Castell-Platja d'Aro";"1";"2";"B";"549";"168";"301";"369";"180";"4";"0";"365";"365"
"17";"Girona";"3";"Girona";"10";"Baix Empordà";"17048";"Castell-Platja d'Aro";"1";"2";"C";"578";"178";"331";"416";"162";"0";"2";"414";"416"
"17";"Girona";"3";"Girona";"10";"Baix Empordà";"17048";"Castell-Platja d'Aro";"1";"3";"A";"514";"173";"309";"391";"123";"4";"1";"386";"387"
"17";"Girona";"3";"Girona";"10";"Baix Empordà";"17048";"Castell-Platja d'Aro";"1";"3";"B";"620";"224";"356";"459";"161";"4";"2";"453";"455"
"17";"Girona";"3";"Girona";"10";"Baix Empordà";"17048";"Castell-Platja d'Aro";"1";"3";"C";"551";"190";"325";"406";"145";"1";"1";"404";"405"
"17";"Girona";"3";"Girona";"10";"Baix Empordà";"17048";"Castell-Platja d'Aro";"1";"4";"U";"745";"255";"428";"540";"205";"3";"3";"534";"537"
"17";"Girona";"3";"Girona";"10";"Baix Empordà";"17048";"Castell-Platja d'Aro";"1";"5";"U";"925";"348";"590";"710";"215";"8";"0";"702";"702"
"17";"Girona";"3";"Girona";"19";"Garrotxa";"17046";"Castellfollit de la Roca";"1";"1";"U";"715";"325";"516";"592";"123";"6";"4";"582";"586"
"17";"Girona";"3";"Girona";"2";"Alt Empordà";"17047";"Castelló d'Empúries";"1";"1";"A";"657";"254";"428";"505";"152";"1";"1";"503";"504"
"17";"Girona";"3";"Girona";"2";"Alt Empordà";"17047";"Castelló d'Empúries";"1";"1";"B";"664";"249";"426";"510";"154";"2";"4";"504";"508"
"17";"Girona";"3";"Girona";"2";"Alt Empordà";"17047";"Castelló d'Empúries";"1";"2";"A";"635";"268";"445";"521";"114";"0";"3";"518";"521"
"17";"Girona";"3";"Girona";"2";"Alt Empordà";"17047";"Castelló d'Empúries";"1";"2";"B";"610";"249";"416";"479";"131";"0";"4";"475";"479"
"17";"Girona";"3";"Girona";"2";"Alt Empordà";"17047";"Castelló d'Empúries";"1";"3";"A";"592";"215";"321";"395";"197";"0";"3";"392";"395"
"17";"Girona";"3";"Girona";"2";"Alt Empordà";"17047";"Castelló d'Empúries";"1";"3";"B";"596";"207";"312";"379";"217";"2";"0";"377";"377"
"17";"Girona";"3";"Girona";"2";"Alt Empordà";"17047";"Castelló d'Empúries";"1";"4";"A";"545";"153";"256";"326";"219";"1";"1";"324";"325"
"17";"Girona";"3";"Girona";"2";"Alt Empordà";"17047";"Castelló d'Empúries";"1";"4";"B";"523";"152";"263";"327";"196";"0";"2";"325";"327"
"17";"Girona";"3";"Girona";"34";"Selva";"17189";"Cellera de Ter, la";"1";"1";"U";"808";"328";"623";"703";"105";"4";"1";"698";"699"
"17";"Girona";"3";"Girona";"34";"Selva";"17189";"Cellera de Ter, la";"1";"2";"U";"721";"320";"542";"614";"107";"1";"3";"610";"613"
"17";"Girona";"3";"Girona";"20";"Gironès";"17049";"Celrà";"1";"1";"A";"596";"279";"448";"521";"75";"4";"3";"514";"517"
"17";"Girona";"3";"Girona";"20";"Gironès";"17049";"Celrà";"1";"1";"B";"593";"261";"439";"521";"72";"0";"2";"519";"521"
"17";"Girona";"3";"Girona";"20";"Gironès";"17049";"Celrà";"1";"2";"A";"650";"220";"430";"527";"123";"4";"3";"520";"523"
"17";"Girona";"3";"Girona";"20";"Gironès";"17049";"Celrà";"1";"2";"B";"657";"244";"425";"527";"130";"5";"4";"518";"522"
"17";"Girona";"3";"Girona";"20";"Gironès";"17049";"Celrà";"1";"3";"U";"628";"277";"440";"526";"102";"3";"5";"518";"523"
"17";"Girona";"3";"Girona";"20";"Gironès";"17050";"Cervià de Ter";"1";"1";"U";"656";"320";"501";"586";"70";"1";"6";"579";"585"
"17";"Girona";"3";"Girona";"2";"Alt Empordà";"17051";"Cistella";"1";"1";"U";"220";"78";"155";"184";"36";"1";"2";"181";"183"
"17";"Girona";"3";"Girona";"2";"Alt Empordà";"17054";"Colera";"1";"1";"U";"372";"179";"238";"293";"79";"4";"0";"289";"289"
"17";"Girona";"3";"Girona";"10";"Baix Empordà";"17055";"Colomers";"1";"1";"U";"154";"88";"115";"133";"21";"0";"0";"133";"133"
"17";"Girona";"3";"Girona";"28";"Pla de l'Estany";"17056";"Cornellà del Terri";"1";"1";"A";"862";"356";"610";"731";"131";"0";"5";"726";"731"
"17";"Girona";"3";"Girona";"28";"Pla de l'Estany";"17056";"Cornellà del Terri";"1";"1";"B";"844";"310";"615";"721";"123";"3";"3";"715";"718"
"17";"Girona";"3";"Girona";"10";"Baix Empordà";"17057";"Corçà";"1";"1";"A";"474";"204";"360";"405";"69";"4";"3";"398";"401"
"17";"Girona";"3";"Girona";"10";"Baix Empordà";"17057";"Corçà";"1";"1";"B";"484";"224";"366";"400";"84";"0";"1";"399";"400"
"17";"Girona";"3";"Girona";"28";"Pla de l'Estany";"17058";"Crespià";"1";"1";"U";"183";"82";"111";"139";"44";"0";"1";"138";"139"
"17";"Girona";"3";"Girona";"10";"Baix Empordà";"17901";"Cruïlles, Monells i Sant Sadurní";"1";"1";"A";"518";"258";"372";"422";"96";"1";"4";"417";"421"
"17";"Girona";"3";"Girona";"10";"Baix Empordà";"17901";"Cruïlles, Monells i Sant Sadurní";"1";"1";"B";"224";"80";"144";"186";"38";"0";"2";"184";"186"
"17";"Girona";"3";"Girona";"10";"Baix Empordà";"17901";"Cruïlles, Monells i Sant Sadurní";"1";"1";"C";"245";"122";"177";"216";"29";"1";"2";"213";"215"
"17";"Girona";"3";"Girona";"2";"Alt Empordà";"17060";"Darnius";"1";"1";"U";"416";"145";"276";"330";"86";"0";"2";"328";"330"
"17";"Girona";"3";"Girona";"2";"Alt Empordà";"17062";"Escala, l'";"1";"1";"U";"791";"292";"491";"585";"206";"0";"0";"585";"585"
"17";"Girona";"3";"Girona";"2";"Alt Empordà";"17062";"Escala, l'";"1";"2";"A";"899";"273";"509";"629";"270";"1";"6";"622";"628"
"17";"Girona";"3";"Girona";"2";"Alt Empordà";"17062";"Escala, l'";"1";"2";"B";"849";"279";"498";"593";"256";"2";"1";"590";"591"
"17";"Girona";"3";"Girona";"2";"Alt Empordà";"17062";"Escala, l'";"1";"3";"A";"604";"260";"407";"482";"122";"0";"1";"481";"482"
"17";"Girona";"3";"Girona";"2";"Alt Empordà";"17062";"Escala, l'";"1";"3";"B";"584";"226";"366";"441";"143";"2";"3";"436";"439"
"17";"Girona";"3";"Girona";"2";"Alt Empordà";"17062";"Escala, l'";"1";"4";"A";"592";"253";"366";"429";"163";"1";"4";"424";"428"
"17";"Girona";"3";"Girona";"2";"Alt Empordà";"17062";"Escala, l'";"1";"4";"B";"528";"220";"347";"413";"115";"1";"1";"411";"412"
"17";"Girona";"3";"Girona";"2";"Alt Empordà";"17062";"Escala, l'";"1";"5";"A";"569";"206";"314";"396";"173";"1";"2";"393";"395"
"17";"Girona";"3";"Girona";"2";"Alt Empordà";"17062";"Escala, l'";"1";"5";"B";"555";"181";"317";"398";"157";"1";"2";"395";"397"
"17";"Girona";"3";"Girona";"2";"Alt Empordà";"17064";"Espolla";"1";"1";"U";"323";"139";"222";"279";"44";"4";"6";"269";"275"
"17";"Girona";"3";"Girona";"28";"Pla de l'Estany";"17065";"Esponellà";"1";"1";"U";"329";"125";"235";"284";"45";"1";"2";"281";"283"
"17";"Girona";"3";"Girona";"2";"Alt Empordà";"17005";"Far d'Empordà, el";"1";"1";"U";"401";"163";"281";"308";"93";"2";"0";"306";"306"
"17";"Girona";"3";"Girona";"2";"Alt Empordà";"17066";"Figueres";"1";"1";"U";"671";"242";"397";"496";"175";"2";"2";"492";"494"
"17";"Girona";"3";"Girona";"2";"Alt Empordà";"17066";"Figueres";"1";"2";"U";"825";"309";"533";"651";"174";"2";"3";"646";"649"
"17";"Girona";"3";"Girona";"2";"Alt Empordà";"17066";"Figueres";"1";"3";"A";"867";"237";"443";"632";"235";"1";"3";"628";"631"
"17";"Girona";"3";"Girona";"2";"Alt Empordà";"17066";"Figueres";"1";"3";"B";"817";"263";"508";"605";"212";"2";"9";"594";"603"
"17";"Girona";"3";"Girona";"2";"Alt Empordà";"17066";"Figueres";"1";"4";"U";"804";"308";"501";"579";"225";"2";"1";"576";"577"
"17";"Girona";"3";"Girona";"2";"Alt Empordà";"17066";"Figueres";"1";"5";"U";"808";"158";"281";"333";"475";"1";"3";"329";"332"
"17";"Girona";"3";"Girona";"2";"Alt Empordà";"17066";"Figueres";"1";"6";"A";"720";"239";"349";"403";"317";"9";"1";"393";"394"
"17";"Girona";"3";"Girona";"2";"Alt Empordà";"17066";"Figueres";"1";"6";"B";"653";"269";"372";"434";"219";"5";"1";"428";"429"
"17";"Girona";"3";"Girona";"2";"Alt Empordà";"17066";"Figueres";"1";"7";"U";"1089";"369";"582";"708";"381";"3";"7";"698";"705"
"17";"Girona";"3";"Girona";"2";"Alt Empordà";"17066";"Figueres";"1";"8";"U";"601";"226";"341";"403";"198";"1";"3";"399";"402"
"17";"Girona";"3";"Girona";"2";"Alt Empordà";"17066";"Figueres";"2";"1";"U";"453";"182";"247";"304";"149";"1";"0";"303";"303"
"17";"Girona";"3";"Girona";"2";"Alt Empordà";"17066";"Figueres";"2";"2";"U";"950";"316";"545";"651";"299";"5";"4";"642";"646"
"17";"Girona";"3";"Girona";"2";"Alt Empordà";"17066";"Figueres";"2";"3";"U";"775";"330";"518";"628";"147";"0";"1";"627";"628"
"17";"Girona";"3";"Girona";"2";"Alt Empordà";"17066";"Figueres";"2";"4";"A";"763";"269";"453";"543";"220";"1";"3";"539";"542"
"17";"Girona";"3";"Girona";"2";"Alt Empordà";"17066";"Figueres";"2";"4";"B";"701";"260";"441";"500";"201";"1";"6";"493";"499"
"17";"Girona";"3";"Girona";"2";"Alt Empordà";"17066";"Figueres";"2";"5";"U";"554";"203";"333";"397";"157";"0";"2";"395";"397"
"17";"Girona";"3";"Girona";"2";"Alt Empordà";"17066";"Figueres";"3";"1";"U";"605";"265";"377";"433";"172";"2";"3";"428";"431"
"17";"Girona";"3";"Girona";"2";"Alt Empordà";"17066";"Figueres";"3";"2";"A";"810";"281";"433";"532";"278";"1";"1";"530";"531"
"17";"Girona";"3";"Girona";"2";"Alt Empordà";"17066";"Figueres";"3";"2";"B";"449";"172";"282";"337";"112";"3";"4";"330";"334"
"17";"Girona";"3";"Girona";"2";"Alt Empordà";"17066";"Figueres";"3";"3";"A";"817";"316";"478";"586";"231";"8";"3";"575";"578"
"17";"Girona";"3";"Girona";"2";"Alt Empordà";"17066";"Figueres";"3";"3";"B";"728";"222";"434";"522";"206";"1";"3";"518";"521"
"17";"Girona";"3";"Girona";"2";"Alt Empordà";"17066";"Figueres";"3";"4";"U";"774";"233";"371";"443";"331";"2";"4";"437";"441"
"17";"Girona";"3";"Girona";"2";"Alt Empordà";"17066";"Figueres";"3";"5";"A";"830";"263";"493";"608";"222";"3";"4";"601";"605"
"17";"Girona";"3";"Girona";"2";"Alt Empordà";"17066";"Figueres";"3";"5";"B";"755";"248";"459";"544";"211";"3";"6";"535";"541"
"17";"Girona";"3";"Girona";"2";"Alt Empordà";"17066";"Figueres";"4";"1";"U";"871";"247";"467";"614";"257";"0";"1";"613";"614"
"17";"Girona";"3";"Girona";"2";"Alt Empordà";"17066";"Figueres";"4";"2";"A";"636";"234";"400";"484";"152";"0";"3";"481";"484"
"17";"Girona";"3";"Girona";"2";"Alt Empordà";"17066";"Figueres";"4";"2";"B";"570";"230";"342";"424";"146";"2";"2";"420";"422"
"17";"Girona";"3";"Girona";"2";"Alt Empordà";"17066";"Figueres";"4";"3";"A";"707";"230";"379";"485";"222";"1";"3";"481";"484"
"17";"Girona";"3";"Girona";"2";"Alt Empordà";"17066";"Figueres";"4";"3";"B";"691";"255";"383";"473";"218";"2";"1";"470";"471"
"17";"Girona";"3";"Girona";"2";"Alt Empordà";"17066";"Figueres";"4";"4";"A";"810";"309";"500";"604";"206";"2";"2";"600";"602"
"17";"Girona";"3";"Girona";"2";"Alt Empordà";"17066";"Figueres";"4";"4";"B";"893";"297";"527";"647";"246";"8";"1";"638";"639"
"17";"Girona";"3";"Girona";"2";"Alt Empordà";"17066";"Figueres";"4";"5";"U";"1078";"323";"583";"701";"377";"1";"5";"695";"700"
"17";"Girona";"3";"Girona";"2";"Alt Empordà";"17066";"Figueres";"4";"7";"U";"725";"315";"490";"553";"172";"1";"4";"548";"552"
"17";"Girona";"3";"Girona";"2";"Alt Empordà";"17066";"Figueres";"4";"8";"U";"743";"258";"418";"523";"220";"6";"0";"517";"517"
"17";"Girona";"3";"Girona";"2";"Alt Empordà";"17066";"Figueres";"4";"9";"U";"946";"376";"619";"757";"189";"5";"5";"747";"752"
"17";"Girona";"3";"Girona";"20";"Gironès";"17067";"Flaçà";"1";"1";"U";"707";"300";"520";"605";"102";"3";"6";"596";"602"
"17";"Girona";"3";"Girona";"10";"Baix Empordà";"17068";"Foixà";"1";"1";"U";"246";"105";"182";"215";"31";"1";"0";"214";"214"
"17";"Girona";"3";"Girona";"10";"Baix Empordà";"17070";"Fontanilles";"1";"1";"U";"107";"48";"80";"96";"11";"1";"1";"94";"95"
"17";"Girona";"3";"Girona";"28";"Pla de l'Estany";"17071";"Fontcoberta";"1";"1";"A";"541";"230";"423";"468";"73";"0";"2";"466";"468"
"17";"Girona";"3";"Girona";"28";"Pla de l'Estany";"17071";"Fontcoberta";"1";"1";"B";"583";"269";"449";"518";"65";"1";"2";"515";"517"
"17";"Girona";"3";"Girona";"10";"Baix Empordà";"17902";"Forallac";"1";"1";"U";"765";"330";"545";"656";"109";"4";"6";"646";"652"
"17";"Girona";"3";"Girona";"10";"Baix Empordà";"17902";"Forallac";"1";"2";"A";"234";"96";"170";"212";"22";"0";"0";"212";"212"
"17";"Girona";"3";"Girona";"10";"Baix Empordà";"17902";"Forallac";"1";"2";"B";"349";"156";"232";"296";"53";"1";"1";"294";"295"
"17";"Girona";"3";"Girona";"20";"Gironès";"17073";"Fornells de la Selva";"1";"1";"A";"925";"382";"720";"834";"91";"1";"3";"830";"833"
"17";"Girona";"3";"Girona";"20";"Gironès";"17073";"Fornells de la Selva";"1";"1";"B";"927";"423";"731";"843";"84";"1";"3";"839";"842"
"17";"Girona";"3";"Girona";"2";"Alt Empordà";"17074";"Fortià";"1";"1";"U";"510";"202";"348";"412";"98";"0";"2";"410";"412"
"17";"Girona";"3";"Girona";"10";"Baix Empordà";"17076";"Garrigoles";"1";"1";"U";"122";"57";"81";"101";"21";"5";"0";"96";"96"
"17";"Girona";"3";"Girona";"2";"Alt Empordà";"17077";"Garriguella";"1";"1";"U";"552";"211";"382";"463";"89";"5";"3";"455";"458"
"17";"Girona";"3";"Girona";"2";"Alt Empordà";"17075";"Garrigàs";"1";"1";"U";"328";"131";"221";"260";"68";"2";"2";"256";"258"
"17";"Girona";"3";"Girona";"20";"Gironès";"17079";"Girona";"1";"1";"U";"715";"275";"453";"553";"162";"2";"1";"550";"551"
"17";"Girona";"3";"Girona";"20";"Gironès";"17079";"Girona";"1";"2";"U";"668";"270";"474";"538";"130";"2";"2";"534";"536"
"17";"Girona";"3";"Girona";"20";"Gironès";"17079";"Girona";"1";"3";"U";"886";"323";"580";"696";"190";"0";"3";"693";"696"
"17";"Girona";"3";"Girona";"20";"Gironès";"17079";"Girona";"1";"4";"U";"785";"284";"450";"558";"227";"2";"3";"553";"556"
"17";"Girona";"3";"Girona";"20";"Gironès";"17079";"Girona";"1";"5";"A";"464";"83";"147";"184";"280";"2";"0";"182";"182"
"17";"Girona";"3";"Girona";"20";"Gironès";"17079";"Girona";"1";"5";"B";"551";"132";"199";"269";"282";"0";"0";"269";"269"
"17";"Girona";"3";"Girona";"20";"Gironès";"17079";"Girona";"1";"6";"A";"513";"201";"333";"369";"144";"4";"1";"364";"365"
"17";"Girona";"3";"Girona";"20";"Gironès";"17079";"Girona";"1";"6";"B";"487";"212";"288";"330";"157";"2";"5";"323";"328"
"17";"Girona";"3";"Girona";"20";"Gironès";"17079";"Girona";"2";"1";"U";"569";"257";"409";"480";"89";"1";"2";"477";"479"
"17";"Girona";"3";"Girona";"20";"Gironès";"17079";"Girona";"2";"10";"A";"827";"324";"578";"697";"130";"4";"5";"688";"693"
"17";"Girona";"3";"Girona";"20";"Gironès";"17079";"Girona";"2";"10";"B";"770";"303";"545";"648";"122";"4";"1";"643";"644"
"17";"Girona";"3";"Girona";"20";"Gironès";"17079";"Girona";"2";"11";"A";"718";"260";"484";"583";"135";"1";"1";"581";"582"
"17";"Girona";"3";"Girona";"20";"Gironès";"17079";"Girona";"2";"11";"B";"732";"275";"482";"566";"166";"3";"4";"559";"563"
"17";"Girona";"3";"Girona";"20";"Gironès";"17079";"Girona";"2";"12";"A";"513";"200";"341";"426";"87";"0";"0";"426";"426"
"17";"Girona";"3";"Girona";"20";"Gironès";"17079";"Girona";"2";"12";"B";"478";"200";"344";"405";"73";"1";"2";"402";"404"
"17";"Girona";"3";"Girona";"20";"Gironès";"17079";"Girona";"2";"13";"U";"750";"290";"500";"622";"128";"2";"4";"616";"620"
"17";"Girona";"3";"Girona";"20";"Gironès";"17079";"Girona";"2";"14";"U";"644";"252";"401";"491";"153";"4";"2";"485";"487"
"17";"Girona";"3";"Girona";"20";"Gironès";"17079";"Girona";"2";"15";"A";"591";"275";"420";"506";"85";"0";"5";"501";"506"
"17";"Girona";"3";"Girona";"20";"Gironès";"17079";"Girona";"2";"15";"B";"561";"214";"391";"476";"85";"0";"3";"473";"476"
"17";"Girona";"3";"Girona";"20";"Gironès";"17079";"Girona";"2";"15";"C";"620";"239";"414";"506";"114";"1";"3";"502";"505"
"17";"Girona";"3";"Girona";"20";"Gironès";"17079";"Girona";"2";"16";"A";"503";"193";"346";"417";"86";"1";"3";"413";"416"
"17";"Girona";"3";"Girona";"20";"Gironès";"17079";"Girona";"2";"16";"B";"464";"243";"371";"419";"45";"0";"6";"413";"419"
"17";"Girona";"3";"Girona";"20";"Gironès";"17079";"Girona";"2";"17";"A";"509";"227";"369";"444";"65";"2";"1";"441";"442"
"17";"Girona";"3";"Girona";"20";"Gironès";"17079";"Girona";"2";"17";"B";"457";"202";"337";"403";"54";"2";"0";"401";"401"
"17";"Girona";"3";"Girona";"20";"Gironès";"17079";"Girona";"2";"18";"A";"504";"267";"379";"432";"72";"1";"1";"430";"431"
"17";"Girona";"3";"Girona";"20";"Gironès";"17079";"Girona";"2";"18";"B";"575";"282";"429";"497";"78";"5";"3";"489";"492"
"17";"Girona";"3";"Girona";"20";"Gironès";"17079";"Girona";"2";"19";"A";"857";"366";"607";"741";"116";"5";"8";"728";"736"
"17";"Girona";"3";"Girona";"20";"Gironès";"17079";"Girona";"2";"19";"B";"866";"302";"639";"766";"100";"3";"7";"756";"763"
"17";"Girona";"3";"Girona";"20";"Gironès";"17079";"Girona";"2";"2";"U";"636";"215";"422";"510";"126";"4";"3";"503";"506"
"17";"Girona";"3";"Girona";"20";"Gironès";"17079";"Girona";"2";"20";"U";"908";"302";"595";"751";"157";"4";"8";"739";"747"
"17";"Girona";"3";"Girona";"20";"Gironès";"17079";"Girona";"2";"21";"A";"520";"228";"362";"428";"92";"5";"1";"422";"423"
"17";"Girona";"3";"Girona";"20";"Gironès";"17079";"Girona";"2";"21";"B";"490";"200";"338";"412";"78";"0";"2";"410";"412"
"17";"Girona";"3";"Girona";"20";"Gironès";"17079";"Girona";"2";"22";"U";"871";"335";"552";"704";"167";"4";"5";"695";"700"
"17";"Girona";"3";"Girona";"20";"Gironès";"17079";"Girona";"2";"3";"U";"928";"347";"617";"766";"162";"0";"4";"762";"766"
"17";"Girona";"3";"Girona";"20";"Gironès";"17079";"Girona";"2";"4";"A";"583";"243";"431";"505";"78";"0";"0";"505";"505"
"17";"Girona";"3";"Girona";"20";"Gironès";"17079";"Girona";"2";"4";"B";"609";"216";"442";"524";"85";"2";"1";"521";"522"
"17";"Girona";"3";"Girona";"20";"Gironès";"17079";"Girona";"2";"5";"U";"728";"284";"468";"583";"145";"0";"5";"578";"583"
"17";"Girona";"3";"Girona";"20";"Gironès";"17079";"Girona";"2";"6";"A";"728";"311";"498";"604";"124";"0";"3";"601";"604"
"17";"Girona";"3";"Girona";"20";"Gironès";"17079";"Girona";"2";"6";"B";"673";"263";"449";"548";"125";"0";"4";"544";"548"
"17";"Girona";"3";"Girona";"20";"Gironès";"17079";"Girona";"2";"7";"A";"627";"274";"405";"535";"92";"1";"0";"534";"534"
"17";"Girona";"3";"Girona";"20";"Gironès";"17079";"Girona";"2";"7";"B";"603";"249";"446";"503";"100";"2";"3";"498";"501"
"17";"Girona";"3";"Girona";"20";"Gironès";"17079";"Girona";"2";"8";"A";"723";"274";"510";"620";"103";"0";"2";"618";"620"
"17";"Girona";"3";"Girona";"20";"Gironès";"17079";"Girona";"2";"8";"B";"742";"304";"547";"644";"98";"1";"3";"640";"643"
"17";"Girona";"3";"Girona";"20";"Gironès";"17079";"Girona";"2";"9";"A";"474";"190";"307";"363";"111";"1";"4";"358";"362"
"17";"Girona";"3";"Girona";"20";"Gironès";"17079";"Girona";"2";"9";"B";"515";"238";"371";"424";"91";"0";"2";"422";"424"
"17";"Girona";"3";"Girona";"20";"Gironès";"17079";"Girona";"3";"1";"U";"693";"307";"480";"593";"100";"3";"2";"588";"590"
"17";"Girona";"3";"Girona";"20";"Gironès";"17079";"Girona";"3";"10";"A";"572";"197";"332";"400";"172";"3";"4";"393";"397"
"17";"Girona";"3";"Girona";"20";"Gironès";"17079";"Girona";"3";"10";"B";"603";"233";"369";"441";"162";"0";"3";"438";"441"
"17";"Girona";"3";"Girona";"20";"Gironès";"17079";"Girona";"3";"11";"A";"813";"290";"462";"590";"223";"8";"4";"578";"582"
"17";"Girona";"3";"Girona";"20";"Gironès";"17079";"Girona";"3";"11";"B";"848";"244";"520";"618";"230";"2";"1";"615";"616"
"17";"Girona";"3";"Girona";"20";"Gironès";"17079";"Girona";"3";"12";"A";"760";"246";"439";"524";"236";"4";"3";"517";"520"
"17";"Girona";"3";"Girona";"20";"Gironès";"17079";"Girona";"3";"12";"B";"715";"259";"426";"499";"216";"1";"2";"496";"498"
"17";"Girona";"3";"Girona";"20";"Gironès";"17079";"Girona";"3";"13";"A";"512";"185";"286";"339";"173";"3";"3";"333";"336"
"17";"Girona";"3";"Girona";"20";"Gironès";"17079";"Girona";"3";"13";"B";"440";"131";"256";"302";"138";"2";"2";"298";"300"
"17";"Girona";"3";"Girona";"20";"Gironès";"17079";"Girona";"3";"14";"A";"613";"201";"343";"410";"203";"1";"1";"408";"409"
"17";"Girona";"3";"Girona";"20";"Gironès";"17079";"Girona";"3";"14";"B";"620";"207";"353";"421";"199";"2";"2";"417";"419"
"17";"Girona";"3";"Girona";"20";"Gironès";"17079";"Girona";"3";"15";"A";"552";"215";"359";"431";"121";"1";"0";"430";"430"
"17";"Girona";"3";"Girona";"20";"Gironès";"17079";"Girona";"3";"15";"B";"570";"230";"366";"428";"142";"0";"4";"424";"428"
"17";"Girona";"3";"Girona";"20";"Gironès";"17079";"Girona";"3";"16";"A";"524";"225";"348";"421";"103";"2";"3";"416";"419"
"17";"Girona";"3";"Girona";"20";"Gironès";"17079";"Girona";"3";"16";"B";"540";"257";"373";"448";"92";"0";"5";"443";"448"
"17";"Girona";"3";"Girona";"20";"Gironès";"17079";"Girona";"3";"17";"A";"635";"230";"363";"452";"183";"3";"1";"448";"449"
"17";"Girona";"3";"Girona";"20";"Gironès";"17079";"Girona";"3";"17";"B";"577";"201";"341";"428";"149";"3";"1";"424";"425"
"17";"Girona";"3";"Girona";"20";"Gironès";"17079";"Girona";"3";"18";"A";"543";"193";"336";"383";"160";"5";"1";"377";"378"
"17";"Girona";"3";"Girona";"20";"Gironès";"17079";"Girona";"3";"18";"B";"499";"178";"305";"374";"125";"0";"1";"373";"374"
"17";"Girona";"3";"Girona";"20";"Gironès";"17079";"Girona";"3";"19";"A";"550";"240";"400";"469";"81";"1";"1";"467";"468"
"17";"Girona";"3";"Girona";"20";"Gironès";"17079";"Girona";"3";"19";"B";"569";"273";"415";"490";"79";"2";"1";"487";"488"
"17";"Girona";"3";"Girona";"20";"Gironès";"17079";"Girona";"3";"2";"U";"756";"326";"506";"634";"122";"0";"4";"630";"634"
"17";"Girona";"3";"Girona";"20";"Gironès";"17079";"Girona";"3";"20";"U";"924";"328";"678";"802";"122";"1";"7";"794";"801"
"17";"Girona";"3";"Girona";"20";"Gironès";"17079";"Girona";"3";"3";"A";"680";"278";"457";"561";"119";"2";"5";"554";"559"
"17";"Girona";"3";"Girona";"20";"Gironès";"17079";"Girona";"3";"3";"B";"716";"269";"465";"582";"134";"2";"3";"577";"580"
"17";"Girona";"3";"Girona";"20";"Gironès";"17079";"Girona";"3";"4";"U";"818";"352";"598";"714";"104";"4";"2";"708";"710"
"17";"Girona";"3";"Girona";"20";"Gironès";"17079";"Girona";"3";"5";"A";"519";"182";"341";"451";"68";"1";"6";"444";"450"
"17";"Girona";"3";"Girona";"20";"Gironès";"17079";"Girona";"3";"5";"B";"492";"202";"342";"434";"58";"1";"4";"429";"433"
"17";"Girona";"3";"Girona";"20";"Gironès";"17079";"Girona";"3";"6";"U";"662";"275";"461";"532";"130";"1";"4";"527";"531"
"17";"Girona";"3";"Girona";"20";"Gironès";"17079";"Girona";"3";"7";"A";"663";"265";"390";"456";"207";"0";"2";"454";"456"
"17";"Girona";"3";"Girona";"20";"Gironès";"17079";"Girona";"3";"7";"B";"631";"257";"384";"459";"172";"3";"0";"456";"456"
"17";"Girona";"3";"Girona";"20";"Gironès";"17079";"Girona";"3";"8";"A";"942";"289";"559";"707";"235";"4";"0";"703";"703"
"17";"Girona";"3";"Girona";"20";"Gironès";"17079";"Girona";"3";"8";"B";"871";"314";"548";"668";"203";"1";"4";"663";"667"
"17";"Girona";"3";"Girona";"20";"Gironès";"17079";"Girona";"3";"9";"U";"758";"271";"414";"495";"263";"1";"5";"489";"494"
"17";"Girona";"3";"Girona";"20";"Gironès";"17079";"Girona";"4";"1";"U";"739";"247";"428";"523";"216";"2";"5";"516";"521"
"17";"Girona";"3";"Girona";"20";"Gironès";"17079";"Girona";"4";"2";"U";"622";"229";"358";"450";"172";"0";"1";"449";"450"
"17";"Girona";"3";"Girona";"20";"Gironès";"17079";"Girona";"5";"1";"A";"552";"234";"424";"501";"51";"1";"1";"499";"500"
"17";"Girona";"3";"Girona";"20";"Gironès";"17079";"Girona";"5";"1";"B";"590";"238";"438";"536";"54";"3";"2";"531";"533"
"17";"Girona";"3";"Girona";"20";"Gironès";"17079";"Girona";"5";"2";"U";"577";"224";"334";"403";"174";"0";"3";"400";"403"
"17";"Girona";"3";"Girona";"20";"Gironès";"17079";"Girona";"5";"3";"A";"572";"204";"331";"392";"180";"0";"5";"387";"392"
"17";"Girona";"3";"Girona";"20";"Gironès";"17079";"Girona";"5";"3";"B";"588";"232";"348";"413";"175";"1";"1";"411";"412"
"17";"Girona";"3";"Girona";"20";"Gironès";"17079";"Girona";"5";"4";"U";"651";"300";"460";"532";"119";"2";"1";"529";"530"
"17";"Girona";"3";"Girona";"20";"Gironès";"17079";"Girona";"5";"5";"U";"754";"291";"347";"522";"232";"3";"5";"514";"519"
"17";"Girona";"3";"Girona";"20";"Gironès";"17079";"Girona";"5";"6";"U";"915";"338";"657";"787";"128";"1";"3";"783";"786"
"17";"Girona";"3";"Girona";"20";"Gironès";"17079";"Girona";"6";"1";"A";"756";"284";"519";"616";"140";"5";"1";"610";"611"
"17";"Girona";"3";"Girona";"20";"Gironès";"17079";"Girona";"6";"1";"B";"707";"269";"498";"588";"119";"6";"2";"580";"582"
"17";"Girona";"3";"Girona";"20";"Gironès";"17079";"Girona";"6";"2";"A";"887";"322";"563";"678";"209";"6";"8";"664";"672"
"17";"Girona";"3";"Girona";"20";"Gironès";"17079";"Girona";"6";"2";"B";"827";"269";"536";"645";"182";"1";"4";"640";"644"
"17";"Girona";"3";"Girona";"20";"Gironès";"17079";"Girona";"6";"3";"A";"705";"254";"430";"521";"184";"1";"0";"520";"520"
"17";"Girona";"3";"Girona";"20";"Gironès";"17079";"Girona";"6";"3";"B";"744";"267";"442";"573";"171";"3";"1";"569";"570"
"17";"Girona";"3";"Girona";"20";"Gironès";"17079";"Girona";"6";"4";"A";"603";"226";"422";"488";"115";"1";"1";"486";"487"
"17";"Girona";"3";"Girona";"20";"Gironès";"17079";"Girona";"6";"4";"B";"572";"220";"377";"460";"112";"2";"4";"454";"458"
"17";"Girona";"3";"Girona";"20";"Gironès";"17079";"Girona";"6";"5";"U";"680";"217";"367";"449";"231";"2";"2";"445";"447"
"17";"Girona";"3";"Girona";"31";"Ripollès";"17080";"Gombrèn";"1";"1";"U";"139";"68";"93";"128";"11";"1";"1";"126";"127"
"17";"Girona";"3";"Girona";"10";"Baix Empordà";"17081";"Gualta";"1";"1";"U";"241";"104";"184";"203";"38";"0";"0";"203";"203"
"17";"Girona";"3";"Girona";"34";"Selva";"17083";"Hostalric";"1";"1";"U";"782";"371";"562";"615";"167";"33";"3";"579";"582"
"17";"Girona";"3";"Girona";"34";"Selva";"17083";"Hostalric";"1";"2";"A";"632";"250";"400";"499";"133";"21";"2";"476";"478"
"17";"Girona";"3";"Girona";"34";"Selva";"17083";"Hostalric";"1";"2";"B";"707";"296";"492";"581";"126";"22";"7";"552";"559"
"17";"Girona";"3";"Girona";"34";"Selva";"17083";"Hostalric";"1";"3";"U";"804";"280";"492";"584";"220";"9";"3";"572";"575"
"17";"Girona";"3";"Girona";"10";"Baix Empordà";"17085";"Jafre";"1";"1";"U";"288";"130";"224";"260";"28";"2";"0";"258";"258"
"17";"Girona";"3";"Girona";"2";"Alt Empordà";"17086";"Jonquera, la";"1";"1";"A";"510";"173";"270";"365";"145";"1";"1";"363";"364"
"17";"Girona";"3";"Girona";"2";"Alt Empordà";"17086";"Jonquera, la";"1";"1";"B";"540";"184";"312";"382";"158";"3";"2";"377";"379"
"17";"Girona";"3";"Girona";"2";"Alt Empordà";"17086";"Jonquera, la";"1";"2";"U";"700";"240";"412";"510";"190";"1";"1";"508";"509"
"17";"Girona";"3";"Girona";"20";"Gironès";"17087";"Juià";"1";"1";"U";"219";"107";"158";"185";"34";"0";"0";"185";"185"
"17";"Girona";"3";"Girona";"2";"Alt Empordà";"17088";"Lladó";"1";"1";"U";"535";"216";"403";"454";"81";"2";"0";"452";"452"
"17";"Girona";"3";"Girona";"20";"Gironès";"17089";"Llagostera";"1";"1";"A";"571";"188";"359";"420";"151";"3";"1";"416";"417"
"17";"Girona";"3";"Girona";"20";"Gironès";"17089";"Llagostera";"1";"1";"B";"641";"225";"401";"469";"172";"2";"1";"466";"467"
"17";"Girona";"3";"Girona";"20";"Gironès";"17089";"Llagostera";"1";"2";"A";"545";"192";"338";"405";"140";"0";"0";"405";"405"
"17";"Girona";"3";"Girona";"20";"Gironès";"17089";"Llagostera";"1";"2";"B";"615";"224";"388";"471";"144";"3";"2";"466";"468"
"17";"Girona";"3";"Girona";"20";"Gironès";"17089";"Llagostera";"1";"3";"A";"608";"238";"410";"481";"127";"5";"2";"474";"476"
"17";"Girona";"3";"Girona";"20";"Gironès";"17089";"Llagostera";"1";"3";"B";"547";"195";"343";"422";"125";"1";"4";"417";"421"
"17";"Girona";"3";"Girona";"20";"Gironès";"17089";"Llagostera";"1";"3";"C";"644";"270";"429";"521";"123";"1";"2";"518";"520"
"17";"Girona";"3";"Girona";"20";"Gironès";"17089";"Llagostera";"1";"4";"A";"590";"226";"388";"459";"131";"3";"1";"455";"456"
"17";"Girona";"3";"Girona";"20";"Gironès";"17089";"Llagostera";"1";"4";"B";"731";"278";"501";"586";"145";"1";"8";"577";"585"
"17";"Girona";"3";"Girona";"20";"Gironès";"17090";"Llambilles";"1";"1";"U";"550";"237";"440";"487";"63";"1";"4";"482";"486"
"17";"Girona";"3";"Girona";"31";"Ripollès";"17091";"Llanars";"1";"1";"U";"413";"179";"280";"345";"68";"6";"1";"338";"339"
"17";"Girona";"3";"Girona";"2";"Alt Empordà";"17092";"Llançà";"1";"1";"A";"492";"196";"334";"405";"87";"4";"2";"399";"401"
"17";"Girona";"3";"Girona";"2";"Alt Empordà";"17092";"Llançà";"1";"1";"B";"515";"224";"350";"431";"84";"1";"0";"430";"430"
"17";"Girona";"3";"Girona";"2";"Alt Empordà";"17092";"Llançà";"1";"2";"A";"817";"303";"526";"658";"159";"4";"4";"650";"654"
"17";"Girona";"3";"Girona";"2";"Alt Empordà";"17092";"Llançà";"1";"2";"B";"820";"312";"543";"671";"149";"10";"2";"659";"661"
"17";"Girona";"3";"Girona";"2";"Alt Empordà";"17092";"Llançà";"1";"3";"U";"832";"317";"512";"640";"192";"2";"2";"636";"638"
"17";"Girona";"3";"Girona";"2";"Alt Empordà";"17093";"Llers";"1";"1";"U";"889";"330";"574";"723";"166";"3";"8";"712";"720"
"17";"Girona";"3";"Girona";"34";"Selva";"17095";"Lloret de Mar";"1";"1";"A";"705";"237";"398";"481";"224";"2";"1";"478";"479"
"17";"Girona";"3";"Girona";"34";"Selva";"17095";"Lloret de Mar";"1";"1";"B";"728";"208";"393";"499";"229";"1";"7";"491";"498"
"17";"Girona";"3";"Girona";"34";"Selva";"17095";"Lloret de Mar";"1";"2";"A";"527";"191";"333";"380";"147";"5";"1";"374";"375"
"17";"Girona";"3";"Girona";"34";"Selva";"17095";"Lloret de Mar";"1";"2";"B";"573";"190";"329";"400";"173";"1";"1";"398";"399"
"17";"Girona";"3";"Girona";"34";"Selva";"17095";"Lloret de Mar";"1";"3";"A";"588";"183";"314";"389";"199";"4";"2";"383";"385"
"17";"Girona";"3";"Girona";"34";"Selva";"17095";"Lloret de Mar";"1";"3";"B";"651";"211";"339";"421";"230";"3";"1";"417";"418"
"17";"Girona";"3";"Girona";"34";"Selva";"17095";"Lloret de Mar";"1";"3";"C";"605";"205";"333";"401";"204";"2";"3";"396";"399"
"17";"Girona";"3";"Girona";"34";"Selva";"17095";"Lloret de Mar";"2";"1";"A";"697";"264";"428";"508";"189";"3";"4";"501";"505"
"17";"Girona";"3";"Girona";"34";"Selva";"17095";"Lloret de Mar";"2";"1";"B";"631";"212";"371";"454";"177";"2";"2";"450";"452"
"17";"Girona";"3";"Girona";"34";"Selva";"17095";"Lloret de Mar";"2";"2";"A";"587";"196";"361";"427";"160";"4";"6";"417";"423"
"17";"Girona";"3";"Girona";"34";"Selva";"17095";"Lloret de Mar";"2";"2";"B";"649";"231";"398";"475";"174";"4";"2";"469";"471"
"17";"Girona";"3";"Girona";"34";"Selva";"17095";"Lloret de Mar";"2";"3";"A";"721";"231";"375";"467";"254";"0";"3";"464";"467"
"17";"Girona";"3";"Girona";"34";"Selva";"17095";"Lloret de Mar";"2";"3";"B";"783";"255";"439";"550";"233";"5";"2";"543";"545"
"17";"Girona";"3";"Girona";"34";"Selva";"17095";"Lloret de Mar";"3";"1";"A";"736";"225";"420";"527";"209";"1";"1";"525";"526"
"17";"Girona";"3";"Girona";"34";"Selva";"17095";"Lloret de Mar";"3";"1";"B";"721";"234";"430";"537";"184";"1";"1";"535";"536"
"17";"Girona";"3";"Girona";"34";"Selva";"17095";"Lloret de Mar";"3";"2";"A";"575";"206";"351";"427";"148";"1";"0";"426";"426"
"17";"Girona";"3";"Girona";"34";"Selva";"17095";"Lloret de Mar";"3";"2";"B";"655";"203";"377";"458";"197";"2";"2";"454";"456"
"17";"Girona";"3";"Girona";"34";"Selva";"17095";"Lloret de Mar";"3";"2";"C";"632";"216";"370";"444";"188";"4";"3";"437";"440"
"17";"Girona";"3";"Girona";"34";"Selva";"17095";"Lloret de Mar";"3";"3";"A";"581";"210";"362";"442";"139";"4";"1";"437";"438"
"17";"Girona";"3";"Girona";"34";"Selva";"17095";"Lloret de Mar";"3";"3";"B";"605";"197";"354";"444";"161";"1";"4";"439";"443"
"17";"Girona";"3";"Girona";"34";"Selva";"17095";"Lloret de Mar";"3";"3";"C";"564";"176";"316";"405";"159";"2";"2";"401";"403"
"17";"Girona";"3";"Girona";"34";"Selva";"17095";"Lloret de Mar";"3";"4";"A";"733";"236";"430";"516";"217";"2";"1";"513";"514"
"17";"Girona";"3";"Girona";"34";"Selva";"17095";"Lloret de Mar";"3";"4";"B";"688";"202";"351";"444";"244";"1";"0";"443";"443"
"17";"Girona";"3";"Girona";"34";"Selva";"17095";"Lloret de Mar";"4";"1";"A";"667";"198";"352";"454";"213";"1";"0";"453";"453"
"17";"Girona";"3";"Girona";"34";"Selva";"17095";"Lloret de Mar";"4";"1";"B";"631";"213";"358";"443";"188";"4";"5";"434";"439"
"17";"Girona";"3";"Girona";"34";"Selva";"17095";"Lloret de Mar";"4";"2";"A";"768";"220";"410";"544";"224";"4";"3";"537";"540"
"17";"Girona";"3";"Girona";"34";"Selva";"17095";"Lloret de Mar";"4";"2";"B";"752";"179";"385";"529";"223";"5";"2";"522";"524"
"17";"Girona";"3";"Girona";"34";"Selva";"17095";"Lloret de Mar";"4";"3";"A";"555";"186";"336";"438";"117";"1";"3";"434";"437"
"17";"Girona";"3";"Girona";"34";"Selva";"17095";"Lloret de Mar";"4";"3";"B";"555";"193";"349";"448";"107";"2";"3";"443";"446"
"17";"Girona";"3";"Girona";"34";"Selva";"17095";"Lloret de Mar";"4";"4";"U";"726";"230";"449";"567";"159";"9";"2";"556";"558"
"17";"Girona";"3";"Girona";"31";"Ripollès";"17096";"Llosses, les";"1";"1";"U";"177";"51";"100";"133";"44";"1";"0";"132";"132"
"17";"Girona";"3";"Girona";"20";"Gironès";"17097";"Madremanya";"1";"1";"U";"198";"88";"147";"177";"21";"1";"4";"172";"176"
"17";"Girona";"3";"Girona";"19";"Garrotxa";"17098";"Maià de Montcal";"1";"1";"U";"313";"148";"218";"259";"54";"1";"2";"256";"258"
"17";"Girona";"3";"Girona";"2";"Alt Empordà";"17100";"Masarac";"1";"1";"U";"197";"79";"134";"163";"34";"3";"1";"159";"160"
"17";"Girona";"3";"Girona";"34";"Selva";"17101";"Massanes";"1";"1";"U";"541";"212";"359";"414";"127";"16";"2";"396";"398"
"17";"Girona";"3";"Girona";"2";"Alt Empordà";"17102";"Maçanet de Cabrenys";"1";"1";"U";"579";"241";"404";"472";"107";"5";"5";"462";"467"
"17";"Girona";"3";"Girona";"34";"Selva";"17103";"Maçanet de la Selva";"1";"1";"A";"517";"171";"335";"405";"112";"4";"1";"400";"401"
"17";"Girona";"3";"Girona";"34";"Selva";"17103";"Maçanet de la Selva";"1";"1";"B";"563";"193";"364";"449";"114";"6";"2";"441";"443"
"17";"Girona";"3";"Girona";"34";"Selva";"17103";"Maçanet de la Selva";"1";"2";"A";"861";"280";"549";"570";"291";"5";"2";"563";"565"
"17";"Girona";"3";"Girona";"34";"Selva";"17103";"Maçanet de la Selva";"1";"2";"B";"840";"281";"469";"576";"264";"2";"3";"571";"574"
"17";"Girona";"3";"Girona";"34";"Selva";"17103";"Maçanet de la Selva";"1";"3";"A";"516";"175";"334";"397";"119";"3";"1";"393";"394"
"17";"Girona";"3";"Girona";"34";"Selva";"17103";"Maçanet de la Selva";"1";"3";"B";"594";"233";"385";"463";"131";"0";"1";"462";"463"
"17";"Girona";"3";"Girona";"34";"Selva";"17103";"Maçanet de la Selva";"1";"4";"A";"544";"166";"290";"356";"188";"0";"0";"356";"356"
"17";"Girona";"3";"Girona";"34";"Selva";"17103";"Maçanet de la Selva";"1";"4";"B";"502";"178";"288";"341";"161";"0";"0";"341";"341"
"17";"Girona";"3";"Girona";"19";"Garrotxa";"17105";"Mieres";"1";"1";"U";"257";"117";"184";"216";"41";"3";"2";"211";"213"
"17";"Girona";"3";"Girona";"2";"Alt Empordà";"17106";"Mollet de Peralada";"1";"1";"U";"141";"71";"98";"122";"19";"1";"1";"120";"121"
"17";"Girona";"3";"Girona";"31";"Ripollès";"17107";"Molló";"1";"1";"U";"267";"94";"181";"231";"36";"1";"0";"230";"230"
"17";"Girona";"3";"Girona";"10";"Baix Empordà";"17110";"Mont-ras";"1";"1";"A";"670";"286";"470";"544";"126";"1";"2";"541";"543"
"17";"Girona";"3";"Girona";"10";"Baix Empordà";"17110";"Mont-ras";"1";"1";"B";"657";"266";"467";"528";"129";"2";"0";"526";"526"
"17";"Girona";"3";"Girona";"19";"Garrotxa";"17109";"Montagut i Oix";"1";"1";"U";"698";"270";"489";"583";"115";"0";"1";"582";"583"
"17";"Girona";"3";"Girona";"2";"Alt Empordà";"17111";"Navata";"1";"1";"U";"869";"366";"640";"739";"130";"1";"7";"731";"738"
"17";"Girona";"3";"Girona";"31";"Ripollès";"17112";"Ogassa";"1";"1";"U";"192";"87";"137";"165";"27";"1";"1";"163";"164"
"17";"Girona";"3";"Girona";"19";"Garrotxa";"17114";"Olot";"1";"1";"A";"534";"179";"290";"330";"204";"0";"0";"330";"330"
"17";"Girona";"3";"Girona";"19";"Garrotxa";"17114";"Olot";"1";"1";"B";"506";"171";"282";"328";"178";"3";"0";"325";"325"
"17";"Girona";"3";"Girona";"19";"Garrotxa";"17114";"Olot";"1";"2";"U";"730";"324";"446";"509";"221";"3";"1";"505";"506"
"17";"Girona";"3";"Girona";"19";"Garrotxa";"17114";"Olot";"1";"3";"U";"826";"239";"570";"672";"154";"3";"2";"667";"669"
"17";"Girona";"3";"Girona";"19";"Garrotxa";"17114";"Olot";"1";"4";"U";"642";"281";"468";"552";"90";"0";"4";"548";"552"
"17";"Girona";"3";"Girona";"19";"Garrotxa";"17114";"Olot";"1";"5";"U";"560";"263";"404";"462";"98";"0";"1";"461";"462"
"17";"Girona";"3";"Girona";"19";"Garrotxa";"17114";"Olot";"1";"6";"U";"559";"260";"412";"450";"109";"3";"5";"442";"447"
"17";"Girona";"3";"Girona";"19";"Garrotxa";"17114";"Olot";"1";"7";"A";"567";"254";"376";"428";"139";"3";"6";"419";"425"
"17";"Girona";"3";"Girona";"19";"Garrotxa";"17114";"Olot";"1";"7";"B";"564";"260";"382";"440";"124";"1";"3";"436";"439"
"17";"Girona";"3";"Girona";"19";"Garrotxa";"17114";"Olot";"2";"1";"A";"876";"344";"596";"706";"170";"1";"5";"700";"705"
"17";"Girona";"3";"Girona";"19";"Garrotxa";"17114";"Olot";"2";"1";"B";"819";"332";"579";"689";"130";"4";"7";"678";"685"
"17";"Girona";"3";"Girona";"19";"Garrotxa";"17114";"Olot";"2";"2";"A";"808";"297";"512";"621";"187";"3";"6";"612";"618"
"17";"Girona";"3";"Girona";"19";"Garrotxa";"17114";"Olot";"2";"2";"B";"744";"317";"520";"603";"141";"3";"3";"597";"600"
"17";"Girona";"3";"Girona";"19";"Garrotxa";"17114";"Olot";"2";"3";"A";"587";"226";"359";"409";"178";"5";"2";"402";"404"
"17";"Girona";"3";"Girona";"19";"Garrotxa";"17114";"Olot";"2";"3";"B";"578";"297";"432";"432";"146";"4";"2";"426";"428"
"17";"Girona";"3";"Girona";"19";"Garrotxa";"17114";"Olot";"2";"4";"U";"961";"364";"596";"694";"267";"5";"3";"686";"689"
"17";"Girona";"3";"Girona";"19";"Garrotxa";"17114";"Olot";"2";"5";"A";"483";"192";"328";"382";"101";"3";"6";"373";"379"
"17";"Girona";"3";"Girona";"19";"Garrotxa";"17114";"Olot";"2";"5";"B";"508";"198";"345";"404";"104";"1";"2";"401";"403"
"17";"Girona";"3";"Girona";"19";"Garrotxa";"17114";"Olot";"3";"1";"U";"600";"253";"421";"462";"138";"2";"4";"456";"460"
"17";"Girona";"3";"Girona";"19";"Garrotxa";"17114";"Olot";"3";"2";"A";"683";"303";"502";"567";"116";"1";"2";"564";"566"
"17";"Girona";"3";"Girona";"19";"Garrotxa";"17114";"Olot";"3";"2";"B";"651";"294";"482";"557";"94";"3";"4";"550";"554"
"17";"Girona";"3";"Girona";"19";"Garrotxa";"17114";"Olot";"3";"3";"A";"850";"346";"609";"710";"140";"2";"3";"705";"708"
"17";"Girona";"3";"Girona";"19";"Garrotxa";"17114";"Olot";"3";"3";"B";"835";"342";"577";"672";"163";"3";"2";"667";"669"
"17";"Girona";"3";"Girona";"19";"Garrotxa";"17114";"Olot";"4";"1";"A";"547";"193";"349";"399";"148";"1";"2";"396";"398"
"17";"Girona";"3";"Girona";"19";"Garrotxa";"17114";"Olot";"4";"1";"B";"518";"182";"330";"389";"129";"0";"2";"387";"389"
"17";"Girona";"3";"Girona";"19";"Garrotxa";"17114";"Olot";"4";"2";"A";"834";"307";"512";"599";"235";"2";"2";"595";"597"
"17";"Girona";"3";"Girona";"19";"Garrotxa";"17114";"Olot";"4";"2";"B";"766";"316";"457";"525";"241";"1";"4";"520";"524"
"17";"Girona";"3";"Girona";"19";"Garrotxa";"17114";"Olot";"5";"1";"A";"510";"228";"354";"412";"98";"1";"0";"411";"411"
"17";"Girona";"3";"Girona";"19";"Garrotxa";"17114";"Olot";"5";"1";"B";"524";"201";"369";"423";"101";"1";"1";"421";"422"
"17";"Girona";"3";"Girona";"19";"Garrotxa";"17114";"Olot";"5";"2";"A";"503";"254";"396";"437";"66";"0";"0";"437";"437"
"17";"Girona";"3";"Girona";"19";"Garrotxa";"17114";"Olot";"5";"2";"B";"487";"249";"365";"420";"67";"0";"4";"416";"420"
"17";"Girona";"3";"Girona";"19";"Garrotxa";"17114";"Olot";"5";"3";"A";"789";"315";"524";"615";"174";"0";"3";"612";"615"
"17";"Girona";"3";"Girona";"19";"Garrotxa";"17114";"Olot";"5";"3";"B";"877";"360";"599";"689";"188";"2";"4";"683";"687"
"17";"Girona";"3";"Girona";"19";"Garrotxa";"17114";"Olot";"5";"4";"A";"586";"261";"445";"520";"66";"0";"2";"518";"520"
"17";"Girona";"3";"Girona";"19";"Garrotxa";"17114";"Olot";"5";"4";"B";"639";"268";"464";"544";"95";"1";"2";"541";"543"
"17";"Girona";"3";"Girona";"2";"Alt Empordà";"17115";"Ordis";"1";"1";"U";"277";"110";"194";"234";"43";"0";"3";"231";"234"
"17";"Girona";"3";"Girona";"34";"Selva";"17116";"Osor";"1";"1";"U";"347";"148";"242";"294";"53";"7";"3";"284";"287"
"17";"Girona";"3";"Girona";"10";"Baix Empordà";"17117";"Palafrugell";"1";"1";"A";"758";"280";"484";"571";"187";"5";"5";"561";"566"
"17";"Girona";"3";"Girona";"10";"Baix Empordà";"17117";"Palafrugell";"1";"1";"B";"674";"282";"426";"513";"161";"3";"2";"508";"510"
"17";"Girona";"3";"Girona";"10";"Baix Empordà";"17117";"Palafrugell";"1";"2";"A";"737";"226";"413";"519";"218";"2";"1";"516";"517"
"17";"Girona";"3";"Girona";"10";"Baix Empordà";"17117";"Palafrugell";"1";"2";"B";"696";"252";"454";"531";"165";"0";"1";"530";"531"
"17";"Girona";"3";"Girona";"10";"Baix Empordà";"17117";"Palafrugell";"1";"3";"A";"564";"183";"304";"400";"164";"0";"3";"397";"400"
"17";"Girona";"3";"Girona";"10";"Baix Empordà";"17117";"Palafrugell";"1";"3";"B";"513";"174";"292";"377";"136";"2";"2";"373";"375"
"17";"Girona";"3";"Girona";"10";"Baix Empordà";"17117";"Palafrugell";"1";"4";"A";"693";"242";"421";"513";"180";"1";"5";"507";"512"
"17";"Girona";"3";"Girona";"10";"Baix Empordà";"17117";"Palafrugell";"1";"4";"B";"642";"254";"413";"498";"144";"2";"6";"490";"496"
"17";"Girona";"3";"Girona";"10";"Baix Empordà";"17117";"Palafrugell";"1";"5";"U";"858";"324";"534";"610";"248";"5";"5";"600";"605"
"17";"Girona";"3";"Girona";"10";"Baix Empordà";"17117";"Palafrugell";"2";"1";"A";"813";"329";"498";"601";"212";"4";"2";"595";"597"
"17";"Girona";"3";"Girona";"10";"Baix Empordà";"17117";"Palafrugell";"2";"1";"B";"755";"340";"470";"555";"200";"2";"2";"551";"553"
"17";"Girona";"3";"Girona";"10";"Baix Empordà";"17117";"Palafrugell";"2";"2";"A";"787";"282";"461";"540";"247";"5";"5";"530";"535"
"17";"Girona";"3";"Girona";"10";"Baix Empordà";"17117";"Palafrugell";"2";"2";"B";"734";"279";"441";"517";"217";"1";"1";"515";"516"
"17";"Girona";"3";"Girona";"10";"Baix Empordà";"17117";"Palafrugell";"2";"3";"A";"876";"277";"469";"570";"306";"0";"4";"566";"570"
"17";"Girona";"3";"Girona";"10";"Baix Empordà";"17117";"Palafrugell";"2";"3";"B";"730";"336";"511";"599";"131";"3";"1";"595";"596"
"17";"Girona";"3";"Girona";"10";"Baix Empordà";"17117";"Palafrugell";"3";"1";"A";"495";"172";"306";"370";"125";"3";"5";"362";"367"
"17";"Girona";"3";"Girona";"10";"Baix Empordà";"17117";"Palafrugell";"3";"1";"B";"494";"187";"304";"370";"124";"1";"0";"369";"369"
"17";"Girona";"3";"Girona";"10";"Baix Empordà";"17117";"Palafrugell";"3";"2";"A";"651";"253";"432";"515";"136";"1";"4";"510";"514"
"17";"Girona";"3";"Girona";"10";"Baix Empordà";"17117";"Palafrugell";"3";"2";"B";"636";"236";"416";"496";"140";"2";"3";"491";"494"
"17";"Girona";"3";"Girona";"10";"Baix Empordà";"17117";"Palafrugell";"3";"2";"C";"222";"82";"139";"183";"39";"2";"0";"181";"181"
"17";"Girona";"3";"Girona";"10";"Baix Empordà";"17117";"Palafrugell";"3";"3";"U";"940";"316";"542";"658";"282";"1";"6";"651";"657"
"17";"Girona";"3";"Girona";"10";"Baix Empordà";"17118";"Palamós";"1";"1";"A";"632";"262";"397";"468";"164";"5";"2";"461";"463"
"17";"Girona";"3";"Girona";"10";"Baix Empordà";"17118";"Palamós";"1";"1";"B";"624";"281";"408";"492";"132";"3";"2";"487";"489"
"17";"Girona";"3";"Girona";"10";"Baix Empordà";"17118";"Palamós";"1";"2";"A";"691";"248";"434";"520";"171";"4";"3";"513";"516"
"17";"Girona";"3";"Girona";"10";"Baix Empordà";"17118";"Palamós";"1";"2";"B";"627";"217";"395";"481";"146";"1";"4";"476";"480"
"17";"Girona";"3";"Girona";"10";"Baix Empordà";"17118";"Palamós";"1";"3";"A";"534";"200";"329";"383";"151";"2";"5";"376";"381"
"17";"Girona";"3";"Girona";"10";"Baix Empordà";"17118";"Palamós";"1";"3";"B";"551";"289";"350";"410";"141";"1";"1";"408";"409"
"17";"Girona";"3";"Girona";"10";"Baix Empordà";"17118";"Palamós";"1";"4";"U";"665";"240";"451";"536";"129";"1";"6";"529";"535"
"17";"Girona";"3";"Girona";"10";"Baix Empordà";"17118";"Palamós";"2";"1";"U";"927";"431";"623";"729";"198";"3";"6";"720";"726"
"17";"Girona";"3";"Girona";"10";"Baix Empordà";"17118";"Palamós";"2";"2";"A";"620";"263";"394";"475";"145";"1";"3";"471";"474"
"17";"Girona";"3";"Girona";"10";"Baix Empordà";"17118";"Palamós";"2";"2";"B";"599";"258";"391";"456";"143";"1";"2";"453";"455"
"17";"Girona";"3";"Girona";"10";"Baix Empordà";"17118";"Palamós";"3";"1";"A";"442";"191";"290";"334";"108";"0";"0";"334";"334"
"17";"Girona";"3";"Girona";"10";"Baix Empordà";"17118";"Palamós";"3";"1";"B";"839";"235";"486";"597";"242";"0";"0";"597";"597"
"17";"Girona";"3";"Girona";"10";"Baix Empordà";"17118";"Palamós";"3";"2";"A";"567";"222";"371";"462";"105";"1";"1";"460";"461"
"17";"Girona";"3";"Girona";"10";"Baix Empordà";"17118";"Palamós";"3";"2";"B";"610";"242";"394";"463";"147";"1";"2";"460";"462"
"17";"Girona";"3";"Girona";"10";"Baix Empordà";"17118";"Palamós";"3";"3";"A";"795";"249";"472";"624";"171";"1";"4";"619";"623"
"17";"Girona";"3";"Girona";"10";"Baix Empordà";"17118";"Palamós";"3";"3";"B";"751";"209";"460";"555";"196";"4";"5";"546";"551"
"17";"Girona";"3";"Girona";"10";"Baix Empordà";"17118";"Palamós";"4";"1";"A";"707";"279";"432";"517";"190";"7";"4";"506";"510"
"17";"Girona";"3";"Girona";"10";"Baix Empordà";"17118";"Palamós";"4";"1";"B";"659";"254";"384";"467";"192";"3";"1";"463";"464"
"17";"Girona";"3";"Girona";"10";"Baix Empordà";"17118";"Palamós";"4";"2";"A";"534";"216";"350";"398";"136";"4";"1";"393";"394"
"17";"Girona";"3";"Girona";"10";"Baix Empordà";"17118";"Palamós";"4";"2";"B";"479";"217";"320";"361";"118";"3";"3";"355";"358"
"17";"Girona";"3";"Girona";"2";"Alt Empordà";"17119";"Palau de Santa Eulàlia";"1";"1";"U";"68";"27";"49";"63";"5";"0";"0";"63";"63"
"17";"Girona";"3";"Girona";"10";"Baix Empordà";"17121";"Palau-sator";"1";"1";"U";"221";"102";"167";"197";"24";"0";"2";"195";"197"
"17";"Girona";"3";"Girona";"2";"Alt Empordà";"17120";"Palau-saverdera";"1";"1";"U";"802";"285";"523";"629";"173";"10";"8";"611";"619"
"17";"Girona";"3";"Girona";"28";"Pla de l'Estany";"17123";"Palol de Revardit";"1";"1";"U";"358";"188";"276";"312";"46";"4";"0";"308";"308"
"17";"Girona";"3";"Girona";"10";"Baix Empordà";"17124";"Pals";"1";"1";"A";"839";"272";"531";"676";"163";"8";"6";"662";"668"
"17";"Girona";"3";"Girona";"10";"Baix Empordà";"17124";"Pals";"1";"1";"B";"797";"264";"533";"638";"159";"1";"6";"631";"637"
"17";"Girona";"3";"Girona";"31";"Ripollès";"17125";"Pardines";"1";"1";"U";"128";"39";"88";"109";"19";"0";"3";"106";"109"
"17";"Girona";"3";"Girona";"10";"Baix Empordà";"17126";"Parlavà";"1";"1";"U";"308";"152";"247";"284";"24";"0";"0";"284";"284"
"17";"Girona";"3";"Girona";"2";"Alt Empordà";"17128";"Pau";"1";"1";"U";"302";"118";"214";"254";"48";"0";"0";"254";"254"
"17";"Girona";"3";"Girona";"2";"Alt Empordà";"17129";"Pedret i Marzà";"1";"1";"U";"137";"56";"98";"118";"19";"0";"1";"117";"118"
"17";"Girona";"3";"Girona";"10";"Baix Empordà";"17130";"Pera, la";"1";"1";"U";"327";"137";"228";"281";"46";"1";"4";"276";"280"
"17";"Girona";"3";"Girona";"2";"Alt Empordà";"17132";"Peralada";"1";"1";"A";"576";"222";"406";"482";"94";"6";"3";"473";"476"
"17";"Girona";"3";"Girona";"2";"Alt Empordà";"17132";"Peralada";"1";"1";"B";"533";"218";"379";"443";"90";"2";"3";"438";"441"
"17";"Girona";"3";"Girona";"2";"Alt Empordà";"17132";"Peralada";"1";"1";"C";"200";"93";"147";"169";"31";"1";"1";"167";"168"
"17";"Girona";"3";"Girona";"19";"Garrotxa";"17133";"Planes d'Hostoles, les";"1";"1";"A";"637";"264";"435";"525";"112";"5";"2";"518";"520"
"17";"Girona";"3";"Girona";"19";"Garrotxa";"17133";"Planes d'Hostoles, les";"1";"1";"B";"637";"237";"418";"533";"104";"7";"5";"521";"526"
"17";"Girona";"3";"Girona";"31";"Ripollès";"17134";"Planoles";"1";"1";"U";"233";"105";"165";"197";"36";"2";"1";"194";"195"
"17";"Girona";"3";"Girona";"2";"Alt Empordà";"17135";"Pont de Molins";"1";"1";"U";"353";"164";"263";"304";"49";"0";"1";"303";"304"
"17";"Girona";"3";"Girona";"2";"Alt Empordà";"17136";"Pontós";"1";"1";"U";"176";"90";"117";"151";"25";"0";"0";"151";"151"
"17";"Girona";"3";"Girona";"28";"Pla de l'Estany";"17137";"Porqueres";"1";"1";"U";"579";"227";"408";"487";"92";"2";"0";"485";"485"
"17";"Girona";"3";"Girona";"28";"Pla de l'Estany";"17137";"Porqueres";"1";"2";"A";"786";"377";"592";"669";"117";"0";"2";"667";"669"
"17";"Girona";"3";"Girona";"28";"Pla de l'Estany";"17137";"Porqueres";"1";"2";"B";"852";"379";"648";"737";"115";"3";"10";"724";"734"
"17";"Girona";"3";"Girona";"28";"Pla de l'Estany";"17137";"Porqueres";"1";"3";"A";"581";"250";"436";"528";"53";"3";"0";"525";"525"
"17";"Girona";"3";"Girona";"28";"Pla de l'Estany";"17137";"Porqueres";"1";"3";"B";"604";"229";"427";"505";"99";"1";"4";"500";"504"
"17";"Girona";"3";"Girona";"2";"Alt Empordà";"17140";"Port de la Selva, el";"1";"1";"U";"671";"351";"503";"581";"90";"2";"1";"578";"579"
"17";"Girona";"3";"Girona";"2";"Alt Empordà";"17138";"Portbou";"1";"1";"A";"466";"211";"306";"371";"95";"4";"3";"364";"367"
"17";"Girona";"3";"Girona";"2";"Alt Empordà";"17138";"Portbou";"1";"1";"B";"477";"220";"310";"361";"116";"3";"2";"356";"358"
"17";"Girona";"3";"Girona";"19";"Garrotxa";"17139";"Preses, les";"1";"1";"A";"962";"455";"718";"836";"126";"5";"11";"820";"831"
"17";"Girona";"3";"Girona";"19";"Garrotxa";"17139";"Preses, les";"1";"1";"B";"415";"173";"302";"336";"79";"4";"7";"325";"332"
"17";"Girona";"3";"Girona";"20";"Gironès";"17142";"Quart";"1";"1";"A";"593";"185";"436";"521";"72";"0";"1";"520";"521"
"17";"Girona";"3";"Girona";"20";"Gironès";"17142";"Quart";"1";"1";"B";"499";"167";"360";"430";"69";"1";"2";"427";"429"
"17";"Girona";"3";"Girona";"20";"Gironès";"17142";"Quart";"1";"2";"A";"855";"240";"623";"769";"86";"1";"3";"765";"768"
"17";"Girona";"3";"Girona";"20";"Gironès";"17142";"Quart";"1";"2";"B";"607";"257";"411";"500";"107";"1";"6";"493";"499"
"17";"Girona";"3";"Girona";"31";"Ripollès";"17043";"Queralbs";"1";"1";"U";"153";"67";"111";"134";"19";"4";"0";"130";"130"
"17";"Girona";"3";"Girona";"2";"Alt Empordà";"17143";"Rabós";"1";"1";"U";"146";"64";"109";"122";"24";"2";"1";"119";"120"
"17";"Girona";"3";"Girona";"10";"Baix Empordà";"17144";"Regencós";"1";"1";"U";"209";"100";"159";"178";"31";"0";"1";"177";"178"
"17";"Girona";"3";"Girona";"31";"Ripollès";"17145";"Ribes de Freser";"1";"1";"U";"678";"270";"490";"561";"117";"2";"4";"555";"559"
"17";"Girona";"3";"Girona";"31";"Ripollès";"17145";"Ribes de Freser";"1";"2";"U";"808";"303";"568";"699";"109";"6";"1";"692";"693"
"17";"Girona";"3";"Girona";"34";"Selva";"17146";"Riells i Viabrea";"1";"1";"A";"666";"237";"420";"522";"144";"3";"4";"515";"519"
"17";"Girona";"3";"Girona";"34";"Selva";"17146";"Riells i Viabrea";"1";"1";"B";"748";"273";"485";"575";"173";"2";"2";"571";"573"
"17";"Girona";"3";"Girona";"34";"Selva";"17146";"Riells i Viabrea";"1";"2";"A";"773";"270";"472";"557";"216";"12";"2";"543";"545"
"17";"Girona";"3";"Girona";"34";"Selva";"17146";"Riells i Viabrea";"1";"2";"B";"786";"281";"493";"582";"204";"11";"4";"567";"571"
"17";"Girona";"3";"Girona";"31";"Ripollès";"17147";"Ripoll";"1";"1";"A";"568";"215";"345";"423";"145";"0";"5";"418";"423"
"17";"Girona";"3";"Girona";"31";"Ripollès";"17147";"Ripoll";"1";"1";"B";"541";"230";"365";"438";"103";"1";"1";"436";"437"
"17";"Girona";"3";"Girona";"31";"Ripollès";"17147";"Ripoll";"2";"1";"U";"609";"255";"437";"506";"103";"0";"1";"505";"506"
"17";"Girona";"3";"Girona";"31";"Ripollès";"17147";"Ripoll";"2";"2";"U";"598";"219";"367";"419";"179";"1";"1";"417";"418"
"17";"Girona";"3";"Girona";"31";"Ripollès";"17147";"Ripoll";"3";"1";"A";"508";"194";"334";"393";"115";"0";"2";"391";"393"
"17";"Girona";"3";"Girona";"31";"Ripollès";"17147";"Ripoll";"3";"1";"B";"517";"185";"337";"412";"105";"2";"4";"406";"410"
"17";"Girona";"3";"Girona";"31";"Ripollès";"17147";"Ripoll";"3";"2";"U";"660";"233";"453";"536";"124";"1";"1";"534";"535"
"17";"Girona";"3";"Girona";"31";"Ripollès";"17147";"Ripoll";"3";"3";"A";"791";"305";"525";"649";"142";"2";"5";"642";"647"
"17";"Girona";"3";"Girona";"31";"Ripollès";"17147";"Ripoll";"3";"3";"B";"834";"333";"552";"683";"151";"3";"4";"676";"680"
"17";"Girona";"3";"Girona";"31";"Ripollès";"17147";"Ripoll";"3";"4";"A";"739";"206";"460";"570";"169";"1";"2";"567";"569"
"17";"Girona";"3";"Girona";"31";"Ripollès";"17147";"Ripoll";"3";"4";"B";"770";"287";"482";"609";"161";"3";"2";"604";"606"
"17";"Girona";"3";"Girona";"31";"Ripollès";"17147";"Ripoll";"4";"1";"A";"460";"171";"306";"395";"65";"0";"3";"392";"395"
"17";"Girona";"3";"Girona";"31";"Ripollès";"17147";"Ripoll";"4";"1";"B";"530";"201";"343";"447";"83";"3";"0";"444";"444"
"17";"Girona";"3";"Girona";"34";"Selva";"17148";"Riudarenes";"1";"1";"A";"579";"243";"414";"490";"89";"5";"5";"480";"485"
"17";"Girona";"3";"Girona";"34";"Selva";"17148";"Riudarenes";"1";"1";"B";"539";"230";"393";"462";"77";"2";"2";"458";"460"
"17";"Girona";"3";"Girona";"34";"Selva";"17148";"Riudarenes";"1";"1";"C";"405";"132";"204";"246";"159";"0";"1";"245";"246"
"17";"Girona";"3";"Girona";"19";"Garrotxa";"17149";"Riudaura";"1";"1";"U";"362";"155";"263";"324";"38";"0";"3";"321";"324"
"17";"Girona";"3";"Girona";"34";"Selva";"17150";"Riudellots de la Selva";"1";"1";"A";"710";"311";"545";"635";"75";"5";"1";"629";"630"
"17";"Girona";"3";"Girona";"34";"Selva";"17150";"Riudellots de la Selva";"1";"1";"B";"686";"270";"511";"601";"85";"3";"3";"595";"598"
"17";"Girona";"3";"Girona";"2";"Alt Empordà";"17151";"Riumors";"1";"1";"U";"172";"55";"121";"146";"26";"0";"1";"145";"146"
"17";"Girona";"3";"Girona";"2";"Alt Empordà";"17152";"Roses";"1";"1";"A";"592";"184";"309";"392";"200";"2";"2";"388";"390"
"17";"Girona";"3";"Girona";"2";"Alt Empordà";"17152";"Roses";"1";"1";"B";"511";"194";"273";"345";"166";"2";"0";"343";"343"
"17";"Girona";"3";"Girona";"2";"Alt Empordà";"17152";"Roses";"1";"2";"A";"480";"169";"282";"339";"141";"1";"4";"334";"338"
"17";"Girona";"3";"Girona";"2";"Alt Empordà";"17152";"Roses";"1";"2";"B";"548";"196";"317";"395";"153";"2";"0";"393";"393"
"17";"Girona";"3";"Girona";"2";"Alt Empordà";"17152";"Roses";"1";"3";"A";"473";"132";"207";"272";"201";"1";"3";"268";"271"
"17";"Girona";"3";"Girona";"2";"Alt Empordà";"17152";"Roses";"1";"3";"B";"383";"120";"191";"234";"149";"2";"1";"231";"232"
"17";"Girona";"3";"Girona";"2";"Alt Empordà";"17152";"Roses";"1";"4";"A";"546";"200";"346";"414";"132";"2";"4";"408";"412"
"17";"Girona";"3";"Girona";"2";"Alt Empordà";"17152";"Roses";"1";"4";"B";"533";"166";"319";"394";"139";"2";"0";"392";"392"
"17";"Girona";"3";"Girona";"2";"Alt Empordà";"17152";"Roses";"1";"5";"U";"763";"261";"449";"565";"198";"0";"5";"560";"565"
"17";"Girona";"3";"Girona";"2";"Alt Empordà";"17152";"Roses";"1";"6";"A";"606";"217";"344";"428";"178";"1";"1";"426";"427"
"17";"Girona";"3";"Girona";"2";"Alt Empordà";"17152";"Roses";"1";"6";"B";"602";"230";"351";"447";"155";"1";"3";"443";"446"
"17";"Girona";"3";"Girona";"2";"Alt Empordà";"17152";"Roses";"2";"1";"A";"474";"176";"274";"333";"141";"2";"0";"331";"331"
"17";"Girona";"3";"Girona";"2";"Alt Empordà";"17152";"Roses";"2";"1";"B";"458";"183";"269";"318";"140";"1";"2";"315";"317"
"17";"Girona";"3";"Girona";"2";"Alt Empordà";"17152";"Roses";"2";"2";"A";"628";"240";"379";"454";"174";"1";"5";"448";"453"
"17";"Girona";"3";"Girona";"2";"Alt Empordà";"17152";"Roses";"2";"2";"B";"649";"229";"362";"447";"202";"3";"1";"443";"444"
"17";"Girona";"3";"Girona";"2";"Alt Empordà";"17152";"Roses";"2";"3";"U";"724";"239";"449";"539";"185";"3";"3";"533";"536"
"17";"Girona";"3";"Girona";"2";"Alt Empordà";"17152";"Roses";"2";"4";"U";"756";"273";"510";"638";"118";"3";"1";"634";"635"
"17";"Girona";"3";"Girona";"2";"Alt Empordà";"17152";"Roses";"2";"5";"A";"500";"167";"282";"362";"138";"2";"2";"358";"360"
"17";"Girona";"3";"Girona";"2";"Alt Empordà";"17152";"Roses";"2";"5";"B";"476";"178";"291";"369";"107";"0";"1";"368";"369"
"17";"Girona";"3";"Girona";"10";"Baix Empordà";"17153";"Rupià";"1";"1";"U";"185";"90";"142";"166";"19";"1";"0";"165";"165"
"17";"Girona";"3";"Girona";"19";"Garrotxa";"17154";"Sales de Llierca";"1";"1";"U";"92";"46";"60";"77";"15";"0";"0";"77";"77"
"17";"Girona";"3";"Girona";"20";"Gironès";"17155";"Salt";"1";"1";"A";"450";"207";"326";"362";"88";"1";"1";"360";"361"
"17";"Girona";"3";"Girona";"20";"Gironès";"17155";"Salt";"1";"1";"B";"456";"218";"331";"383";"73";"3";"2";"378";"380"
"17";"Girona";"3";"Girona";"20";"Gironès";"17155";"Salt";"1";"2";"U";"729";"356";"520";"598";"131";"2";"2";"594";"596"
"17";"Girona";"3";"Girona";"20";"Gironès";"17155";"Salt";"1";"3";"A";"706";"219";"347";"429";"277";"0";"3";"426";"429"
"17";"Girona";"3";"Girona";"20";"Gironès";"17155";"Salt";"1";"3";"B";"421";"94";"172";"224";"197";"0";"1";"223";"224"
"17";"Girona";"3";"Girona";"20";"Gironès";"17155";"Salt";"1";"4";"A";"798";"317";"513";"601";"197";"1";"1";"599";"600"
"17";"Girona";"3";"Girona";"20";"Gironès";"17155";"Salt";"1";"4";"B";"792";"306";"490";"578";"214";"0";"8";"570";"578"
"17";"Girona";"3";"Girona";"20";"Gironès";"17155";"Salt";"1";"5";"A";"568";"177";"281";"322";"246";"0";"1";"321";"322"
"17";"Girona";"3";"Girona";"20";"Gironès";"17155";"Salt";"1";"5";"B";"598";"200";"314";"367";"231";"3";"1";"363";"364"
"17";"Girona";"3";"Girona";"20";"Gironès";"17155";"Salt";"1";"6";"U";"854";"268";"449";"513";"341";"4";"2";"507";"509"
"17";"Girona";"3";"Girona";"20";"Gironès";"17155";"Salt";"1";"8";"U";"945";"377";"616";"708";"237";"4";"3";"701";"704"
"17";"Girona";"3";"Girona";"20";"Gironès";"17155";"Salt";"1";"9";"U";"693";"281";"484";"574";"119";"3";"2";"569";"571"
"17";"Girona";"3";"Girona";"20";"Gironès";"17155";"Salt";"2";"1";"A";"511";"175";"297";"346";"165";"1";"1";"344";"345"
"17";"Girona";"3";"Girona";"20";"Gironès";"17155";"Salt";"2";"1";"B";"500";"167";"308";"360";"140";"2";"1";"357";"358"
"17";"Girona";"3";"Girona";"20";"Gironès";"17155";"Salt";"2";"2";"U";"766";"270";"450";"521";"245";"1";"2";"518";"520"
"17";"Girona";"3";"Girona";"20";"Gironès";"17155";"Salt";"2";"3";"A";"472";"186";"280";"342";"130";"5";"2";"335";"337"
"17";"Girona";"3";"Girona";"20";"Gironès";"17155";"Salt";"2";"3";"B";"486";"186";"266";"339";"147";"1";"0";"338";"338"
"17";"Girona";"3";"Girona";"20";"Gironès";"17155";"Salt";"2";"4";"A";"733";"259";"418";"487";"246";"1";"2";"484";"486"
"17";"Girona";"3";"Girona";"20";"Gironès";"17155";"Salt";"2";"4";"B";"769";"241";"431";"528";"241";"2";"2";"524";"526"
"17";"Girona";"3";"Girona";"20";"Gironès";"17155";"Salt";"2";"5";"U";"688";"229";"473";"563";"125";"1";"2";"560";"562"
"17";"Girona";"3";"Girona";"20";"Gironès";"17155";"Salt";"2";"6";"U";"668";"229";"365";"441";"227";"4";"2";"435";"437"
"17";"Girona";"3";"Girona";"20";"Gironès";"17155";"Salt";"2";"7";"U";"830";"270";"457";"567";"263";"0";"4";"563";"567"
"17";"Girona";"3";"Girona";"20";"Gironès";"17157";"Sant Andreu Salou";"1";"1";"U";"126";"47";"94";"121";"5";"0";"4";"117";"121"
"17";"Girona";"3";"Girona";"19";"Garrotxa";"17183";"Sant Aniol de Finestres";"1";"1";"U";"273";"123";"201";"241";"32";"2";"1";"238";"239"
"17";"Girona";"3";"Girona";"2";"Alt Empordà";"17158";"Sant Climent Sescebes";"1";"1";"U";"460";"152";"250";"317";"143";"3";"0";"314";"314"
"17";"Girona";"3";"Girona";"34";"Selva";"17159";"Sant Feliu de Buixalleu";"1";"1";"U";"627";"213";"401";"505";"122";"14";"0";"491";"491"
"17";"Girona";"3";"Girona";"10";"Baix Empordà";"17160";"Sant Feliu de Guíxols";"1";"1";"A";"512";"195";"335";"401";"111";"2";"0";"399";"399"
"17";"Girona";"3";"Girona";"10";"Baix Empordà";"17160";"Sant Feliu de Guíxols";"1";"1";"B";"452";"184";"308";"363";"89";"1";"3";"359";"362"
"17";"Girona";"3";"Girona";"10";"Baix Empordà";"17160";"Sant Feliu de Guíxols";"1";"2";"A";"683";"316";"486";"551";"132";"5";"1";"545";"546"
"17";"Girona";"3";"Girona";"10";"Baix Empordà";"17160";"Sant Feliu de Guíxols";"1";"2";"B";"728";"309";"484";"574";"154";"2";"4";"568";"572"
"17";"Girona";"3";"Girona";"10";"Baix Empordà";"17160";"Sant Feliu de Guíxols";"2";"1";"A";"509";"215";"329";"390";"119";"2";"3";"385";"388"
"17";"Girona";"3";"Girona";"10";"Baix Empordà";"17160";"Sant Feliu de Guíxols";"2";"1";"B";"496";"219";"320";"376";"120";"3";"1";"372";"373"
"17";"Girona";"3";"Girona";"10";"Baix Empordà";"17160";"Sant Feliu de Guíxols";"2";"2";"A";"737";"264";"446";"536";"201";"4";"3";"529";"532"
"17";"Girona";"3";"Girona";"10";"Baix Empordà";"17160";"Sant Feliu de Guíxols";"2";"2";"B";"858";"320";"527";"614";"244";"4";"11";"599";"610"
"17";"Girona";"3";"Girona";"10";"Baix Empordà";"17160";"Sant Feliu de Guíxols";"2";"3";"A";"857";"320";"524";"625";"232";"6";"1";"618";"619"
"17";"Girona";"3";"Girona";"10";"Baix Empordà";"17160";"Sant Feliu de Guíxols";"2";"3";"B";"872";"288";"608";"626";"246";"5";"4";"617";"621"
"17";"Girona";"3";"Girona";"10";"Baix Empordà";"17160";"Sant Feliu de Guíxols";"2";"4";"U";"842";"273";"488";"616";"226";"0";"2";"614";"616"
"17";"Girona";"3";"Girona";"10";"Baix Empordà";"17160";"Sant Feliu de Guíxols";"2";"5";"A";"705";"214";"385";"464";"241";"1";"1";"462";"463"
"17";"Girona";"3";"Girona";"10";"Baix Empordà";"17160";"Sant Feliu de Guíxols";"2";"5";"B";"719";"197";"395";"492";"227";"0";"4";"488";"492"
"17";"Girona";"3";"Girona";"10";"Baix Empordà";"17160";"Sant Feliu de Guíxols";"3";"1";"A";"863";"372";"578";"673";"190";"1";"3";"669";"672"
"17";"Girona";"3";"Girona";"10";"Baix Empordà";"17160";"Sant Feliu de Guíxols";"3";"1";"B";"830";"359";"561";"636";"194";"4";"0";"632";"632"
"17";"Girona";"3";"Girona";"10";"Baix Empordà";"17160";"Sant Feliu de Guíxols";"3";"2";"A";"555";"209";"352";"412";"143";"3";"1";"408";"409"
"17";"Girona";"3";"Girona";"10";"Baix Empordà";"17160";"Sant Feliu de Guíxols";"3";"2";"B";"562";"185";"337";"415";"147";"1";"4";"410";"414"
"17";"Girona";"3";"Girona";"10";"Baix Empordà";"17160";"Sant Feliu de Guíxols";"3";"3";"A";"458";"138";"258";"315";"143";"2";"3";"310";"313"
"17";"Girona";"3";"Girona";"10";"Baix Empordà";"17160";"Sant Feliu de Guíxols";"3";"3";"B";"485";"149";"273";"341";"144";"0";"7";"334";"341"
"17";"Girona";"3";"Girona";"10";"Baix Empordà";"17160";"Sant Feliu de Guíxols";"4";"1";"A";"658";"268";"422";"506";"152";"2";"4";"500";"504"
"17";"Girona";"3";"Girona";"10";"Baix Empordà";"17160";"Sant Feliu de Guíxols";"4";"1";"B";"634";"232";"381";"456";"178";"2";"1";"453";"454"
"17";"Girona";"3";"Girona";"10";"Baix Empordà";"17160";"Sant Feliu de Guíxols";"4";"2";"U";"717";"297";"504";"600";"117";"2";"0";"598";"598"
"17";"Girona";"3";"Girona";"19";"Garrotxa";"17161";"Sant Feliu de Pallerols";"1";"1";"A";"501";"262";"380";"452";"49";"0";"3";"449";"452"
"17";"Girona";"3";"Girona";"19";"Garrotxa";"17161";"Sant Feliu de Pallerols";"1";"1";"B";"485";"250";"356";"432";"53";"0";"2";"430";"432"
"17";"Girona";"3";"Girona";"19";"Garrotxa";"17162";"Sant Ferriol";"1";"1";"U";"151";"47";"91";"114";"37";"1";"1";"112";"113"
"17";"Girona";"3";"Girona";"20";"Gironès";"17163";"Sant Gregori";"1";"1";"A";"843";"409";"618";"737";"106";"3";"0";"734";"734"
"17";"Girona";"3";"Girona";"20";"Gironès";"17163";"Sant Gregori";"1";"1";"B";"870";"433";"660";"772";"98";"3";"2";"767";"769"
"17";"Girona";"3";"Girona";"20";"Gironès";"17163";"Sant Gregori";"1";"2";"A";"607";"292";"414";"473";"134";"1";"3";"469";"472"
"17";"Girona";"3";"Girona";"20";"Gironès";"17163";"Sant Gregori";"1";"2";"B";"280";"163";"229";"258";"22";"3";"3";"252";"255"
"17";"Girona";"3";"Girona";"34";"Selva";"17164";"Sant Hilari Sacalm";"1";"1";"A";"492";"186";"371";"411";"81";"1";"2";"408";"410"
"17";"Girona";"3";"Girona";"34";"Selva";"17164";"Sant Hilari Sacalm";"1";"1";"B";"628";"247";"438";"530";"98";"4";"2";"524";"526"
"17";"Girona";"3";"Girona";"34";"Selva";"17164";"Sant Hilari Sacalm";"1";"2";"A";"479";"167";"324";"399";"80";"1";"3";"395";"398"
"17";"Girona";"3";"Girona";"34";"Selva";"17164";"Sant Hilari Sacalm";"1";"2";"B";"534";"219";"400";"443";"91";"0";"2";"441";"443"
"17";"Girona";"3";"Girona";"34";"Selva";"17164";"Sant Hilari Sacalm";"1";"3";"A";"930";"293";"640";"756";"174";"1";"6";"749";"755"
"17";"Girona";"3";"Girona";"34";"Selva";"17164";"Sant Hilari Sacalm";"1";"3";"B";"935";"331";"642";"759";"176";"2";"0";"757";"757"
"17";"Girona";"3";"Girona";"19";"Garrotxa";"17165";"Sant Jaume de Llierca";"1";"1";"U";"650";"302";"493";"558";"92";"0";"3";"555";"558"
"17";"Girona";"3";"Girona";"20";"Gironès";"17168";"Sant Joan de Mollet";"1";"1";"U";"376";"161";"287";"333";"43";"1";"5";"327";"332"
"17";"Girona";"3";"Girona";"31";"Ripollès";"17167";"Sant Joan de les Abadesses";"1";"1";"U";"494";"245";"360";"419";"75";"2";"6";"411";"417"
"17";"Girona";"3";"Girona";"31";"Ripollès";"17167";"Sant Joan de les Abadesses";"1";"2";"A";"766";"376";"545";"636";"130";"3";"6";"627";"633"
"17";"Girona";"3";"Girona";"31";"Ripollès";"17167";"Sant Joan de les Abadesses";"1";"2";"B";"776";"401";"569";"656";"120";"1";"7";"648";"655"
"17";"Girona";"3";"Girona";"31";"Ripollès";"17167";"Sant Joan de les Abadesses";"1";"3";"U";"660";"261";"464";"548";"112";"0";"2";"546";"548"
"17";"Girona";"3";"Girona";"19";"Garrotxa";"17185";"Sant Joan les Fonts";"1";"1";"A";"447";"200";"316";"377";"70";"4";"0";"373";"373"
"17";"Girona";"3";"Girona";"19";"Garrotxa";"17185";"Sant Joan les Fonts";"1";"1";"B";"497";"215";"346";"409";"88";"2";"0";"407";"407"
"17";"Girona";"3";"Girona";"19";"Garrotxa";"17185";"Sant Joan les Fonts";"1";"2";"U";"488";"205";"355";"395";"93";"1";"4";"390";"394"
"17";"Girona";"3";"Girona";"19";"Garrotxa";"17185";"Sant Joan les Fonts";"1";"3";"A";"644";"277";"463";"552";"92";"0";"4";"548";"552"
"17";"Girona";"3";"Girona";"19";"Garrotxa";"17185";"Sant Joan les Fonts";"1";"3";"B";"212";"67";"143";"170";"42";"0";"4";"166";"170"
"17";"Girona";"3";"Girona";"20";"Gironès";"17166";"Sant Jordi Desvalls";"1";"1";"U";"516";"222";"392";"449";"67";"5";"2";"442";"444"
"17";"Girona";"3";"Girona";"20";"Gironès";"17169";"Sant Julià de Ramis";"1";"1";"A";"930";"381";"632";"787";"143";"2";"4";"781";"785"
"17";"Girona";"3";"Girona";"20";"Gironès";"17169";"Sant Julià de Ramis";"1";"1";"B";"926";"374";"636";"778";"148";"1";"1";"776";"777"
"17";"Girona";"3";"Girona";"20";"Gironès";"17169";"Sant Julià de Ramis";"1";"2";"U";"634";"271";"425";"524";"110";"4";"2";"518";"520"
"17";"Girona";"3";"Girona";"34";"Selva";"17903";"Sant Julià del Llor i Bonmatí";"1";"1";"U";"892";"317";"663";"735";"157";"18";"3";"714";"717"
"17";"Girona";"3";"Girona";"2";"Alt Empordà";"17171";"Sant Llorenç de la Muga";"1";"1";"U";"165";"67";"114";"140";"25";"1";"1";"138";"139"
"17";"Girona";"3";"Girona";"20";"Gironès";"17173";"Sant Martí Vell";"1";"1";"U";"178";"89";"137";"157";"21";"0";"0";"157";"157"
"17";"Girona";"3";"Girona";"20";"Gironès";"17172";"Sant Martí de Llémena";"1";"1";"U";"454";"175";"323";"382";"72";"4";"3";"375";"378"
"17";"Girona";"3";"Girona";"28";"Pla de l'Estany";"17174";"Sant Miquel de Campmajor";"1";"1";"U";"177";"61";"122";"147";"30";"0";"3";"144";"147"
"17";"Girona";"3";"Girona";"2";"Alt Empordà";"17175";"Sant Miquel de Fluvià";"1";"1";"U";"577";"218";"351";"411";"166";"2";"5";"404";"409"
"17";"Girona";"3";"Girona";"2";"Alt Empordà";"17176";"Sant Mori";"1";"1";"U";"121";"57";"90";"105";"16";"1";"1";"103";"104"
"17";"Girona";"3";"Girona";"31";"Ripollès";"17177";"Sant Pau de Segúries";"1";"1";"U";"561";"240";"412";"477";"84";"4";"1";"472";"473"
"17";"Girona";"3";"Girona";"2";"Alt Empordà";"17178";"Sant Pere Pescador";"1";"1";"A";"573";"233";"366";"434";"139";"2";"3";"429";"432"
"17";"Girona";"3";"Girona";"2";"Alt Empordà";"17178";"Sant Pere Pescador";"1";"1";"B";"489";"221";"348";"399";"90";"1";"4";"394";"398"
"17";"Girona";"3";"Girona";"34";"Selva";"17180";"Santa Coloma de Farners";"1";"1";"A";"748";"257";"452";"543";"205";"2";"5";"536";"541"
"17";"Girona";"3";"Girona";"34";"Selva";"17180";"Santa Coloma de Farners";"1";"1";"B";"711";"271";"464";"556";"155";"6";"2";"548";"550"
"17";"Girona";"3";"Girona";"34";"Selva";"17180";"Santa Coloma de Farners";"1";"2";"A";"522";"165";"332";"417";"105";"3";"2";"412";"414"
"17";"Girona";"3";"Girona";"34";"Selva";"17180";"Santa Coloma de Farners";"1";"2";"B";"525";"181";"332";"414";"111";"1";"7";"406";"413"
"17";"Girona";"3";"Girona";"34";"Selva";"17180";"Santa Coloma de Farners";"1";"3";"A";"758";"269";"481";"598";"160";"1";"1";"596";"597"
"17";"Girona";"3";"Girona";"34";"Selva";"17180";"Santa Coloma de Farners";"1";"3";"B";"733";"245";"450";"566";"167";"3";"0";"563";"563"
"17";"Girona";"3";"Girona";"34";"Selva";"17180";"Santa Coloma de Farners";"1";"4";"A";"927";"344";"632";"768";"159";"3";"4";"761";"765"
"17";"Girona";"3";"Girona";"34";"Selva";"17180";"Santa Coloma de Farners";"1";"4";"B";"890";"281";"574";"708";"182";"1";"6";"701";"707"
"17";"Girona";"3";"Girona";"34";"Selva";"17180";"Santa Coloma de Farners";"1";"5";"A";"677";"231";"392";"519";"158";"2";"3";"514";"517"
"17";"Girona";"3";"Girona";"34";"Selva";"17180";"Santa Coloma de Farners";"1";"5";"B";"593";"230";"380";"467";"126";"3";"2";"462";"464"
"17";"Girona";"3";"Girona";"34";"Selva";"17180";"Santa Coloma de Farners";"1";"6";"A";"556";"195";"324";"431";"125";"1";"0";"430";"430"
"17";"Girona";"3";"Girona";"34";"Selva";"17180";"Santa Coloma de Farners";"1";"6";"B";"665";"194";"368";"489";"176";"2";"3";"484";"487"
"17";"Girona";"3";"Girona";"10";"Baix Empordà";"17181";"Santa Cristina d'Aro";"1";"1";"A";"830";"224";"497";"652";"178";"3";"5";"644";"649"
"17";"Girona";"3";"Girona";"10";"Baix Empordà";"17181";"Santa Cristina d'Aro";"1";"1";"B";"876";"242";"544";"674";"202";"3";"8";"663";"671"
"17";"Girona";"3";"Girona";"10";"Baix Empordà";"17181";"Santa Cristina d'Aro";"1";"2";"A";"807";"313";"516";"613";"194";"3";"3";"607";"610"
"17";"Girona";"3";"Girona";"10";"Baix Empordà";"17181";"Santa Cristina d'Aro";"1";"2";"B";"845";"334";"531";"658";"187";"3";"1";"654";"655"
"17";"Girona";"3";"Girona";"2";"Alt Empordà";"17182";"Santa Llogaia d'Àlguema";"1";"1";"U";"260";"90";"191";"202";"58";"0";"1";"201";"202"
"17";"Girona";"3";"Girona";"19";"Garrotxa";"17184";"Santa Pau";"1";"1";"A";"746";"319";"587";"648";"98";"5";"3";"640";"643"
"17";"Girona";"3";"Girona";"19";"Garrotxa";"17184";"Santa Pau";"1";"1";"B";"512";"243";"386";"458";"54";"3";"1";"454";"455"
"17";"Girona";"3";"Girona";"20";"Gironès";"17186";"Sarrià de Ter";"1";"1";"A";"510";"237";"378";"436";"74";"4";"0";"432";"432"
"17";"Girona";"3";"Girona";"20";"Gironès";"17186";"Sarrià de Ter";"1";"1";"B";"519";"259";"390";"445";"74";"4";"2";"439";"441"
"17";"Girona";"3";"Girona";"20";"Gironès";"17186";"Sarrià de Ter";"1";"2";"A";"803";"366";"575";"667";"136";"10";"0";"657";"657"
"17";"Girona";"3";"Girona";"20";"Gironès";"17186";"Sarrià de Ter";"1";"2";"B";"869";"400";"613";"714";"155";"8";"5";"701";"706"
"17";"Girona";"3";"Girona";"20";"Gironès";"17186";"Sarrià de Ter";"1";"3";"A";"522";"218";"337";"407";"115";"6";"4";"397";"401"
"17";"Girona";"3";"Girona";"20";"Gironès";"17186";"Sarrià de Ter";"1";"3";"B";"500";"236";"347";"397";"103";"0";"1";"396";"397"
"17";"Girona";"3";"Girona";"2";"Alt Empordà";"17187";"Saus, Camallera i Llampaies";"1";"1";"U";"614";"311";"477";"541";"73";"4";"3";"534";"537"
"17";"Girona";"3";"Girona";"2";"Alt Empordà";"17188";"Selva de Mar, la";"1";"1";"U";"166";"87";"116";"141";"25";"0";"0";"141";"141"
"17";"Girona";"3";"Girona";"28";"Pla de l'Estany";"17190";"Serinyà";"1";"1";"U";"840";"375";"626";"715";"125";"4";"5";"706";"711"
"17";"Girona";"3";"Girona";"10";"Baix Empordà";"17191";"Serra de Daró";"1";"1";"U";"145";"78";"115";"128";"17";"1";"1";"126";"127"
"17";"Girona";"3";"Girona";"31";"Ripollès";"17192";"Setcases";"1";"1";"U";"147";"58";"103";"128";"19";"0";"0";"128";"128"
"17";"Girona";"3";"Girona";"34";"Selva";"17193";"Sils";"1";"1";"A";"804";"265";"504";"625";"179";"1";"7";"617";"624"
"17";"Girona";"3";"Girona";"34";"Selva";"17193";"Sils";"1";"1";"B";"819";"294";"565";"675";"144";"3";"6";"666";"672"
"17";"Girona";"3";"Girona";"34";"Selva";"17193";"Sils";"1";"2";"A";"677";"237";"416";"506";"171";"5";"3";"498";"501"
"17";"Girona";"3";"Girona";"34";"Selva";"17193";"Sils";"1";"2";"B";"636";"246";"437";"521";"115";"0";"2";"519";"521"
"17";"Girona";"3";"Girona";"34";"Selva";"17193";"Sils";"1";"3";"A";"671";"213";"372";"451";"220";"5";"1";"445";"446"
"17";"Girona";"3";"Girona";"34";"Selva";"17193";"Sils";"1";"3";"B";"610";"206";"341";"427";"183";"4";"2";"421";"423"
"17";"Girona";"3";"Girona";"2";"Alt Empordà";"17052";"Siurana";"1";"1";"U";"125";"51";"82";"104";"21";"1";"0";"103";"103"
"17";"Girona";"3";"Girona";"34";"Selva";"17194";"Susqueda";"1";"1";"U";"79";"36";"51";"68";"11";"0";"1";"67";"68"
"17";"Girona";"3";"Girona";"10";"Baix Empordà";"17195";"Tallada d'Empordà, la";"1";"1";"U";"342";"174";"268";"305";"37";"0";"2";"303";"305"
"17";"Girona";"3";"Girona";"2";"Alt Empordà";"17196";"Terrades";"1";"1";"U";"214";"65";"160";"180";"34";"0";"3";"177";"180"
"17";"Girona";"3";"Girona";"10";"Baix Empordà";"17197";"Torrent";"1";"1";"U";"136";"57";"94";"117";"19";"2";"0";"115";"115"
"17";"Girona";"3";"Girona";"2";"Alt Empordà";"17198";"Torroella de Fluvià";"1";"1";"U";"425";"170";"269";"325";"100";"2";"3";"320";"323"
"17";"Girona";"3";"Girona";"10";"Baix Empordà";"17199";"Torroella de Montgrí";"1";"1";"A";"508";"207";"333";"411";"97";"2";"2";"407";"409"
"17";"Girona";"3";"Girona";"10";"Baix Empordà";"17199";"Torroella de Montgrí";"1";"1";"B";"508";"237";"353";"427";"81";"0";"0";"427";"427"
"17";"Girona";"3";"Girona";"10";"Baix Empordà";"17199";"Torroella de Montgrí";"1";"2";"U";"600";"235";"396";"496";"104";"1";"2";"493";"495"
"17";"Girona";"3";"Girona";"10";"Baix Empordà";"17199";"Torroella de Montgrí";"1";"3";"A";"730";"223";"409";"514";"216";"2";"5";"507";"512"
"17";"Girona";"3";"Girona";"10";"Baix Empordà";"17199";"Torroella de Montgrí";"1";"3";"B";"727";"252";"392";"503";"224";"6";"4";"493";"497"
"17";"Girona";"3";"Girona";"10";"Baix Empordà";"17199";"Torroella de Montgrí";"1";"4";"A";"690";"262";"463";"575";"115";"3";"1";"571";"572"
"17";"Girona";"3";"Girona";"10";"Baix Empordà";"17199";"Torroella de Montgrí";"1";"4";"B";"688";"273";"452";"566";"122";"4";"1";"561";"562"
"17";"Girona";"3";"Girona";"10";"Baix Empordà";"17199";"Torroella de Montgrí";"1";"5";"U";"694";"270";"422";"537";"157";"1";"3";"533";"536"
"17";"Girona";"3";"Girona";"10";"Baix Empordà";"17199";"Torroella de Montgrí";"1";"6";"A";"546";"176";"325";"419";"127";"5";"4";"410";"414"
"17";"Girona";"3";"Girona";"10";"Baix Empordà";"17199";"Torroella de Montgrí";"1";"6";"B";"505";"201";"348";"432";"73";"2";"3";"427";"430"
"17";"Girona";"3";"Girona";"10";"Baix Empordà";"17199";"Torroella de Montgrí";"1";"7";"U";"634";"228";"398";"495";"139";"2";"3";"490";"493"
"17";"Girona";"3";"Girona";"19";"Garrotxa";"17200";"Tortellà";"1";"1";"U";"616";"331";"457";"523";"93";"1";"6";"516";"522"
"17";"Girona";"3";"Girona";"31";"Ripollès";"17201";"Toses";"1";"1";"U";"131";"59";"87";"120";"11";"0";"1";"119";"120"
"17";"Girona";"3";"Girona";"34";"Selva";"17202";"Tossa de Mar";"1";"1";"U";"875";"300";"537";"632";"243";"2";"4";"626";"630"
"17";"Girona";"3";"Girona";"34";"Selva";"17202";"Tossa de Mar";"1";"2";"A";"541";"170";"332";"425";"116";"5";"2";"418";"420"
"17";"Girona";"3";"Girona";"34";"Selva";"17202";"Tossa de Mar";"1";"2";"B";"584";"187";"351";"442";"142";"4";"0";"438";"438"
"17";"Girona";"3";"Girona";"34";"Selva";"17202";"Tossa de Mar";"1";"3";"A";"938";"307";"595";"737";"201";"5";"3";"729";"732"
"17";"Girona";"3";"Girona";"34";"Selva";"17202";"Tossa de Mar";"1";"3";"B";"860";"296";"558";"688";"172";"4";"3";"681";"684"
"17";"Girona";"3";"Girona";"10";"Baix Empordà";"17205";"Ullastret";"1";"1";"U";"216";"98";"168";"193";"23";"0";"0";"193";"193"
"17";"Girona";"3";"Girona";"10";"Baix Empordà";"17204";"Ullà";"1";"1";"U";"558";"244";"385";"448";"110";"1";"7";"440";"447"
"17";"Girona";"3";"Girona";"10";"Baix Empordà";"17203";"Ultramort";"1";"1";"U";"154";"66";"112";"138";"16";"3";"0";"135";"135"
"17";"Girona";"3";"Girona";"2";"Alt Empordà";"17014";"Vajol, la";"1";"1";"U";"62";"25";"41";"56";"6";"0";"2";"54";"56"
"17";"Girona";"3";"Girona";"19";"Garrotxa";"17207";"Vall d'en Bas, la";"1";"1";"A";"922";"448";"701";"810";"112";"2";"3";"805";"808"
"17";"Girona";"3";"Girona";"19";"Garrotxa";"17207";"Vall d'en Bas, la";"1";"1";"B";"221";"102";"165";"201";"20";"3";"0";"198";"198"
"17";"Girona";"3";"Girona";"19";"Garrotxa";"17207";"Vall d'en Bas, la";"1";"2";"A";"470";"207";"330";"396";"74";"2";"1";"393";"394"
"17";"Girona";"3";"Girona";"19";"Garrotxa";"17207";"Vall d'en Bas, la";"1";"2";"B";"496";"198";"362";"430";"66";"1";"3";"426";"429"
"17";"Girona";"3";"Girona";"19";"Garrotxa";"17207";"Vall d'en Bas, la";"1";"2";"C";"264";"101";"177";"229";"35";"0";"0";"229";"229"
"17";"Girona";"3";"Girona";"19";"Garrotxa";"17208";"Vall de Bianya, la";"1";"1";"A";"458";"196";"326";"372";"86";"1";"3";"368";"371"
"17";"Girona";"3";"Girona";"19";"Garrotxa";"17208";"Vall de Bianya, la";"1";"1";"B";"544";"249";"400";"461";"83";"1";"7";"453";"460"
"17";"Girona";"3";"Girona";"10";"Baix Empordà";"17209";"Vall-llobrega";"1";"1";"U";"625";"232";"432";"540";"85";"1";"2";"537";"539"
"17";"Girona";"3";"Girona";"31";"Ripollès";"17170";"Vallfogona de Ripollès";"1";"1";"U";"174";"68";"124";"150";"24";"0";"0";"150";"150"
"17";"Girona";"3";"Girona";"2";"Alt Empordà";"17210";"Ventalló";"1";"1";"U";"557";"230";"388";"456";"101";"2";"3";"451";"454"
"17";"Girona";"3";"Girona";"10";"Baix Empordà";"17211";"Verges";"1";"1";"U";"836";"417";"624";"730";"106";"4";"2";"724";"726"
"17";"Girona";"3";"Girona";"34";"Selva";"17213";"Vidreres";"1";"1";"A";"763";"301";"515";"616";"147";"1";"1";"614";"615"
"17";"Girona";"3";"Girona";"34";"Selva";"17213";"Vidreres";"1";"1";"B";"764";"308";"503";"600";"164";"5";"1";"594";"595"
"17";"Girona";"3";"Girona";"34";"Selva";"17213";"Vidreres";"1";"2";"U";"910";"294";"571";"705";"205";"1";"3";"701";"704"
"17";"Girona";"3";"Girona";"34";"Selva";"17213";"Vidreres";"1";"3";"A";"764";"286";"496";"618";"146";"6";"4";"608";"612"
"17";"Girona";"3";"Girona";"34";"Selva";"17213";"Vidreres";"1";"3";"B";"794";"272";"525";"646";"148";"7";"0";"639";"639"
"17";"Girona";"3";"Girona";"34";"Selva";"17213";"Vidreres";"1";"4";"A";"678";"200";"326";"412";"266";"4";"2";"406";"408"
"17";"Girona";"3";"Girona";"34";"Selva";"17213";"Vidreres";"1";"4";"B";"711";"229";"377";"481";"230";"3";"1";"477";"478"
"17";"Girona";"3";"Girona";"2";"Alt Empordà";"17230";"Vila-sacra";"1";"1";"U";"451";"210";"333";"388";"63";"0";"0";"388";"388"
"17";"Girona";"3";"Girona";"2";"Alt Empordà";"17214";"Vilabertran";"1";"1";"U";"707";"294";"468";"580";"127";"4";"3";"573";"576"
"17";"Girona";"3";"Girona";"20";"Gironès";"17215";"Vilablareix";"1";"1";"A";"541";"220";"389";"457";"84";"2";"9";"446";"455"
"17";"Girona";"3";"Girona";"20";"Gironès";"17215";"Vilablareix";"1";"1";"B";"565";"239";"430";"499";"66";"1";"2";"496";"498"
"17";"Girona";"3";"Girona";"20";"Gironès";"17215";"Vilablareix";"1";"2";"A";"488";"189";"337";"416";"72";"0";"1";"415";"416"
"17";"Girona";"3";"Girona";"20";"Gironès";"17215";"Vilablareix";"1";"2";"B";"452";"167";"313";"393";"59";"0";"3";"390";"393"
"17";"Girona";"3";"Girona";"2";"Alt Empordà";"17217";"Viladamat";"1";"1";"U";"341";"192";"290";"309";"32";"1";"0";"308";"308"
"17";"Girona";"3";"Girona";"20";"Gironès";"17216";"Viladasens";"1";"1";"U";"164";"81";"127";"146";"18";"1";"1";"144";"145"
"17";"Girona";"3";"Girona";"28";"Pla de l'Estany";"17218";"Vilademuls";"1";"1";"A";"263";"112";"192";"229";"34";"0";"1";"228";"229"
"17";"Girona";"3";"Girona";"28";"Pla de l'Estany";"17218";"Vilademuls";"1";"1";"B";"327";"166";"255";"285";"42";"1";"2";"282";"284"
"17";"Girona";"3";"Girona";"2";"Alt Empordà";"17221";"Vilafant";"1";"1";"A";"490";"190";"303";"360";"130";"0";"1";"359";"360"
"17";"Girona";"3";"Girona";"2";"Alt Empordà";"17221";"Vilafant";"1";"1";"B";"458";"194";"309";"362";"96";"2";"0";"360";"360"
"17";"Girona";"3";"Girona";"2";"Alt Empordà";"17221";"Vilafant";"1";"2";"U";"772";"269";"500";"616";"156";"4";"2";"610";"612"
"17";"Girona";"3";"Girona";"2";"Alt Empordà";"17221";"Vilafant";"1";"3";"A";"679";"255";"400";"497";"182";"0";"2";"495";"497"
"17";"Girona";"3";"Girona";"2";"Alt Empordà";"17221";"Vilafant";"1";"3";"B";"620";"243";"406";"481";"139";"1";"1";"479";"480"
"17";"Girona";"3";"Girona";"2";"Alt Empordà";"17221";"Vilafant";"1";"4";"A";"557";"251";"388";"450";"107";"1";"0";"449";"449"
"17";"Girona";"3";"Girona";"2";"Alt Empordà";"17221";"Vilafant";"1";"4";"B";"616";"245";"427";"509";"107";"0";"2";"507";"509"
"17";"Girona";"3";"Girona";"2";"Alt Empordà";"17223";"Vilajuïga";"1";"1";"U";"817";"270";"518";"633";"184";"4";"5";"624";"629"
"17";"Girona";"3";"Girona";"31";"Ripollès";"17224";"Vilallonga de Ter";"1";"1";"U";"312";"129";"200";"259";"53";"0";"2";"257";"259"
"17";"Girona";"3";"Girona";"2";"Alt Empordà";"17225";"Vilamacolum";"1";"1";"U";"209";"90";"142";"165";"44";"1";"3";"161";"164"
"17";"Girona";"3";"Girona";"2";"Alt Empordà";"17226";"Vilamalla";"1";"1";"A";"417";"155";"260";"306";"111";"2";"2";"302";"304"
"17";"Girona";"3";"Girona";"2";"Alt Empordà";"17226";"Vilamalla";"1";"1";"B";"430";"169";"294";"344";"86";"3";"2";"339";"341"
"17";"Girona";"3";"Girona";"2";"Alt Empordà";"17227";"Vilamaniscle";"1";"1";"U";"128";"54";"90";"106";"22";"2";"1";"103";"104"
"17";"Girona";"3";"Girona";"2";"Alt Empordà";"17228";"Vilanant";"1";"1";"U";"294";"130";"225";"253";"41";"2";"0";"251";"251"
"17";"Girona";"3";"Girona";"2";"Alt Empordà";"17222";"Vilaür";"1";"1";"U";"108";"53";"77";"94";"14";"0";"1";"93";"94"
"17";"Girona";"3";"Girona";"34";"Selva";"17233";"Vilobí d'Onyar";"1";"1";"U";"712";"319";"529";"625";"87";"0";"4";"621";"625"
"17";"Girona";"3";"Girona";"34";"Selva";"17233";"Vilobí d'Onyar";"1";"2";"A";"816";"353";"577";"681";"135";"4";"1";"676";"677"
"17";"Girona";"3";"Girona";"34";"Selva";"17233";"Vilobí d'Onyar";"1";"2";"B";"757";"314";"522";"631";"126";"5";"5";"621";"626"
"17";"Girona";"3";"Girona";"10";"Baix Empordà";"17232";"Vilopriu";"1";"1";"U";"142";"72";"97";"123";"19";"1";"0";"122";"122"
"25";"Lleida";"5";"Alt Pirineu i territori d'Aran";"25";"Pallars Jussà";"25001";"Abella de la Conca";"1";"1";"U";"139";"33";"59";"108";"31";"1";"0";"107";"107"
"25";"Lleida";"5";"Alt Pirineu i territori d'Aran";"26";"Pallars Sobirà";"25017";"Alins";"1";"1";"U";"239";"64";"136";"195";"44";"3";"1";"191";"192"
"25";"Lleida";"5";"Alt Pirineu i territori d'Aran";"26";"Pallars Sobirà";"25024";"Alt Àneu";"1";"1";"U";"351";"115";"188";"287";"64";"2";"4";"281";"285"
"25";"Lleida";"5";"Alt Pirineu i territori d'Aran";"4";"Alt Urgell";"25005";"Alàs i Cerc";"1";"1";"U";"277";"97";"171";"221";"56";"1";"7";"213";"220"
"25";"Lleida";"5";"Alt Pirineu i territori d'Aran";"39";"Consell General d'Aran";"25031";"Arres";"1";"1";"U";"52";"8";"19";"36";"16";"0";"0";"36";"36"
"25";"Lleida";"5";"Alt Pirineu i territori d'Aran";"4";"Alt Urgell";"25032";"Arsèguel";"1";"1";"U";"60";"11";"34";"50";"10";"0";"1";"49";"50"
"25";"Lleida";"5";"Alt Pirineu i territori d'Aran";"26";"Pallars Sobirà";"25039";"Baix Pallars";"1";"1";"U";"288";"106";"187";"244";"44";"0";"1";"243";"244"
"25";"Lleida";"5";"Alt Pirineu i territori d'Aran";"4";"Alt Urgell";"25044";"Bassella";"1";"1";"U";"190";"62";"118";"156";"34";"1";"1";"154";"155"
"25";"Lleida";"5";"Alt Pirineu i territori d'Aran";"39";"Consell General d'Aran";"25045";"Bausen";"1";"1";"U";"49";"24";"28";"38";"11";"0";"0";"38";"38"
"25";"Lleida";"5";"Alt Pirineu i territori d'Aran";"15";"Cerdanya";"25051";"Bellver de Cerdanya";"1";"1";"A";"745";"151";"479";"588";"157";"3";"3";"582";"585"
"25";"Lleida";"5";"Alt Pirineu i territori d'Aran";"15";"Cerdanya";"25051";"Bellver de Cerdanya";"1";"1";"B";"768";"283";"529";"641";"127";"1";"2";"638";"640"
"25";"Lleida";"5";"Alt Pirineu i territori d'Aran";"39";"Consell General d'Aran";"25059";"Bossòst";"1";"1";"U";"805";"258";"451";"597";"208";"2";"3";"592";"595"
"25";"Lleida";"5";"Alt Pirineu i territori d'Aran";"39";"Consell General d'Aran";"25057";"Bòrdes, es";"1";"1";"U";"201";"66";"109";"159";"42";"1";"2";"156";"158"
"25";"Lleida";"5";"Alt Pirineu i territori d'Aran";"4";"Alt Urgell";"25061";"Cabó";"1";"1";"U";"82";"21";"49";"66";"16";"0";"0";"66";"66"
"25";"Lleida";"5";"Alt Pirineu i territori d'Aran";"39";"Consell General d'Aran";"25063";"Canejan";"1";"1";"U";"91";"27";"45";"64";"27";"0";"0";"64";"64"
"25";"Lleida";"5";"Alt Pirineu i territori d'Aran";"25";"Pallars Jussà";"25904";"Castell de Mur";"1";"1";"U";"155";"70";"109";"139";"16";"0";"2";"137";"139"
"25";"Lleida";"5";"Alt Pirineu i territori d'Aran";"4";"Alt Urgell";"25071";"Cava";"1";"1";"U";"52";"19";"24";"41";"11";"0";"0";"41";"41"
"25";"Lleida";"5";"Alt Pirineu i territori d'Aran";"4";"Alt Urgell";"25077";"Coll de Nargó";"1";"1";"U";"457";"158";"272";"347";"110";"0";"0";"347";"347"
"25";"Lleida";"5";"Alt Pirineu i territori d'Aran";"25";"Pallars Jussà";"25161";"Conca de Dalt";"1";"1";"U";"371";"116";"202";"276";"95";"1";"0";"275";"275"
"25";"Lleida";"5";"Alt Pirineu i territori d'Aran";"26";"Pallars Sobirà";"25082";"Espot";"1";"1";"U";"278";"61";"155";"217";"61";"0";"2";"215";"217"
"25";"Lleida";"5";"Alt Pirineu i territori d'Aran";"4";"Alt Urgell";"25088";"Estamariu";"1";"1";"U";"96";"20";"76";"87";"9";"0";"0";"87";"87"
"25";"Lleida";"5";"Alt Pirineu i territori d'Aran";"26";"Pallars Sobirà";"25086";"Esterri d'Àneu";"1";"1";"U";"531";"210";"294";"448";"83";"4";"0";"444";"444"
"25";"Lleida";"5";"Alt Pirineu i territori d'Aran";"26";"Pallars Sobirà";"25087";"Esterri de Cardós";"1";"1";"U";"62";"21";"40";"52";"10";"0";"1";"51";"52"
"25";"Lleida";"5";"Alt Pirineu i territori d'Aran";"26";"Pallars Sobirà";"25089";"Farrera";"1";"1";"U";"105";"12";"38";"87";"18";"0";"0";"87";"87"
"25";"Lleida";"5";"Alt Pirineu i territori d'Aran";"4";"Alt Urgell";"25908";"Fígols i Alinyà";"1";"1";"U";"228";"75";"143";"179";"49";"1";"3";"175";"178"
"25";"Lleida";"5";"Alt Pirineu i territori d'Aran";"25";"Pallars Jussà";"25098";"Gavet de la Conca";"1";"1";"U";"251";"76";"138";"197";"54";"1";"1";"195";"196"
"25";"Lleida";"5";"Alt Pirineu i territori d'Aran";"26";"Pallars Sobirà";"25903";"Guingueta d'Àneu, la";"1";"1";"U";"239";"92";"148";"204";"35";"1";"0";"203";"203"
"25";"Lleida";"5";"Alt Pirineu i territori d'Aran";"25";"Pallars Jussà";"25115";"Isona i Conca Dellà";"1";"1";"A";"540";"195";"322";"450";"90";"2";"8";"440";"448"
"25";"Lleida";"5";"Alt Pirineu i territori d'Aran";"25";"Pallars Jussà";"25115";"Isona i Conca Dellà";"1";"1";"B";"291";"66";"174";"216";"75";"3";"5";"208";"213"
"25";"Lleida";"5";"Alt Pirineu i territori d'Aran";"4";"Alt Urgell";"25910";"Josa i Tuixén";"1";"1";"U";"103";"34";"59";"86";"17";"1";"1";"84";"85"
"25";"Lleida";"5";"Alt Pirineu i territori d'Aran";"39";"Consell General d'Aran";"25121";"Les";"1";"1";"U";"647";"149";"323";"433";"214";"2";"12";"419";"431"
"25";"Lleida";"5";"Alt Pirineu i territori d'Aran";"26";"Pallars Sobirà";"25123";"Lladorre";"1";"1";"U";"195";"53";"114";"164";"31";"0";"2";"162";"164"
"25";"Lleida";"5";"Alt Pirineu i territori d'Aran";"26";"Pallars Sobirà";"25126";"Llavorsí";"1";"1";"U";"285";"82";"169";"228";"57";"3";"7";"218";"225"
"25";"Lleida";"5";"Alt Pirineu i territori d'Aran";"15";"Cerdanya";"25127";"Lles de Cerdanya";"1";"1";"U";"213";"78";"147";"187";"26";"2";"1";"184";"185"
"25";"Lleida";"5";"Alt Pirineu i territori d'Aran";"25";"Pallars Jussà";"25128";"Llimiana";"1";"1";"U";"144";"45";"80";"107";"37";"0";"0";"107";"107"
"25";"Lleida";"5";"Alt Pirineu i territori d'Aran";"15";"Cerdanya";"25139";"Montellà i Martinet";"1";"1";"U";"484";"196";"329";"405";"79";"1";"4";"400";"404"
"25";"Lleida";"5";"Alt Pirineu i territori d'Aran";"4";"Alt Urgell";"25140";"Montferrer i Castellbò";"1";"1";"U";"781";"276";"459";"576";"205";"2";"8";"566";"574"
"25";"Lleida";"5";"Alt Pirineu i territori d'Aran";"39";"Consell General d'Aran";"25025";"Naut Aran";"1";"1";"A";"856";"167";"375";"573";"283";"5";"8";"560";"568"
"25";"Lleida";"5";"Alt Pirineu i territori d'Aran";"39";"Consell General d'Aran";"25025";"Naut Aran";"1";"1";"B";"490";"122";"263";"366";"124";"2";"2";"362";"364"
"25";"Lleida";"5";"Alt Pirineu i territori d'Aran";"4";"Alt Urgell";"25149";"Oliana";"1";"1";"A";"636";"244";"438";"542";"94";"3";"3";"536";"539"
"25";"Lleida";"5";"Alt Pirineu i territori d'Aran";"4";"Alt Urgell";"25149";"Oliana";"1";"1";"B";"741";"257";"503";"620";"121";"4";"5";"611";"616"
"25";"Lleida";"5";"Alt Pirineu i territori d'Aran";"4";"Alt Urgell";"25155";"Organyà";"1";"1";"U";"669";"281";"451";"543";"126";"2";"4";"537";"541"
"25";"Lleida";"5";"Alt Pirineu i territori d'Aran";"4";"Alt Urgell";"25165";"Peramola";"1";"1";"U";"280";"80";"175";"233";"47";"6";"1";"226";"227"
"25";"Lleida";"5";"Alt Pirineu i territori d'Aran";"25";"Pallars Jussà";"25171";"Pobla de Segur, la";"1";"1";"U";"1000";"359";"618";"785";"215";"5";"7";"773";"780"
"25";"Lleida";"5";"Alt Pirineu i territori d'Aran";"25";"Pallars Jussà";"25171";"Pobla de Segur, la";"1";"2";"A";"582";"224";"371";"476";"106";"2";"5";"469";"474"
"25";"Lleida";"5";"Alt Pirineu i territori d'Aran";"25";"Pallars Jussà";"25171";"Pobla de Segur, la";"1";"2";"B";"611";"233";"371";"480";"131";"0";"2";"478";"480"
"25";"Lleida";"5";"Alt Pirineu i territori d'Aran";"4";"Alt Urgell";"25030";"Pont de Bar, el";"1";"1";"U";"132";"50";"78";"99";"33";"0";"1";"98";"99"
"25";"Lleida";"5";"Alt Pirineu i territori d'Aran";"5";"Alta Ribagorça";"25173";"Pont de Suert, el";"1";"1";"A";"544";"167";"313";"416";"128";"3";"6";"407";"413"
"25";"Lleida";"5";"Alt Pirineu i territori d'Aran";"5";"Alta Ribagorça";"25173";"Pont de Suert, el";"1";"1";"B";"602";"178";"337";"473";"129";"3";"4";"466";"470"
"25";"Lleida";"5";"Alt Pirineu i territori d'Aran";"5";"Alta Ribagorça";"25173";"Pont de Suert, el";"1";"2";"U";"561";"190";"308";"399";"162";"4";"1";"394";"395"
"25";"Lleida";"5";"Alt Pirineu i territori d'Aran";"15";"Cerdanya";"25175";"Prats i Sansor";"1";"1";"U";"196";"89";"136";"175";"21";"0";"4";"171";"175"
"25";"Lleida";"5";"Alt Pirineu i territori d'Aran";"15";"Cerdanya";"25179";"Prullans";"1";"1";"U";"163";"69";"114";"142";"21";"1";"1";"140";"141"
"25";"Lleida";"5";"Alt Pirineu i territori d'Aran";"26";"Pallars Sobirà";"25183";"Rialp";"1";"1";"U";"502";"156";"305";"405";"97";"2";"4";"399";"403"
"25";"Lleida";"5";"Alt Pirineu i territori d'Aran";"4";"Alt Urgell";"25185";"Ribera d'Urgellet";"1";"1";"U";"683";"220";"435";"522";"161";"0";"7";"515";"522"
"25";"Lleida";"5";"Alt Pirineu i territori d'Aran";"15";"Cerdanya";"25913";"Riu de Cerdanya";"1";"1";"U";"89";"35";"63";"85";"4";"1";"0";"84";"84"
"25";"Lleida";"5";"Alt Pirineu i territori d'Aran";"25";"Pallars Jussà";"25190";"Salàs de Pallars";"1";"1";"U";"265";"96";"178";"226";"39";"0";"3";"223";"226"
"25";"Lleida";"5";"Alt Pirineu i territori d'Aran";"25";"Pallars Jussà";"25196";"Sant Esteve de la Sarga";"1";"1";"U";"122";"37";"57";"90";"32";"1";"1";"88";"89"
"25";"Lleida";"5";"Alt Pirineu i territori d'Aran";"25";"Pallars Jussà";"25201";"Sarroca de Bellera";"1";"1";"U";"118";"34";"58";"96";"22";"0";"0";"96";"96"
"25";"Lleida";"5";"Alt Pirineu i territori d'Aran";"25";"Pallars Jussà";"25202";"Senterada";"1";"1";"U";"101";"27";"57";"80";"21";"1";"0";"79";"79"
"25";"Lleida";"5";"Alt Pirineu i territori d'Aran";"4";"Alt Urgell";"25203";"Seu d'Urgell, la";"1";"1";"U";"579";"175";"275";"349";"230";"2";"2";"345";"347"
"25";"Lleida";"5";"Alt Pirineu i territori d'Aran";"4";"Alt Urgell";"25203";"Seu d'Urgell, la";"1";"2";"A";"588";"185";"306";"372";"216";"0";"4";"368";"372"
"25";"Lleida";"5";"Alt Pirineu i territori d'Aran";"4";"Alt Urgell";"25203";"Seu d'Urgell, la";"1";"2";"B";"553";"160";"305";"354";"199";"1";"3";"350";"353"
"25";"Lleida";"5";"Alt Pirineu i territori d'Aran";"4";"Alt Urgell";"25203";"Seu d'Urgell, la";"1";"3";"A";"684";"215";"388";"473";"211";"4";"3";"466";"469"
"25";"Lleida";"5";"Alt Pirineu i territori d'Aran";"4";"Alt Urgell";"25203";"Seu d'Urgell, la";"1";"3";"B";"675";"222";"392";"483";"192";"2";"2";"479";"481"
"25";"Lleida";"5";"Alt Pirineu i territori d'Aran";"4";"Alt Urgell";"25203";"Seu d'Urgell, la";"1";"4";"A";"621";"223";"407";"498";"123";"2";"4";"492";"496"
"25";"Lleida";"5";"Alt Pirineu i territori d'Aran";"4";"Alt Urgell";"25203";"Seu d'Urgell, la";"1";"4";"B";"597";"186";"364";"443";"154";"3";"6";"434";"440"
"25";"Lleida";"5";"Alt Pirineu i territori d'Aran";"4";"Alt Urgell";"25203";"Seu d'Urgell, la";"1";"4";"C";"706";"229";"417";"533";"173";"0";"2";"531";"533"
"25";"Lleida";"5";"Alt Pirineu i territori d'Aran";"4";"Alt Urgell";"25203";"Seu d'Urgell, la";"1";"5";"A";"618";"211";"355";"425";"193";"3";"2";"420";"422"
"25";"Lleida";"5";"Alt Pirineu i territori d'Aran";"4";"Alt Urgell";"25203";"Seu d'Urgell, la";"1";"5";"B";"740";"228";"393";"488";"252";"2";"4";"482";"486"
"25";"Lleida";"5";"Alt Pirineu i territori d'Aran";"4";"Alt Urgell";"25203";"Seu d'Urgell, la";"1";"6";"A";"747";"265";"474";"565";"182";"4";"6";"555";"561"
"25";"Lleida";"5";"Alt Pirineu i territori d'Aran";"4";"Alt Urgell";"25203";"Seu d'Urgell, la";"1";"6";"B";"319";"103";"201";"237";"82";"5";"2";"230";"232"
"25";"Lleida";"5";"Alt Pirineu i territori d'Aran";"4";"Alt Urgell";"25203";"Seu d'Urgell, la";"1";"7";"A";"744";"255";"441";"541";"203";"5";"4";"532";"536"
"25";"Lleida";"5";"Alt Pirineu i territori d'Aran";"4";"Alt Urgell";"25203";"Seu d'Urgell, la";"1";"7";"B";"817";"257";"491";"590";"227";"6";"1";"583";"584"
"25";"Lleida";"5";"Alt Pirineu i territori d'Aran";"26";"Pallars Sobirà";"25208";"Soriguera";"1";"1";"U";"314";"104";"171";"246";"68";"0";"1";"245";"246"
"25";"Lleida";"5";"Alt Pirineu i territori d'Aran";"26";"Pallars Sobirà";"25209";"Sort";"1";"1";"A";"699";"231";"409";"556";"143";"0";"5";"551";"556"
"25";"Lleida";"5";"Alt Pirineu i territori d'Aran";"26";"Pallars Sobirà";"25209";"Sort";"1";"1";"B";"824";"270";"521";"669";"155";"3";"4";"662";"666"
"25";"Lleida";"5";"Alt Pirineu i territori d'Aran";"25";"Pallars Jussà";"25215";"Talarn";"1";"1";"U";"325";"121";"193";"241";"84";"1";"0";"240";"240"
"25";"Lleida";"5";"Alt Pirineu i territori d'Aran";"25";"Pallars Jussà";"25227";"Torre de Cabdella, la";"1";"1";"U";"644";"221";"378";"540";"104";"1";"3";"536";"539"
"25";"Lleida";"5";"Alt Pirineu i territori d'Aran";"25";"Pallars Jussà";"25234";"Tremp";"1";"1";"U";"651";"175";"351";"438";"213";"2";"1";"435";"436"
"25";"Lleida";"5";"Alt Pirineu i territori d'Aran";"25";"Pallars Jussà";"25234";"Tremp";"1";"2";"U";"822";"295";"507";"619";"203";"4";"7";"608";"615"
"25";"Lleida";"5";"Alt Pirineu i territori d'Aran";"25";"Pallars Jussà";"25234";"Tremp";"2";"1";"A";"552";"183";"357";"421";"131";"1";"2";"418";"420"
"25";"Lleida";"5";"Alt Pirineu i territori d'Aran";"25";"Pallars Jussà";"25234";"Tremp";"2";"1";"B";"627";"203";"372";"470";"157";"4";"4";"462";"466"
"25";"Lleida";"5";"Alt Pirineu i territori d'Aran";"25";"Pallars Jussà";"25234";"Tremp";"2";"2";"A";"582";"189";"361";"451";"131";"2";"2";"447";"449"
"25";"Lleida";"5";"Alt Pirineu i territori d'Aran";"25";"Pallars Jussà";"25234";"Tremp";"2";"2";"B";"564";"176";"335";"436";"128";"3";"4";"429";"433"
"25";"Lleida";"5";"Alt Pirineu i territori d'Aran";"25";"Pallars Jussà";"25234";"Tremp";"3";"1";"U";"497";"107";"256";"341";"156";"0";"1";"340";"341"
"25";"Lleida";"5";"Alt Pirineu i territori d'Aran";"26";"Pallars Sobirà";"25221";"Tírvia";"1";"1";"U";"131";"32";"71";"97";"34";"0";"0";"97";"97"
"25";"Lleida";"5";"Alt Pirineu i territori d'Aran";"5";"Alta Ribagorça";"25043";"Vall de Boí, la";"1";"1";"U";"791";"301";"474";"636";"155";"2";"1";"633";"634"
"25";"Lleida";"5";"Alt Pirineu i territori d'Aran";"26";"Pallars Sobirà";"25901";"Vall de Cardós";"1";"1";"U";"291";"86";"175";"246";"45";"1";"3";"242";"245"
"25";"Lleida";"5";"Alt Pirineu i territori d'Aran";"4";"Alt Urgell";"25906";"Valls d'Aguilar, les";"1";"1";"U";"226";"61";"122";"171";"55";"2";"0";"169";"169"
"25";"Lleida";"5";"Alt Pirineu i territori d'Aran";"4";"Alt Urgell";"25239";"Valls de Valira, les";"1";"1";"U";"613";"147";"293";"379";"234";"2";"4";"373";"377"
"25";"Lleida";"5";"Alt Pirineu i territori d'Aran";"4";"Alt Urgell";"25909";"Vansa i Fórnols, la";"1";"1";"U";"158";"49";"90";"130";"28";"0";"0";"130";"130"
"25";"Lleida";"5";"Alt Pirineu i territori d'Aran";"39";"Consell General d'Aran";"25243";"Vielha e Mijaran";"1";"1";"A";"550";"151";"288";"373";"177";"1";"2";"370";"372"
"25";"Lleida";"5";"Alt Pirineu i territori d'Aran";"39";"Consell General d'Aran";"25243";"Vielha e Mijaran";"1";"1";"B";"596";"175";"316";"415";"181";"1";"4";"410";"414"
"25";"Lleida";"5";"Alt Pirineu i territori d'Aran";"39";"Consell General d'Aran";"25243";"Vielha e Mijaran";"1";"2";"A";"517";"132";"288";"393";"124";"1";"2";"390";"392"
"25";"Lleida";"5";"Alt Pirineu i territori d'Aran";"39";"Consell General d'Aran";"25243";"Vielha e Mijaran";"1";"2";"B";"435";"118";"228";"299";"136";"1";"3";"295";"298"
"25";"Lleida";"5";"Alt Pirineu i territori d'Aran";"39";"Consell General d'Aran";"25243";"Vielha e Mijaran";"1";"2";"C";"427";"104";"222";"302";"125";"1";"2";"299";"301"
"25";"Lleida";"5";"Alt Pirineu i territori d'Aran";"39";"Consell General d'Aran";"25243";"Vielha e Mijaran";"1";"3";"A";"592";"154";"279";"408";"184";"2";"3";"403";"406"
"25";"Lleida";"5";"Alt Pirineu i territori d'Aran";"39";"Consell General d'Aran";"25243";"Vielha e Mijaran";"1";"3";"B";"501";"138";"252";"356";"145";"1";"5";"350";"355"
"25";"Lleida";"5";"Alt Pirineu i territori d'Aran";"5";"Alta Ribagorça";"25245";"Vilaller";"1";"1";"U";"443";"151";"246";"345";"98";"1";"3";"341";"344"
"25";"Lleida";"5";"Alt Pirineu i territori d'Aran";"39";"Consell General d'Aran";"25247";"Vilamòs";"1";"1";"U";"126";"36";"57";"92";"34";"1";"0";"91";"91"
"25";"Lleida";"2";"Catalunya Central";"35";"Solsonès";"25064";"Castellar de la Ribera";"1";"1";"U";"116";"37";"71";"106";"10";"0";"1";"105";"106"
"25";"Lleida";"2";"Catalunya Central";"35";"Solsonès";"25075";"Clariana de Cardener";"1";"1";"U";"117";"45";"64";"102";"15";"0";"0";"102";"102"
"25";"Lleida";"2";"Catalunya Central";"35";"Solsonès";"25163";"Coma i la Pedra, la";"1";"1";"U";"230";"82";"148";"182";"48";"1";"0";"181";"181"
"25";"Lleida";"2";"Catalunya Central";"35";"Solsonès";"25111";"Guixers";"1";"1";"U";"115";"54";"86";"100";"15";"0";"1";"99";"100"
"25";"Lleida";"2";"Catalunya Central";"14";"Berguedà";"25100";"Gósol";"1";"1";"U";"209";"85";"144";"182";"27";"1";"0";"181";"181"
"25";"Lleida";"2";"Catalunya Central";"35";"Solsonès";"25124";"Lladurs";"1";"1";"U";"168";"57";"95";"136";"32";"0";"1";"135";"136"
"25";"Lleida";"2";"Catalunya Central";"35";"Solsonès";"25129";"Llobera";"1";"1";"U";"174";"68";"124";"148";"26";"2";"1";"145";"146"
"25";"Lleida";"2";"Catalunya Central";"35";"Solsonès";"25136";"Molsosa, la";"1";"1";"U";"100";"35";"62";"81";"19";"0";"0";"81";"81"
"25";"Lleida";"2";"Catalunya Central";"35";"Solsonès";"25146";"Navès";"1";"1";"U";"225";"95";"155";"190";"35";"0";"1";"189";"190"
"25";"Lleida";"2";"Catalunya Central";"35";"Solsonès";"25148";"Odèn";"1";"1";"U";"218";"87";"118";"177";"41";"1";"2";"174";"176"
"25";"Lleida";"2";"Catalunya Central";"35";"Solsonès";"25151";"Olius";"1";"1";"U";"671";"274";"488";"588";"83";"3";"5";"580";"585"
"25";"Lleida";"2";"Catalunya Central";"35";"Solsonès";"25166";"Pinell de Solsonès";"1";"1";"U";"176";"57";"100";"146";"30";"0";"1";"145";"146"
"25";"Lleida";"2";"Catalunya Central";"35";"Solsonès";"25167";"Pinós";"1";"1";"U";"234";"87";"159";"198";"36";"2";"3";"193";"196"
"25";"Lleida";"2";"Catalunya Central";"35";"Solsonès";"25186";"Riner";"1";"1";"U";"215";"56";"133";"181";"34";"0";"1";"180";"181"
"25";"Lleida";"2";"Catalunya Central";"35";"Solsonès";"25193";"Sant Llorenç de Morunys";"1";"1";"U";"766";"343";"545";"635";"131";"6";"2";"627";"629"
"25";"Lleida";"2";"Catalunya Central";"35";"Solsonès";"25207";"Solsona";"1";"1";"A";"696";"252";"463";"557";"139";"1";"9";"547";"556"
"25";"Lleida";"2";"Catalunya Central";"35";"Solsonès";"25207";"Solsona";"1";"1";"B";"794";"280";"532";"637";"157";"5";"10";"622";"632"
"25";"Lleida";"2";"Catalunya Central";"35";"Solsonès";"25207";"Solsona";"1";"2";"A";"646";"216";"390";"473";"173";"3";"2";"468";"470"
"25";"Lleida";"2";"Catalunya Central";"35";"Solsonès";"25207";"Solsona";"1";"2";"B";"746";"237";"458";"563";"183";"3";"4";"556";"560"
"25";"Lleida";"2";"Catalunya Central";"35";"Solsonès";"25207";"Solsona";"1";"3";"U";"960";"353";"611";"740";"220";"5";"5";"730";"735"
"25";"Lleida";"2";"Catalunya Central";"35";"Solsonès";"25207";"Solsona";"2";"1";"A";"590";"249";"372";"454";"136";"2";"5";"447";"452"
"25";"Lleida";"2";"Catalunya Central";"35";"Solsonès";"25207";"Solsona";"2";"1";"B";"685";"204";"486";"554";"131";"3";"7";"544";"551"
"25";"Lleida";"2";"Catalunya Central";"35";"Solsonès";"25207";"Solsona";"2";"2";"A";"484";"232";"311";"376";"108";"3";"1";"372";"373"
"25";"Lleida";"2";"Catalunya Central";"35";"Solsonès";"25207";"Solsona";"2";"2";"B";"618";"216";"410";"487";"131";"3";"1";"483";"484"
"25";"Lleida";"4";"Lleida";"38";"Urgell";"25003";"Agramunt";"1";"1";"U";"566";"202";"345";"433";"133";"1";"2";"430";"432"
"25";"Lleida";"4";"Lleida";"38";"Urgell";"25003";"Agramunt";"1";"2";"U";"697";"251";"431";"518";"179";"3";"0";"515";"515"
"25";"Lleida";"4";"Lleida";"38";"Urgell";"25003";"Agramunt";"1";"3";"A";"631";"220";"391";"479";"152";"2";"7";"470";"477"
"25";"Lleida";"4";"Lleida";"38";"Urgell";"25003";"Agramunt";"1";"3";"B";"714";"246";"440";"563";"151";"3";"5";"555";"560"
"25";"Lleida";"4";"Lleida";"38";"Urgell";"25003";"Agramunt";"1";"4";"A";"563";"201";"347";"451";"112";"1";"6";"444";"450"
"25";"Lleida";"4";"Lleida";"38";"Urgell";"25003";"Agramunt";"1";"4";"B";"607";"201";"385";"486";"121";"2";"4";"480";"484"
"25";"Lleida";"4";"Lleida";"33";"Segrià";"25038";"Aitona";"1";"1";"U";"778";"301";"500";"606";"172";"1";"4";"601";"605"
"25";"Lleida";"4";"Lleida";"33";"Segrià";"25038";"Aitona";"1";"2";"U";"777";"292";"481";"621";"156";"7";"1";"613";"614"
"25";"Lleida";"4";"Lleida";"33";"Segrià";"25004";"Alamús, els";"1";"1";"U";"576";"219";"407";"482";"94";"4";"2";"476";"478"
"25";"Lleida";"4";"Lleida";"18";"Garrigues";"25006";"Albagés, l'";"1";"1";"U";"344";"132";"237";"274";"70";"2";"1";"271";"272"
"25";"Lleida";"4";"Lleida";"33";"Segrià";"25007";"Albatàrrec";"1";"1";"A";"721";"231";"459";"581";"140";"4";"1";"576";"577"
"25";"Lleida";"4";"Lleida";"33";"Segrià";"25007";"Albatàrrec";"1";"1";"B";"691";"200";"410";"547";"144";"1";"3";"543";"546"
"25";"Lleida";"4";"Lleida";"23";"Noguera";"25008";"Albesa";"1";"1";"A";"589";"196";"394";"499";"90";"0";"2";"497";"499"
"25";"Lleida";"4";"Lleida";"23";"Noguera";"25008";"Albesa";"1";"1";"B";"549";"167";"349";"469";"80";"2";"7";"460";"467"
"25";"Lleida";"4";"Lleida";"18";"Garrigues";"25009";"Albi, l'";"1";"1";"U";"630";"228";"449";"534";"96";"4";"2";"528";"530"
"25";"Lleida";"4";"Lleida";"33";"Segrià";"25010";"Alcanó";"1";"1";"U";"211";"50";"119";"162";"49";"0";"3";"159";"162"
"25";"Lleida";"4";"Lleida";"33";"Segrià";"25011";"Alcarràs";"1";"1";"A";"801";"254";"501";"639";"162";"5";"2";"632";"634"
"25";"Lleida";"4";"Lleida";"33";"Segrià";"25011";"Alcarràs";"1";"1";"B";"749";"260";"442";"564";"185";"6";"5";"553";"558"
"25";"Lleida";"4";"Lleida";"33";"Segrià";"25011";"Alcarràs";"1";"2";"A";"719";"220";"366";"487";"232";"1";"4";"482";"486"
"25";"Lleida";"4";"Lleida";"33";"Segrià";"25011";"Alcarràs";"1";"2";"B";"717";"230";"385";"507";"210";"5";"4";"498";"502"
"25";"Lleida";"4";"Lleida";"33";"Segrià";"25011";"Alcarràs";"1";"3";"U";"927";"310";"509";"679";"248";"0";"2";"677";"679"
"25";"Lleida";"4";"Lleida";"33";"Segrià";"25011";"Alcarràs";"1";"4";"A";"708";"250";"418";"517";"191";"0";"2";"515";"517"
"25";"Lleida";"4";"Lleida";"33";"Segrià";"25011";"Alcarràs";"1";"4";"B";"633";"218";"368";"474";"159";"1";"6";"467";"473"
"25";"Lleida";"4";"Lleida";"33";"Segrià";"25012";"Alcoletge";"1";"1";"A";"687";"240";"441";"538";"149";"2";"5";"531";"536"
"25";"Lleida";"4";"Lleida";"33";"Segrià";"25012";"Alcoletge";"1";"1";"B";"621";"220";"397";"496";"125";"8";"1";"487";"488"
"25";"Lleida";"4";"Lleida";"33";"Segrià";"25012";"Alcoletge";"1";"2";"U";"976";"320";"497";"643";"333";"3";"1";"639";"640"
"25";"Lleida";"4";"Lleida";"33";"Segrià";"25013";"Alfarràs";"1";"1";"A";"568";"178";"304";"417";"151";"3";"4";"410";"414"
"25";"Lleida";"4";"Lleida";"33";"Segrià";"25013";"Alfarràs";"1";"1";"B";"634";"203";"329";"458";"176";"5";"4";"449";"453"
"25";"Lleida";"4";"Lleida";"33";"Segrià";"25013";"Alfarràs";"1";"2";"U";"972";"300";"513";"680";"292";"3";"8";"669";"677"
"25";"Lleida";"4";"Lleida";"33";"Segrià";"25014";"Alfés";"1";"1";"U";"254";"107";"170";"216";"38";"1";"3";"212";"215"
"25";"Lleida";"4";"Lleida";"23";"Noguera";"25015";"Algerri";"1";"1";"U";"353";"173";"251";"290";"63";"0";"1";"289";"290"
"25";"Lleida";"4";"Lleida";"33";"Segrià";"25016";"Alguaire";"1";"1";"U";"1012";"328";"629";"764";"248";"7";"3";"754";"757"
"25";"Lleida";"4";"Lleida";"33";"Segrià";"25016";"Alguaire";"1";"2";"A";"628";"195";"364";"482";"146";"1";"4";"477";"481"
"25";"Lleida";"4";"Lleida";"33";"Segrià";"25016";"Alguaire";"1";"2";"B";"471";"135";"284";"361";"110";"3";"3";"355";"358"
"25";"Lleida";"4";"Lleida";"33";"Segrià";"25019";"Almacelles";"1";"1";"U";"797";"225";"439";"581";"216";"0";"5";"576";"581"
"25";"Lleida";"4";"Lleida";"33";"Segrià";"25019";"Almacelles";"1";"2";"A";"620";"172";"310";"446";"174";"5";"2";"439";"441"
"25";"Lleida";"4";"Lleida";"33";"Segrià";"25019";"Almacelles";"1";"2";"B";"757";"182";"394";"572";"185";"5";"2";"565";"567"
"25";"Lleida";"4";"Lleida";"33";"Segrià";"25019";"Almacelles";"2";"1";"U";"949";"264";"491";"678";"271";"6";"5";"667";"672"
"25";"Lleida";"4";"Lleida";"33";"Segrià";"25019";"Almacelles";"2";"2";"A";"666";"170";"345";"467";"199";"0";"4";"463";"467"
"25";"Lleida";"4";"Lleida";"33";"Segrià";"25019";"Almacelles";"2";"2";"B";"772";"206";"380";"520";"252";"2";"3";"515";"518"
"25";"Lleida";"4";"Lleida";"33";"Segrià";"25020";"Almatret";"1";"1";"U";"294";"105";"207";"241";"53";"3";"1";"237";"238"
"25";"Lleida";"4";"Lleida";"33";"Segrià";"25021";"Almenar";"1";"1";"U";"608";"164";"300";"384";"224";"0";"6";"378";"384"
"25";"Lleida";"4";"Lleida";"33";"Segrià";"25021";"Almenar";"2";"1";"A";"523";"164";"282";"390";"133";"1";"5";"384";"389"
"25";"Lleida";"4";"Lleida";"33";"Segrià";"25021";"Almenar";"2";"1";"B";"545";"152";"289";"393";"152";"1";"5";"387";"392"
"25";"Lleida";"4";"Lleida";"33";"Segrià";"25021";"Almenar";"2";"2";"U";"945";"294";"542";"721";"224";"3";"5";"713";"718"
"25";"Lleida";"4";"Lleida";"33";"Segrià";"25023";"Alpicat";"1";"1";"A";"674";"258";"433";"537";"137";"0";"2";"535";"537"
"25";"Lleida";"4";"Lleida";"33";"Segrià";"25023";"Alpicat";"1";"1";"B";"835";"301";"509";"651";"184";"2";"6";"643";"649"
"25";"Lleida";"4";"Lleida";"33";"Segrià";"25023";"Alpicat";"1";"2";"A";"853";"267";"503";"683";"170";"4";"10";"669";"679"
"25";"Lleida";"4";"Lleida";"33";"Segrià";"25023";"Alpicat";"1";"2";"B";"947";"252";"571";"761";"186";"5";"6";"750";"756"
"25";"Lleida";"4";"Lleida";"33";"Segrià";"25023";"Alpicat";"1";"3";"A";"568";"200";"355";"468";"100";"1";"2";"465";"467"
"25";"Lleida";"4";"Lleida";"33";"Segrià";"25023";"Alpicat";"1";"3";"B";"661";"228";"334";"556";"105";"2";"1";"553";"554"
"25";"Lleida";"4";"Lleida";"23";"Noguera";"25022";"Alòs de Balaguer";"1";"1";"U";"107";"47";"75";"93";"14";"0";"0";"93";"93"
"25";"Lleida";"4";"Lleida";"38";"Urgell";"25027";"Anglesola";"1";"1";"U";"1011";"370";"701";"841";"170";"4";"1";"836";"837"
"25";"Lleida";"4";"Lleida";"18";"Garrigues";"25029";"Arbeca";"1";"1";"U";"797";"270";"519";"646";"151";"2";"3";"641";"644"
"25";"Lleida";"4";"Lleida";"18";"Garrigues";"25029";"Arbeca";"1";"2";"U";"871";"304";"592";"732";"139";"3";"1";"728";"729"
"25";"Lleida";"4";"Lleida";"33";"Segrià";"25033";"Artesa de Lleida";"1";"1";"A";"550";"216";"380";"470";"80";"4";"4";"462";"466"
"25";"Lleida";"4";"Lleida";"33";"Segrià";"25033";"Artesa de Lleida";"1";"1";"B";"553";"188";"349";"453";"100";"5";"1";"447";"448"
"25";"Lleida";"4";"Lleida";"23";"Noguera";"25034";"Artesa de Segre";"1";"1";"A";"612";"185";"381";"500";"112";"1";"6";"493";"499"
"25";"Lleida";"4";"Lleida";"23";"Noguera";"25034";"Artesa de Segre";"1";"1";"B";"701";"227";"457";"575";"126";"1";"7";"567";"574"
"25";"Lleida";"4";"Lleida";"23";"Noguera";"25034";"Artesa de Segre";"1";"2";"U";"1031";"274";"568";"765";"266";"3";"4";"758";"762"
"25";"Lleida";"4";"Lleida";"33";"Segrià";"25036";"Aspa";"1";"1";"U";"185";"66";"126";"152";"33";"1";"3";"148";"151"
"25";"Lleida";"4";"Lleida";"23";"Noguera";"25037";"Avellanes i Santa Linya, les";"1";"1";"U";"391";"134";"236";"320";"71";"2";"2";"316";"318"
"25";"Lleida";"4";"Lleida";"23";"Noguera";"25040";"Balaguer";"1";"1";"U";"735";"238";"417";"488";"247";"3";"4";"481";"485"
"25";"Lleida";"4";"Lleida";"23";"Noguera";"25040";"Balaguer";"1";"2";"U";"914";"268";"503";"643";"271";"6";"3";"634";"637"
"25";"Lleida";"4";"Lleida";"23";"Noguera";"25040";"Balaguer";"2";"1";"A";"601";"108";"197";"262";"339";"4";"6";"252";"258"
"25";"Lleida";"4";"Lleida";"23";"Noguera";"25040";"Balaguer";"2";"1";"B";"259";"85";"153";"182";"77";"0";"0";"182";"182"
"25";"Lleida";"4";"Lleida";"23";"Noguera";"25040";"Balaguer";"3";"1";"A";"1000";"337";"560";"723";"277";"2";"5";"716";"721"
"25";"Lleida";"4";"Lleida";"23";"Noguera";"25040";"Balaguer";"3";"1";"B";"1004";"291";"590";"759";"245";"5";"14";"740";"754"
"25";"Lleida";"4";"Lleida";"23";"Noguera";"25040";"Balaguer";"3";"2";"U";"834";"299";"487";"605";"229";"4";"4";"597";"601"
"25";"Lleida";"4";"Lleida";"23";"Noguera";"25040";"Balaguer";"4";"1";"A";"578";"233";"350";"454";"124";"4";"4";"446";"450"
"25";"Lleida";"4";"Lleida";"23";"Noguera";"25040";"Balaguer";"4";"1";"B";"626";"220";"410";"516";"110";"2";"3";"511";"514"
"25";"Lleida";"4";"Lleida";"23";"Noguera";"25040";"Balaguer";"4";"2";"A";"529";"195";"337";"408";"121";"0";"4";"404";"408"
"25";"Lleida";"4";"Lleida";"23";"Noguera";"25040";"Balaguer";"4";"2";"B";"630";"250";"385";"476";"154";"2";"3";"471";"474"
"25";"Lleida";"4";"Lleida";"23";"Noguera";"25040";"Balaguer";"4";"3";"A";"561";"203";"352";"447";"114";"3";"5";"439";"444"
"25";"Lleida";"4";"Lleida";"23";"Noguera";"25040";"Balaguer";"4";"3";"B";"641";"221";"422";"521";"120";"1";"8";"512";"520"
"25";"Lleida";"4";"Lleida";"23";"Noguera";"25040";"Balaguer";"4";"4";"A";"725";"240";"458";"586";"139";"1";"8";"577";"585"
"25";"Lleida";"4";"Lleida";"23";"Noguera";"25040";"Balaguer";"4";"4";"B";"888";"283";"591";"733";"155";"4";"2";"727";"729"
"25";"Lleida";"4";"Lleida";"27";"Pla d'Urgell";"25041";"Barbens";"1";"1";"U";"573";"196";"389";"452";"121";"6";"5";"441";"446"
"25";"Lleida";"4";"Lleida";"23";"Noguera";"25042";"Baronia de Rialb, la";"1";"1";"U";"210";"79";"137";"173";"37";"1";"1";"171";"172"
"25";"Lleida";"4";"Lleida";"38";"Urgell";"25046";"Belianes";"1";"1";"U";"429";"160";"304";"352";"77";"2";"0";"350";"350"
"25";"Lleida";"4";"Lleida";"27";"Pla d'Urgell";"25048";"Bell-lloc d'Urgell";"1";"1";"U";"777";"253";"501";"613";"164";"7";"3";"603";"606"
"25";"Lleida";"4";"Lleida";"27";"Pla d'Urgell";"25048";"Bell-lloc d'Urgell";"1";"2";"U";"873";"278";"552";"692";"181";"6";"6";"680";"686"
"25";"Lleida";"4";"Lleida";"18";"Garrigues";"25170";"Bellaguarda";"1";"1";"U";"262";"65";"152";"220";"42";"1";"1";"218";"219"
"25";"Lleida";"4";"Lleida";"23";"Noguera";"25047";"Bellcaire d'Urgell";"1";"1";"U";"1012";"340";"712";"865";"147";"2";"15";"848";"863"
"25";"Lleida";"4";"Lleida";"23";"Noguera";"25049";"Bellmunt d'Urgell";"1";"1";"U";"152";"63";"108";"129";"23";"5";"0";"124";"124"
"25";"Lleida";"4";"Lleida";"38";"Urgell";"25050";"Bellpuig";"1";"1";"A";"741";"239";"437";"555";"186";"5";"10";"540";"550"
"25";"Lleida";"4";"Lleida";"38";"Urgell";"25050";"Bellpuig";"1";"1";"B";"709";"221";"406";"507";"202";"3";"3";"501";"504"
"25";"Lleida";"4";"Lleida";"38";"Urgell";"25050";"Bellpuig";"1";"2";"U";"1035";"352";"678";"823";"212";"4";"4";"815";"819"
"25";"Lleida";"4";"Lleida";"38";"Urgell";"25050";"Bellpuig";"1";"3";"U";"778";"294";"484";"599";"179";"2";"6";"591";"597"
"25";"Lleida";"4";"Lleida";"27";"Pla d'Urgell";"25052";"Bellvís";"1";"1";"A";"833";"327";"557";"694";"139";"5";"3";"686";"689"
"25";"Lleida";"4";"Lleida";"27";"Pla d'Urgell";"25052";"Bellvís";"1";"1";"B";"736";"318";"530";"635";"101";"1";"6";"628";"634"
"25";"Lleida";"4";"Lleida";"33";"Segrià";"25053";"Benavent de Segrià";"1";"1";"A";"552";"195";"358";"444";"108";"3";"2";"439";"441"
"25";"Lleida";"4";"Lleida";"33";"Segrià";"25053";"Benavent de Segrià";"1";"1";"B";"512";"200";"342";"427";"85";"2";"1";"424";"425"
"25";"Lleida";"4";"Lleida";"32";"Segarra";"25055";"Biosca";"1";"1";"U";"174";"68";"106";"134";"40";"1";"1";"132";"133"
"25";"Lleida";"4";"Lleida";"18";"Garrigues";"25058";"Borges Blanques, les";"1";"1";"U";"698";"216";"383";"506";"192";"1";"5";"500";"505"
"25";"Lleida";"4";"Lleida";"18";"Garrigues";"25058";"Borges Blanques, les";"1";"2";"A";"498";"139";"282";"390";"108";"2";"1";"387";"388"
"25";"Lleida";"4";"Lleida";"18";"Garrigues";"25058";"Borges Blanques, les";"1";"2";"B";"587";"203";"369";"488";"99";"1";"6";"481";"487"
"25";"Lleida";"4";"Lleida";"18";"Garrigues";"25058";"Borges Blanques, les";"2";"1";"A";"679";"238";"419";"555";"124";"1";"0";"554";"554"
"25";"Lleida";"4";"Lleida";"18";"Garrigues";"25058";"Borges Blanques, les";"2";"1";"B";"807";"228";"504";"653";"154";"2";"3";"648";"651"
"25";"Lleida";"4";"Lleida";"18";"Garrigues";"25058";"Borges Blanques, les";"2";"2";"A";"498";"184";"298";"370";"128";"0";"3";"367";"370"
"25";"Lleida";"4";"Lleida";"18";"Garrigues";"25058";"Borges Blanques, les";"2";"2";"B";"616";"199";"352";"441";"175";"1";"3";"437";"440"
"25";"Lleida";"4";"Lleida";"18";"Garrigues";"25056";"Bovera";"1";"1";"U";"243";"75";"156";"194";"49";"0";"5";"189";"194"
"25";"Lleida";"4";"Lleida";"23";"Noguera";"25060";"Cabanabona";"1";"1";"U";"70";"25";"31";"52";"18";"0";"2";"50";"52"
"25";"Lleida";"4";"Lleida";"23";"Noguera";"25062";"Camarasa";"1";"1";"U";"761";"344";"525";"631";"130";"2";"4";"625";"629"
"25";"Lleida";"4";"Lleida";"18";"Garrigues";"25067";"Castelldans";"1";"1";"U";"731";"255";"488";"581";"150";"1";"7";"573";"580"
"25";"Lleida";"4";"Lleida";"27";"Pla d'Urgell";"25068";"Castellnou de Seana";"1";"1";"U";"554";"222";"420";"460";"94";"3";"1";"456";"457"
"25";"Lleida";"4";"Lleida";"38";"Urgell";"25070";"Castellserà";"1";"1";"U";"818";"370";"601";"687";"131";"1";"4";"682";"686"
"25";"Lleida";"4";"Lleida";"23";"Noguera";"25069";"Castelló de Farfanya";"1";"1";"U";"449";"127";"275";"345";"104";"1";"4";"340";"344"
"25";"Lleida";"4";"Lleida";"32";"Segarra";"25072";"Cervera";"1";"1";"U";"838";"289";"481";"588";"250";"2";"3";"583";"586"
"25";"Lleida";"4";"Lleida";"32";"Segarra";"25072";"Cervera";"2";"1";"A";"571";"155";"330";"401";"170";"1";"0";"400";"400"
"25";"Lleida";"4";"Lleida";"32";"Segarra";"25072";"Cervera";"2";"1";"B";"500";"155";"301";"441";"59";"0";"4";"437";"441"
"25";"Lleida";"4";"Lleida";"32";"Segarra";"25072";"Cervera";"2";"2";"A";"680";"194";"386";"489";"191";"3";"6";"480";"486"
"25";"Lleida";"4";"Lleida";"32";"Segarra";"25072";"Cervera";"2";"2";"B";"677";"206";"399";"497";"180";"6";"3";"488";"491"
"25";"Lleida";"4";"Lleida";"32";"Segarra";"25072";"Cervera";"2";"3";"U";"890";"260";"559";"736";"154";"7";"1";"728";"729"
"25";"Lleida";"4";"Lleida";"32";"Segarra";"25072";"Cervera";"3";"1";"A";"792";"244";"438";"571";"221";"0";"8";"563";"571"
"25";"Lleida";"4";"Lleida";"32";"Segarra";"25072";"Cervera";"3";"1";"B";"917";"296";"647";"688";"229";"3";"6";"679";"685"
"25";"Lleida";"4";"Lleida";"18";"Garrigues";"25073";"Cervià de les Garrigues";"1";"1";"U";"588";"238";"422";"450";"138";"2";"4";"444";"448"
"25";"Lleida";"4";"Lleida";"38";"Urgell";"25074";"Ciutadilla";"1";"1";"U";"179";"70";"124";"156";"23";"5";"0";"151";"151"
"25";"Lleida";"4";"Lleida";"18";"Garrigues";"25076";"Cogul, el";"1";"1";"U";"147";"58";"95";"111";"36";"0";"1";"110";"111"
"25";"Lleida";"4";"Lleida";"33";"Segrià";"25078";"Corbins";"1";"1";"U";"1003";"295";"752";"840";"163";"3";"13";"824";"837"
"25";"Lleida";"4";"Lleida";"23";"Noguera";"25079";"Cubells";"1";"1";"U";"306";"120";"207";"254";"52";"2";"2";"250";"252"
"25";"Lleida";"4";"Lleida";"18";"Garrigues";"25081";"Espluga Calba, l'";"1";"1";"U";"319";"160";"242";"265";"54";"2";"0";"263";"263"
"25";"Lleida";"4";"Lleida";"32";"Segarra";"25085";"Estaràs";"1";"1";"U";"151";"52";"104";"127";"24";"1";"0";"126";"126"
"25";"Lleida";"4";"Lleida";"18";"Garrigues";"25092";"Floresta, la";"1";"1";"U";"132";"54";"82";"104";"28";"1";"0";"103";"103"
"25";"Lleida";"4";"Lleida";"27";"Pla d'Urgell";"25093";"Fondarella";"1";"1";"U";"637";"245";"439";"522";"115";"2";"11";"509";"520"
"25";"Lleida";"4";"Lleida";"23";"Noguera";"25094";"Foradada";"1";"1";"U";"137";"52";"95";"122";"15";"0";"1";"121";"122"
"25";"Lleida";"4";"Lleida";"38";"Urgell";"25096";"Fuliola, la";"1";"1";"U";"915";"403";"600";"713";"202";"3";"3";"707";"710"
"25";"Lleida";"4";"Lleida";"18";"Garrigues";"25097";"Fulleda";"1";"1";"U";"85";"43";"61";"77";"8";"0";"2";"75";"77"
"25";"Lleida";"4";"Lleida";"33";"Segrià";"25912";"Gimenells i el Pla de la Font";"1";"1";"A";"611";"212";"367";"474";"137";"4";"3";"467";"470"
"25";"Lleida";"4";"Lleida";"33";"Segrià";"25912";"Gimenells i el Pla de la Font";"1";"1";"B";"263";"67";"148";"199";"64";"3";"0";"196";"196"
"25";"Lleida";"4";"Lleida";"27";"Pla d'Urgell";"25099";"Golmés";"1";"1";"A";"635";"246";"408";"492";"143";"3";"1";"488";"489"
"25";"Lleida";"4";"Lleida";"27";"Pla d'Urgell";"25099";"Golmés";"1";"1";"B";"621";"240";"444";"510";"111";"4";"4";"502";"506"
"25";"Lleida";"4";"Lleida";"18";"Garrigues";"25101";"Granadella, la";"1";"1";"U";"563";"220";"400";"487";"76";"6";"2";"479";"481"
"25";"Lleida";"4";"Lleida";"33";"Segrià";"25102";"Granja d'Escarp, la";"1";"1";"U";"714";"269";"462";"576";"138";"3";"4";"569";"573"
"25";"Lleida";"4";"Lleida";"32";"Segarra";"25103";"Granyanella";"1";"1";"U";"131";"35";"70";"94";"37";"0";"1";"93";"94"
"25";"Lleida";"4";"Lleida";"32";"Segarra";"25104";"Granyena de Segarra";"1";"1";"U";"128";"45";"84";"100";"28";"0";"0";"100";"100"
"25";"Lleida";"4";"Lleida";"18";"Garrigues";"25105";"Granyena de les Garrigues";"1";"1";"U";"132";"57";"94";"110";"22";"3";"0";"107";"107"
"25";"Lleida";"4";"Lleida";"38";"Urgell";"25109";"Guimerà";"1";"1";"U";"237";"90";"156";"196";"41";"0";"0";"196";"196"
"25";"Lleida";"4";"Lleida";"32";"Segarra";"25110";"Guissona";"1";"1";"U";"696";"217";"465";"548";"148";"8";"2";"538";"540"
"25";"Lleida";"4";"Lleida";"32";"Segarra";"25110";"Guissona";"1";"2";"A";"596";"200";"443";"464";"132";"4";"5";"455";"460"
"25";"Lleida";"4";"Lleida";"32";"Segarra";"25110";"Guissona";"1";"2";"B";"616";"207";"409";"508";"108";"4";"4";"500";"504"
"25";"Lleida";"4";"Lleida";"32";"Segarra";"25110";"Guissona";"1";"3";"U";"890";"263";"567";"678";"212";"6";"0";"672";"672"
"25";"Lleida";"4";"Lleida";"27";"Pla d'Urgell";"25113";"Ivars d'Urgell";"1";"1";"U";"520";"183";"365";"439";"81";"3";"2";"434";"436"
"25";"Lleida";"4";"Lleida";"27";"Pla d'Urgell";"25113";"Ivars d'Urgell";"1";"2";"U";"646";"260";"434";"538";"108";"2";"1";"535";"536"
"25";"Lleida";"4";"Lleida";"23";"Noguera";"25112";"Ivars de Noguera";"1";"1";"U";"275";"117";"210";"236";"39";"0";"1";"235";"236"
"25";"Lleida";"4";"Lleida";"32";"Segarra";"25114";"Ivorra";"1";"1";"U";"95";"44";"81";"92";"3";"0";"0";"92";"92"
"25";"Lleida";"4";"Lleida";"18";"Garrigues";"25118";"Juncosa";"1";"1";"U";"353";"141";"237";"283";"70";"0";"3";"280";"283"
"25";"Lleida";"4";"Lleida";"18";"Garrigues";"25119";"Juneda";"1";"1";"A";"616";"216";"391";"493";"123";"8";"5";"480";"485"
"25";"Lleida";"4";"Lleida";"18";"Garrigues";"25119";"Juneda";"1";"1";"B";"638";"220";"400";"520";"118";"5";"10";"505";"515"
"25";"Lleida";"4";"Lleida";"18";"Garrigues";"25119";"Juneda";"1";"2";"U";"1001";"370";"695";"859";"142";"1";"8";"850";"858"
"25";"Lleida";"4";"Lleida";"27";"Pla d'Urgell";"25122";"Linyola";"1";"1";"U";"879";"324";"607";"717";"162";"7";"7";"703";"710"
"25";"Lleida";"4";"Lleida";"27";"Pla d'Urgell";"25122";"Linyola";"1";"2";"U";"1038";"378";"721";"886";"152";"5";"7";"874";"881"
"25";"Lleida";"4";"Lleida";"33";"Segrià";"25125";"Llardecans";"1";"1";"U";"427";"172";"305";"351";"76";"3";"8";"340";"348"
"25";"Lleida";"4";"Lleida";"33";"Segrià";"25120";"Lleida";"1";"1";"A";"671";"241";"409";"515";"156";"5";"2";"508";"510"
"25";"Lleida";"4";"Lleida";"33";"Segrià";"25120";"Lleida";"1";"1";"B";"784";"263";"475";"593";"191";"2";"4";"587";"591"
"25";"Lleida";"4";"Lleida";"33";"Segrià";"25120";"Lleida";"1";"10";"A";"509";"179";"288";"356";"153";"3";"3";"350";"353"
"25";"Lleida";"4";"Lleida";"33";"Segrià";"25120";"Lleida";"1";"10";"B";"643";"212";"365";"450";"193";"1";"3";"446";"449"
"25";"Lleida";"4";"Lleida";"33";"Segrià";"25120";"Lleida";"1";"11";"A";"585";"202";"349";"451";"134";"1";"4";"446";"450"
"25";"Lleida";"4";"Lleida";"33";"Segrià";"25120";"Lleida";"1";"11";"B";"493";"161";"283";"373";"120";"3";"5";"365";"370"
"25";"Lleida";"4";"Lleida";"33";"Segrià";"25120";"Lleida";"1";"12";"U";"748";"245";"384";"498";"250";"8";"3";"487";"490"
"25";"Lleida";"4";"Lleida";"33";"Segrià";"25120";"Lleida";"1";"13";"A";"688";"234";"415";"499";"189";"5";"1";"493";"494"
"25";"Lleida";"4";"Lleida";"33";"Segrià";"25120";"Lleida";"1";"13";"B";"702";"226";"398";"530";"172";"3";"3";"524";"527"
"25";"Lleida";"4";"Lleida";"33";"Segrià";"25120";"Lleida";"1";"14";"A";"645";"223";"409";"504";"141";"0";"4";"500";"504"
"25";"Lleida";"4";"Lleida";"33";"Segrià";"25120";"Lleida";"1";"14";"B";"693";"219";"398";"523";"170";"2";"6";"515";"521"
"25";"Lleida";"4";"Lleida";"33";"Segrià";"25120";"Lleida";"1";"3";"A";"558";"192";"342";"423";"135";"2";"4";"417";"421"
"25";"Lleida";"4";"Lleida";"33";"Segrià";"25120";"Lleida";"1";"3";"B";"497";"197";"309";"390";"107";"2";"0";"388";"388"
"25";"Lleida";"4";"Lleida";"33";"Segrià";"25120";"Lleida";"1";"4";"A";"777";"257";"462";"596";"181";"2";"3";"591";"594"
"25";"Lleida";"4";"Lleida";"33";"Segrià";"25120";"Lleida";"1";"4";"B";"930";"318";"590";"747";"183";"5";"5";"737";"742"
"25";"Lleida";"4";"Lleida";"33";"Segrià";"25120";"Lleida";"1";"5";"A";"573";"179";"320";"408";"165";"2";"2";"404";"406"
"25";"Lleida";"4";"Lleida";"33";"Segrià";"25120";"Lleida";"1";"5";"B";"839";"267";"503";"609";"230";"2";"4";"603";"607"
"25";"Lleida";"4";"Lleida";"33";"Segrià";"25120";"Lleida";"1";"6";"A";"510";"177";"281";"355";"155";"3";"1";"351";"352"
"25";"Lleida";"4";"Lleida";"33";"Segrià";"25120";"Lleida";"1";"6";"B";"535";"189";"315";"389";"146";"3";"3";"383";"386"
"25";"Lleida";"4";"Lleida";"33";"Segrià";"25120";"Lleida";"1";"7";"A";"924";"310";"532";"666";"258";"3";"4";"659";"663"
"25";"Lleida";"4";"Lleida";"33";"Segrià";"25120";"Lleida";"1";"7";"B";"1090";"320";"600";"771";"319";"3";"5";"763";"768"
"25";"Lleida";"4";"Lleida";"33";"Segrià";"25120";"Lleida";"1";"8";"A";"855";"302";"505";"657";"198";"4";"1";"652";"653"
"25";"Lleida";"4";"Lleida";"33";"Segrià";"25120";"Lleida";"1";"8";"B";"955";"320";"570";"738";"217";"5";"8";"725";"733"
"25";"Lleida";"4";"Lleida";"33";"Segrià";"25120";"Lleida";"1";"9";"U";"805";"258";"459";"576";"229";"2";"5";"569";"574"
"25";"Lleida";"4";"Lleida";"33";"Segrià";"25120";"Lleida";"2";"2";"A";"509";"162";"291";"363";"146";"2";"2";"359";"361"
"25";"Lleida";"4";"Lleida";"33";"Segrià";"25120";"Lleida";"2";"2";"B";"623";"208";"415";"474";"149";"2";"1";"471";"472"
"25";"Lleida";"4";"Lleida";"33";"Segrià";"25120";"Lleida";"2";"3";"U";"877";"254";"513";"653";"224";"1";"7";"645";"652"
"25";"Lleida";"4";"Lleida";"33";"Segrià";"25120";"Lleida";"2";"4";"A";"945";"242";"572";"729";"216";"5";"15";"709";"724"
"25";"Lleida";"4";"Lleida";"33";"Segrià";"25120";"Lleida";"2";"4";"B";"1027";"231";"626";"791";"236";"6";"6";"779";"785"
"25";"Lleida";"4";"Lleida";"33";"Segrià";"25120";"Lleida";"2";"5";"A";"816";"203";"471";"631";"185";"0";"5";"626";"631"
"25";"Lleida";"4";"Lleida";"33";"Segrià";"25120";"Lleida";"2";"5";"B";"995";"278";"640";"811";"184";"3";"7";"801";"808"
"25";"Lleida";"4";"Lleida";"33";"Segrià";"25120";"Lleida";"2";"6";"U";"845";"287";"491";"629";"216";"3";"5";"621";"626"
"25";"Lleida";"4";"Lleida";"33";"Segrià";"25120";"Lleida";"2";"7";"A";"722";"237";"401";"544";"178";"0";"4";"540";"544"
"25";"Lleida";"4";"Lleida";"33";"Segrià";"25120";"Lleida";"2";"7";"B";"703";"198";"367";"503";"200";"0";"5";"498";"503"
"25";"Lleida";"4";"Lleida";"33";"Segrià";"25120";"Lleida";"2";"8";"U";"935";"315";"526";"661";"274";"2";"3";"656";"659"
"25";"Lleida";"4";"Lleida";"33";"Segrià";"25120";"Lleida";"2";"9";"A";"598";"198";"393";"490";"108";"2";"2";"486";"488"
"25";"Lleida";"4";"Lleida";"33";"Segrià";"25120";"Lleida";"2";"9";"B";"741";"201";"426";"616";"125";"2";"3";"611";"614"
"25";"Lleida";"4";"Lleida";"33";"Segrià";"25120";"Lleida";"3";"1";"U";"693";"217";"328";"421";"272";"2";"1";"418";"419"
"25";"Lleida";"4";"Lleida";"33";"Segrià";"25120";"Lleida";"3";"3";"U";"996";"309";"543";"670";"326";"3";"1";"666";"667"
"25";"Lleida";"4";"Lleida";"33";"Segrià";"25120";"Lleida";"3";"4";"A";"529";"193";"373";"431";"98";"3";"0";"428";"428"
"25";"Lleida";"4";"Lleida";"33";"Segrià";"25120";"Lleida";"3";"4";"B";"509";"217";"363";"420";"89";"1";"2";"417";"419"
"25";"Lleida";"4";"Lleida";"33";"Segrià";"25120";"Lleida";"3";"5";"U";"513";"192";"330";"421";"92";"0";"2";"419";"421"
"25";"Lleida";"4";"Lleida";"33";"Segrià";"25120";"Lleida";"3";"6";"A";"543";"211";"339";"417";"126";"1";"1";"415";"416"
"25";"Lleida";"4";"Lleida";"33";"Segrià";"25120";"Lleida";"3";"6";"B";"533";"173";"321";"408";"125";"2";"6";"400";"406"
"25";"Lleida";"4";"Lleida";"33";"Segrià";"25120";"Lleida";"3";"7";"U";"517";"195";"312";"394";"123";"1";"4";"389";"393"
"25";"Lleida";"4";"Lleida";"33";"Segrià";"25120";"Lleida";"3";"8";"U";"783";"302";"489";"590";"193";"2";"3";"585";"588"
"25";"Lleida";"4";"Lleida";"33";"Segrià";"25120";"Lleida";"4";"1";"A";"565";"154";"243";"291";"274";"2";"2";"287";"289"
"25";"Lleida";"4";"Lleida";"33";"Segrià";"25120";"Lleida";"4";"1";"B";"471";"123";"188";"230";"241";"4";"1";"225";"226"
"25";"Lleida";"4";"Lleida";"33";"Segrià";"25120";"Lleida";"4";"10";"A";"826";"188";"329";"425";"401";"0";"3";"422";"425"
"25";"Lleida";"4";"Lleida";"33";"Segrià";"25120";"Lleida";"4";"10";"B";"468";"139";"200";"244";"224";"1";"5";"238";"243"
"25";"Lleida";"4";"Lleida";"33";"Segrià";"25120";"Lleida";"4";"11";"A";"850";"201";"327";"401";"449";"1";"2";"398";"400"
"25";"Lleida";"4";"Lleida";"33";"Segrià";"25120";"Lleida";"4";"11";"B";"539";"146";"230";"279";"260";"1";"1";"277";"278"
"25";"Lleida";"4";"Lleida";"33";"Segrià";"25120";"Lleida";"4";"13";"U";"901";"315";"486";"593";"308";"0";"3";"590";"593"
"25";"Lleida";"4";"Lleida";"33";"Segrià";"25120";"Lleida";"4";"14";"A";"551";"190";"304";"376";"175";"1";"0";"375";"375"
"25";"Lleida";"4";"Lleida";"33";"Segrià";"25120";"Lleida";"4";"14";"B";"521";"174";"284";"364";"157";"0";"4";"360";"364"
"25";"Lleida";"4";"Lleida";"33";"Segrià";"25120";"Lleida";"4";"15";"U";"1025";"345";"623";"730";"295";"4";"2";"724";"726"
"25";"Lleida";"4";"Lleida";"33";"Segrià";"25120";"Lleida";"4";"16";"U";"1000";"434";"684";"732";"268";"4";"1";"727";"728"
"25";"Lleida";"4";"Lleida";"33";"Segrià";"25120";"Lleida";"4";"17";"A";"605";"199";"357";"456";"149";"5";"4";"447";"451"
"25";"Lleida";"4";"Lleida";"33";"Segrià";"25120";"Lleida";"4";"17";"B";"611";"216";"362";"462";"149";"6";"2";"454";"456"
"25";"Lleida";"4";"Lleida";"33";"Segrià";"25120";"Lleida";"4";"3";"A";"680";"231";"435";"539";"141";"0";"2";"537";"539"
"25";"Lleida";"4";"Lleida";"33";"Segrià";"25120";"Lleida";"4";"3";"B";"734";"281";"490";"599";"135";"1";"3";"595";"598"
"25";"Lleida";"4";"Lleida";"33";"Segrià";"25120";"Lleida";"4";"4";"U";"630";"227";"367";"441";"189";"4";"2";"435";"437"
"25";"Lleida";"4";"Lleida";"33";"Segrià";"25120";"Lleida";"4";"5";"U";"561";"167";"315";"422";"139";"1";"0";"421";"421"
"25";"Lleida";"4";"Lleida";"33";"Segrià";"25120";"Lleida";"4";"6";"A";"540";"173";"305";"422";"118";"3";"6";"413";"419"
"25";"Lleida";"4";"Lleida";"33";"Segrià";"25120";"Lleida";"4";"6";"B";"496";"158";"290";"385";"111";"1";"2";"382";"384"
"25";"Lleida";"4";"Lleida";"33";"Segrià";"25120";"Lleida";"4";"7";"U";"864";"337";"526";"637";"227";"4";"4";"629";"633"
"25";"Lleida";"4";"Lleida";"33";"Segrià";"25120";"Lleida";"4";"8";"U";"709";"246";"392";"482";"227";"2";"4";"476";"480"
"25";"Lleida";"4";"Lleida";"33";"Segrià";"25120";"Lleida";"5";"10";"U";"760";"276";"474";"607";"153";"2";"4";"601";"605"
"25";"Lleida";"4";"Lleida";"33";"Segrià";"25120";"Lleida";"5";"11";"A";"660";"233";"459";"580";"80";"3";"5";"572";"577"
"25";"Lleida";"4";"Lleida";"33";"Segrià";"25120";"Lleida";"5";"11";"B";"693";"250";"490";"610";"83";"4";"4";"602";"606"
"25";"Lleida";"4";"Lleida";"33";"Segrià";"25120";"Lleida";"5";"12";"U";"698";"240";"470";"561";"137";"1";"3";"557";"560"
"25";"Lleida";"4";"Lleida";"33";"Segrià";"25120";"Lleida";"5";"2";"U";"759";"263";"452";"557";"202";"8";"4";"545";"549"
"25";"Lleida";"4";"Lleida";"33";"Segrià";"25120";"Lleida";"5";"3";"U";"906";"337";"533";"657";"249";"2";"2";"653";"655"
"25";"Lleida";"4";"Lleida";"33";"Segrià";"25120";"Lleida";"5";"4";"U";"768";"272";"476";"598";"170";"0";"5";"593";"598"
"25";"Lleida";"4";"Lleida";"33";"Segrià";"25120";"Lleida";"5";"5";"U";"853";"289";"494";"648";"205";"2";"2";"644";"646"
"25";"Lleida";"4";"Lleida";"33";"Segrià";"25120";"Lleida";"5";"6";"A";"577";"177";"360";"487";"90";"0";"0";"487";"487"
"25";"Lleida";"4";"Lleida";"33";"Segrià";"25120";"Lleida";"5";"6";"B";"722";"221";"434";"578";"144";"1";"2";"575";"577"
"25";"Lleida";"4";"Lleida";"33";"Segrià";"25120";"Lleida";"5";"7";"U";"552";"187";"285";"359";"193";"2";"1";"356";"357"
"25";"Lleida";"4";"Lleida";"33";"Segrià";"25120";"Lleida";"5";"8";"U";"882";"314";"540";"698";"184";"3";"4";"691";"695"
"25";"Lleida";"4";"Lleida";"33";"Segrià";"25120";"Lleida";"5";"9";"U";"742";"243";"479";"594";"148";"2";"4";"588";"592"
"25";"Lleida";"4";"Lleida";"33";"Segrià";"25120";"Lleida";"6";"1";"A";"342";"77";"123";"149";"193";"3";"0";"146";"146"
"25";"Lleida";"4";"Lleida";"33";"Segrià";"25120";"Lleida";"6";"1";"B";"776";"284";"468";"570";"206";"4";"4";"562";"566"
"25";"Lleida";"4";"Lleida";"33";"Segrià";"25120";"Lleida";"6";"10";"U";"978";"334";"551";"673";"305";"3";"6";"664";"670"
"25";"Lleida";"4";"Lleida";"33";"Segrià";"25120";"Lleida";"6";"11";"U";"960";"288";"544";"742";"218";"0";"5";"737";"742"
"25";"Lleida";"4";"Lleida";"33";"Segrià";"25120";"Lleida";"6";"12";"A";"574";"206";"365";"451";"123";"2";"3";"446";"449"
"25";"Lleida";"4";"Lleida";"33";"Segrià";"25120";"Lleida";"6";"12";"B";"469";"181";"293";"363";"106";"3";"0";"360";"360"
"25";"Lleida";"4";"Lleida";"33";"Segrià";"25120";"Lleida";"6";"13";"U";"905";"347";"596";"741";"164";"5";"1";"735";"736"
"25";"Lleida";"4";"Lleida";"33";"Segrià";"25120";"Lleida";"6";"14";"A";"791";"267";"492";"632";"159";"3";"4";"625";"629"
"25";"Lleida";"4";"Lleida";"33";"Segrià";"25120";"Lleida";"6";"14";"B";"890";"275";"523";"691";"199";"0";"16";"675";"691"
"25";"Lleida";"4";"Lleida";"33";"Segrià";"25120";"Lleida";"6";"16";"U";"679";"216";"421";"556";"123";"0";"4";"552";"556"
"25";"Lleida";"4";"Lleida";"33";"Segrià";"25120";"Lleida";"6";"17";"A";"631";"190";"342";"432";"199";"3";"4";"425";"429"
"25";"Lleida";"4";"Lleida";"33";"Segrià";"25120";"Lleida";"6";"17";"B";"718";"223";"399";"508";"210";"2";"7";"499";"506"
"25";"Lleida";"4";"Lleida";"33";"Segrià";"25120";"Lleida";"6";"2";"A";"549";"227";"337";"414";"135";"1";"0";"413";"413"
"25";"Lleida";"4";"Lleida";"33";"Segrià";"25120";"Lleida";"6";"2";"B";"556";"192";"331";"412";"144";"1";"1";"410";"411"
"25";"Lleida";"4";"Lleida";"33";"Segrià";"25120";"Lleida";"6";"3";"A";"621";"204";"351";"438";"183";"3";"2";"433";"435"
"25";"Lleida";"4";"Lleida";"33";"Segrià";"25120";"Lleida";"6";"3";"B";"724";"242";"425";"525";"199";"3";"5";"517";"522"
"25";"Lleida";"4";"Lleida";"33";"Segrià";"25120";"Lleida";"6";"4";"A";"651";"216";"392";"497";"154";"0";"8";"489";"497"
"25";"Lleida";"4";"Lleida";"33";"Segrià";"25120";"Lleida";"6";"4";"B";"729";"247";"455";"578";"151";"1";"1";"576";"577"
"25";"Lleida";"4";"Lleida";"33";"Segrià";"25120";"Lleida";"6";"5";"U";"571";"225";"361";"447";"124";"2";"3";"442";"445"
"25";"Lleida";"4";"Lleida";"33";"Segrià";"25120";"Lleida";"6";"6";"U";"955";"323";"563";"696";"259";"3";"6";"687";"693"
"25";"Lleida";"4";"Lleida";"33";"Segrià";"25120";"Lleida";"6";"7";"A";"745";"233";"410";"530";"215";"1";"4";"525";"529"
"25";"Lleida";"4";"Lleida";"33";"Segrià";"25120";"Lleida";"6";"7";"B";"900";"275";"491";"626";"274";"3";"3";"620";"623"
"25";"Lleida";"4";"Lleida";"33";"Segrià";"25120";"Lleida";"6";"9";"A";"848";"206";"446";"567";"281";"2";"3";"562";"565"
"25";"Lleida";"4";"Lleida";"33";"Segrià";"25120";"Lleida";"6";"9";"B";"799";"310";"530";"570";"229";"6";"3";"561";"564"
"25";"Lleida";"4";"Lleida";"33";"Segrià";"25120";"Lleida";"7";"1";"A";"663";"236";"394";"505";"158";"1";"6";"498";"504"
"25";"Lleida";"4";"Lleida";"33";"Segrià";"25120";"Lleida";"7";"1";"B";"748";"248";"405";"562";"186";"1";"4";"557";"561"
"25";"Lleida";"4";"Lleida";"33";"Segrià";"25120";"Lleida";"7";"1";"C";"755";"273";"465";"591";"164";"2";"6";"583";"589"
"25";"Lleida";"4";"Lleida";"33";"Segrià";"25120";"Lleida";"7";"2";"U";"703";"242";"397";"491";"212";"4";"5";"482";"487"
"25";"Lleida";"4";"Lleida";"33";"Segrià";"25120";"Lleida";"7";"3";"A";"639";"222";"406";"482";"157";"1";"2";"479";"481"
"25";"Lleida";"4";"Lleida";"33";"Segrià";"25120";"Lleida";"7";"3";"B";"773";"225";"450";"567";"206";"4";"5";"558";"563"
"25";"Lleida";"4";"Lleida";"33";"Segrià";"25120";"Lleida";"7";"4";"A";"933";"276";"455";"568";"365";"0";"2";"566";"568"
"25";"Lleida";"4";"Lleida";"33";"Segrià";"25120";"Lleida";"7";"4";"B";"1023";"295";"530";"663";"360";"3";"1";"659";"660"
"25";"Lleida";"4";"Lleida";"33";"Segrià";"25120";"Lleida";"7";"5";"A";"832";"249";"508";"623";"209";"6";"3";"614";"617"
"25";"Lleida";"4";"Lleida";"33";"Segrià";"25120";"Lleida";"7";"5";"B";"974";"306";"543";"721";"253";"5";"2";"714";"716"
"25";"Lleida";"4";"Lleida";"33";"Segrià";"25120";"Lleida";"7";"6";"A";"816";"278";"460";"558";"258";"2";"4";"552";"556"
"25";"Lleida";"4";"Lleida";"33";"Segrià";"25120";"Lleida";"7";"6";"B";"826";"245";"481";"587";"239";"4";"3";"580";"583"
"25";"Lleida";"4";"Lleida";"33";"Segrià";"25120";"Lleida";"7";"7";"A";"760";"239";"437";"549";"211";"8";"5";"536";"541"
"25";"Lleida";"4";"Lleida";"33";"Segrià";"25120";"Lleida";"7";"7";"B";"841";"276";"479";"572";"269";"3";"3";"566";"569"
"25";"Lleida";"4";"Lleida";"33";"Segrià";"25120";"Lleida";"8";"1";"A";"462";"155";"295";"358";"104";"0";"5";"353";"358"
"25";"Lleida";"4";"Lleida";"33";"Segrià";"25120";"Lleida";"8";"1";"B";"669";"205";"382";"468";"201";"1";"7";"460";"467"
"25";"Lleida";"4";"Lleida";"33";"Segrià";"25120";"Lleida";"8";"2";"A";"678";"213";"411";"572";"106";"2";"4";"566";"570"
"25";"Lleida";"4";"Lleida";"33";"Segrià";"25120";"Lleida";"8";"2";"B";"824";"271";"517";"708";"116";"3";"7";"698";"705"
"25";"Lleida";"4";"Lleida";"33";"Segrià";"25120";"Lleida";"8";"2";"C";"409";"110";"232";"310";"99";"0";"2";"308";"310"
"25";"Lleida";"4";"Lleida";"33";"Segrià";"25120";"Lleida";"8";"2";"D";"305";"97";"199";"266";"39";"1";"0";"265";"265"
"25";"Lleida";"4";"Lleida";"33";"Segrià";"25120";"Lleida";"8";"3";"A";"382";"118";"224";"309";"73";"2";"6";"301";"307"
"25";"Lleida";"4";"Lleida";"33";"Segrià";"25120";"Lleida";"8";"3";"B";"463";"113";"258";"370";"93";"0";"2";"368";"370"
"25";"Lleida";"4";"Lleida";"33";"Segrià";"25120";"Lleida";"9";"1";"A";"569";"166";"336";"443";"126";"0";"1";"442";"443"
"25";"Lleida";"4";"Lleida";"33";"Segrià";"25120";"Lleida";"9";"1";"B";"967";"402";"592";"739";"228";"0";"5";"734";"739"
"25";"Lleida";"4";"Lleida";"33";"Segrià";"25120";"Lleida";"9";"2";"A";"956";"283";"551";"699";"257";"6";"2";"691";"693"
"25";"Lleida";"4";"Lleida";"33";"Segrià";"25120";"Lleida";"9";"2";"B";"150";"63";"88";"112";"38";"0";"3";"109";"112"
"25";"Lleida";"4";"Lleida";"33";"Segrià";"25133";"Maials";"1";"1";"U";"714";"257";"439";"569";"145";"0";"6";"563";"569"
"25";"Lleida";"4";"Lleida";"38";"Urgell";"25130";"Maldà";"1";"1";"U";"197";"62";"130";"162";"35";"0";"2";"160";"162"
"25";"Lleida";"4";"Lleida";"33";"Segrià";"25131";"Massalcoreig";"1";"1";"U";"413";"160";"261";"310";"103";"2";"3";"305";"308"
"25";"Lleida";"4";"Lleida";"32";"Segarra";"25132";"Massoteres";"1";"1";"U";"126";"61";"90";"107";"19";"0";"0";"107";"107"
"25";"Lleida";"4";"Lleida";"23";"Noguera";"25134";"Menàrguens";"1";"1";"U";"631";"197";"413";"503";"128";"5";"5";"493";"498"
"25";"Lleida";"4";"Lleida";"27";"Pla d'Urgell";"25135";"Miralcamp";"1";"1";"U";"1027";"296";"646";"830";"197";"4";"9";"817";"826"
"25";"Lleida";"4";"Lleida";"27";"Pla d'Urgell";"25137";"Mollerussa";"1";"1";"A";"759";"277";"493";"596";"163";"2";"4";"590";"594"
"25";"Lleida";"4";"Lleida";"27";"Pla d'Urgell";"25137";"Mollerussa";"1";"1";"B";"777";"262";"470";"582";"195";"3";"5";"574";"579"
"25";"Lleida";"4";"Lleida";"27";"Pla d'Urgell";"25137";"Mollerussa";"1";"2";"A";"775";"258";"468";"575";"200";"4";"6";"565";"571"
"25";"Lleida";"4";"Lleida";"27";"Pla d'Urgell";"25137";"Mollerussa";"1";"2";"B";"959";"291";"602";"707";"252";"5";"7";"695";"702"
"25";"Lleida";"4";"Lleida";"27";"Pla d'Urgell";"25137";"Mollerussa";"1";"3";"U";"750";"247";"403";"499";"251";"5";"2";"492";"494"
"25";"Lleida";"4";"Lleida";"27";"Pla d'Urgell";"25137";"Mollerussa";"1";"4";"A";"643";"245";"430";"523";"120";"0";"3";"520";"523"
"25";"Lleida";"4";"Lleida";"27";"Pla d'Urgell";"25137";"Mollerussa";"1";"4";"B";"889";"321";"587";"706";"183";"5";"5";"696";"701"
"25";"Lleida";"4";"Lleida";"27";"Pla d'Urgell";"25137";"Mollerussa";"1";"5";"A";"693";"253";"416";"508";"185";"5";"3";"500";"503"
"25";"Lleida";"4";"Lleida";"27";"Pla d'Urgell";"25137";"Mollerussa";"1";"5";"B";"878";"313";"543";"675";"203";"1";"3";"671";"674"
"25";"Lleida";"4";"Lleida";"27";"Pla d'Urgell";"25137";"Mollerussa";"1";"6";"A";"643";"216";"407";"504";"139";"1";"7";"496";"503"
"25";"Lleida";"4";"Lleida";"27";"Pla d'Urgell";"25137";"Mollerussa";"1";"6";"B";"797";"290";"511";"639";"158";"1";"2";"636";"638"
"25";"Lleida";"4";"Lleida";"23";"Noguera";"25138";"Montgai";"1";"1";"A";"371";"148";"255";"328";"43";"4";"4";"320";"324"
"25";"Lleida";"4";"Lleida";"23";"Noguera";"25138";"Montgai";"1";"1";"B";"205";"84";"150";"174";"31";"0";"5";"169";"174"
"25";"Lleida";"4";"Lleida";"33";"Segrià";"25142";"Montoliu de Lleida";"1";"1";"U";"369";"152";"235";"297";"72";"0";"2";"295";"297"
"25";"Lleida";"4";"Lleida";"32";"Segarra";"25141";"Montoliu de Segarra";"1";"1";"U";"157";"65";"108";"124";"33";"1";"4";"119";"123"
"25";"Lleida";"4";"Lleida";"32";"Segarra";"25143";"Montornès de Segarra";"1";"1";"U";"87";"23";"48";"73";"14";"0";"0";"73";"73"
"25";"Lleida";"4";"Lleida";"38";"Urgell";"25145";"Nalec";"1";"1";"U";"85";"40";"59";"73";"12";"1";"0";"72";"72"
"25";"Lleida";"4";"Lleida";"23";"Noguera";"25150";"Oliola";"1";"1";"U";"187";"62";"118";"153";"34";"2";"0";"151";"151"
"25";"Lleida";"4";"Lleida";"32";"Segarra";"25152";"Oluges, les";"1";"1";"U";"140";"42";"79";"107";"33";"0";"1";"106";"107"
"25";"Lleida";"4";"Lleida";"18";"Garrigues";"25153";"Omellons, els";"1";"1";"U";"200";"76";"134";"164";"36";"2";"2";"160";"162"
"25";"Lleida";"4";"Lleida";"38";"Urgell";"25154";"Omells de na Gaia, els";"1";"1";"U";"122";"47";"74";"93";"29";"0";"0";"93";"93"
"25";"Lleida";"4";"Lleida";"23";"Noguera";"25156";"Os de Balaguer";"1";"1";"A";"343";"163";"252";"301";"42";"1";"5";"295";"300"
"25";"Lleida";"4";"Lleida";"23";"Noguera";"25156";"Os de Balaguer";"1";"1";"B";"435";"148";"285";"355";"80";"0";"2";"353";"355"
"25";"Lleida";"4";"Lleida";"38";"Urgell";"25157";"Ossó de Sió";"1";"1";"U";"182";"67";"125";"156";"26";"1";"0";"155";"155"
"25";"Lleida";"4";"Lleida";"27";"Pla d'Urgell";"25158";"Palau d'Anglesola, el";"1";"1";"A";"738";"311";"495";"587";"151";"5";"9";"573";"582"
"25";"Lleida";"4";"Lleida";"27";"Pla d'Urgell";"25158";"Palau d'Anglesola, el";"1";"1";"B";"887";"267";"625";"748";"139";"1";"4";"743";"747"
"25";"Lleida";"4";"Lleida";"23";"Noguera";"25164";"Penelles";"1";"1";"U";"388";"170";"262";"289";"99";"2";"4";"283";"287"
"25";"Lleida";"4";"Lleida";"32";"Segarra";"25911";"Plans de Sió, els";"1";"1";"U";"454";"178";"301";"374";"80";"1";"1";"372";"373"
"25";"Lleida";"4";"Lleida";"27";"Pla d'Urgell";"25168";"Poal, el";"1";"1";"U";"513";"209";"366";"438";"75";"1";"2";"435";"437"
"25";"Lleida";"4";"Lleida";"18";"Garrigues";"25169";"Pobla de Cérvoles, la";"1";"1";"U";"188";"76";"113";"151";"37";"0";"2";"149";"151"
"25";"Lleida";"4";"Lleida";"23";"Noguera";"25172";"Ponts";"1";"1";"U";"718";"300";"474";"574";"144";"5";"3";"566";"569"
"25";"Lleida";"4";"Lleida";"23";"Noguera";"25172";"Ponts";"1";"2";"A";"581";"232";"395";"476";"105";"2";"4";"470";"474"
"25";"Lleida";"4";"Lleida";"23";"Noguera";"25172";"Ponts";"1";"2";"B";"512";"213";"349";"425";"87";"1";"0";"424";"424"
"25";"Lleida";"4";"Lleida";"33";"Segrià";"25174";"Portella, la";"1";"1";"U";"397";"178";"280";"346";"51";"1";"7";"338";"345"
"25";"Lleida";"4";"Lleida";"38";"Urgell";"25176";"Preixana";"1";"1";"U";"321";"153";"230";"268";"53";"5";"4";"259";"263"
"25";"Lleida";"4";"Lleida";"23";"Noguera";"25177";"Preixens";"1";"1";"U";"376";"170";"264";"297";"79";"4";"1";"292";"293"
"25";"Lleida";"4";"Lleida";"18";"Garrigues";"25180";"Puiggròs";"1";"1";"U";"238";"85";"140";"178";"60";"1";"1";"176";"177"
"25";"Lleida";"4";"Lleida";"38";"Urgell";"25181";"Puigverd d'Agramunt";"1";"1";"U";"179";"74";"131";"152";"27";"0";"3";"149";"152"
"25";"Lleida";"4";"Lleida";"33";"Segrià";"25182";"Puigverd de Lleida";"1";"1";"A";"548";"181";"341";"430";"118";"4";"4";"422";"426"
"25";"Lleida";"4";"Lleida";"33";"Segrià";"25182";"Puigverd de Lleida";"1";"1";"B";"502";"172";"328";"416";"86";"1";"5";"410";"415"
"25";"Lleida";"4";"Lleida";"32";"Segarra";"25905";"Ribera d'Ondara";"1";"1";"U";"384";"156";"280";"329";"55";"2";"3";"324";"327"
"25";"Lleida";"4";"Lleida";"33";"Segrià";"25189";"Rosselló";"1";"1";"A";"1009";"302";"588";"767";"242";"5";"4";"758";"762"
"25";"Lleida";"4";"Lleida";"33";"Segrià";"25189";"Rosselló";"1";"1";"B";"1090";"345";"631";"814";"276";"7";"2";"805";"807"
"25";"Lleida";"4";"Lleida";"32";"Segarra";"25191";"Sanaüja";"1";"1";"U";"330";"112";"235";"272";"58";"0";"2";"270";"272"
"25";"Lleida";"4";"Lleida";"32";"Segarra";"25192";"Sant Guim de Freixenet";"1";"1";"U";"768";"253";"527";"622";"146";"8";"3";"611";"614"
"25";"Lleida";"4";"Lleida";"32";"Segarra";"25197";"Sant Guim de la Plana";"1";"1";"U";"139";"40";"93";"119";"20";"0";"0";"119";"119"
"25";"Lleida";"4";"Lleida";"38";"Urgell";"25902";"Sant Martí de Riucorb";"1";"1";"U";"569";"246";"430";"493";"76";"5";"3";"485";"488"
"25";"Lleida";"4";"Lleida";"32";"Segarra";"25194";"Sant Ramon";"1";"1";"U";"425";"110";"279";"346";"79";"1";"5";"340";"345"
"25";"Lleida";"4";"Lleida";"33";"Segrià";"25200";"Sarroca de Lleida";"1";"1";"U";"342";"148";"227";"264";"78";"0";"5";"259";"264"
"25";"Lleida";"4";"Lleida";"23";"Noguera";"25035";"Sentiu de Sió, la";"1";"1";"U";"398";"133";"239";"335";"63";"6";"4";"325";"329"
"25";"Lleida";"4";"Lleida";"33";"Segrià";"25204";"Seròs";"1";"1";"U";"571";"172";"335";"458";"113";"8";"5";"445";"450"
"25";"Lleida";"4";"Lleida";"33";"Segrià";"25204";"Seròs";"1";"2";"U";"674";"217";"376";"532";"142";"3";"4";"525";"529"
"25";"Lleida";"4";"Lleida";"27";"Pla d'Urgell";"25205";"Sidamon";"1";"1";"U";"563";"202";"372";"464";"99";"6";"6";"452";"458"
"25";"Lleida";"4";"Lleida";"18";"Garrigues";"25206";"Soleràs, el";"1";"1";"U";"259";"90";"176";"222";"37";"0";"2";"220";"222"
"25";"Lleida";"4";"Lleida";"33";"Segrià";"25210";"Soses";"1";"1";"U";"1111";"430";"759";"911";"200";"2";"10";"899";"909"
"25";"Lleida";"4";"Lleida";"33";"Segrià";"25211";"Sudanell";"1";"1";"U";"683";"264";"415";"507";"176";"3";"4";"500";"504"
"25";"Lleida";"4";"Lleida";"33";"Segrià";"25212";"Sunyer";"1";"1";"U";"235";"83";"149";"198";"37";"0";"4";"194";"198"
"25";"Lleida";"4";"Lleida";"32";"Segarra";"25216";"Talavera";"1";"1";"U";"228";"89";"159";"200";"28";"1";"0";"199";"199"
"25";"Lleida";"4";"Lleida";"32";"Segarra";"25219";"Tarroja de Segarra";"1";"1";"U";"142";"50";"98";"128";"14";"0";"0";"128";"128"
"25";"Lleida";"4";"Lleida";"18";"Garrigues";"25218";"Tarrés";"1";"1";"U";"85";"41";"62";"75";"10";"0";"0";"75";"75"
"25";"Lleida";"4";"Lleida";"23";"Noguera";"25222";"Tiurana";"1";"1";"U";"66";"33";"41";"55";"11";"0";"0";"55";"55"
"25";"Lleida";"4";"Lleida";"18";"Garrigues";"25224";"Torms, els";"1";"1";"U";"126";"50";"80";"108";"18";"1";"0";"107";"107"
"25";"Lleida";"4";"Lleida";"38";"Urgell";"25225";"Tornabous";"1";"1";"U";"574";"255";"367";"482";"92";"2";"3";"477";"480"
"25";"Lleida";"4";"Lleida";"33";"Segrià";"25233";"Torre-serona";"1";"1";"U";"274";"89";"182";"223";"51";"0";"3";"220";"223"
"25";"Lleida";"4";"Lleida";"33";"Segrià";"25226";"Torrebesses";"1";"1";"U";"251";"91";"155";"197";"54";"4";"1";"192";"193"
"25";"Lleida";"4";"Lleida";"33";"Segrià";"25228";"Torrefarrera";"1";"1";"U";"1211";"335";"732";"902";"309";"5";"10";"887";"897"
"25";"Lleida";"4";"Lleida";"33";"Segrià";"25228";"Torrefarrera";"1";"2";"A";"860";"277";"551";"715";"145";"2";"5";"708";"713"
"25";"Lleida";"4";"Lleida";"33";"Segrià";"25228";"Torrefarrera";"1";"2";"B";"954";"302";"614";"797";"157";"3";"6";"788";"794"
"25";"Lleida";"4";"Lleida";"32";"Segarra";"25907";"Torrefeta i Florejacs";"1";"1";"U";"502";"180";"356";"406";"96";"2";"3";"401";"404"
"25";"Lleida";"4";"Lleida";"27";"Pla d'Urgell";"25230";"Torregrossa";"1";"1";"A";"838";"269";"535";"662";"176";"2";"4";"656";"660"
"25";"Lleida";"4";"Lleida";"27";"Pla d'Urgell";"25230";"Torregrossa";"1";"1";"B";"742";"286";"490";"605";"137";"6";"4";"595";"599"
"25";"Lleida";"4";"Lleida";"23";"Noguera";"25231";"Torrelameu";"1";"1";"U";"491";"184";"358";"424";"67";"1";"3";"420";"423"
"25";"Lleida";"4";"Lleida";"33";"Segrià";"25232";"Torres de Segre";"1";"1";"A";"693";"211";"450";"553";"140";"0";"6";"547";"553"
"25";"Lleida";"4";"Lleida";"33";"Segrià";"25232";"Torres de Segre";"1";"1";"B";"731";"266";"483";"591";"140";"1";"5";"585";"590"
"25";"Lleida";"4";"Lleida";"32";"Segarra";"25223";"Torà";"1";"1";"U";"933";"368";"647";"782";"151";"9";"4";"769";"773"
"25";"Lleida";"4";"Lleida";"38";"Urgell";"25217";"Tàrrega";"1";"1";"A";"732";"255";"447";"547";"185";"4";"7";"536";"543"
"25";"Lleida";"4";"Lleida";"38";"Urgell";"25217";"Tàrrega";"1";"1";"B";"860";"284";"520";"630";"230";"6";"2";"622";"624"
"25";"Lleida";"4";"Lleida";"38";"Urgell";"25217";"Tàrrega";"1";"2";"U";"953";"330";"588";"708";"245";"5";"10";"693";"703"
"25";"Lleida";"4";"Lleida";"38";"Urgell";"25217";"Tàrrega";"2";"1";"A";"528";"200";"336";"413";"115";"0";"4";"409";"413"
"25";"Lleida";"4";"Lleida";"38";"Urgell";"25217";"Tàrrega";"2";"1";"B";"622";"259";"424";"504";"118";"1";"3";"500";"503"
"25";"Lleida";"4";"Lleida";"38";"Urgell";"25217";"Tàrrega";"2";"2";"A";"615";"236";"395";"478";"137";"1";"1";"476";"477"
"25";"Lleida";"4";"Lleida";"38";"Urgell";"25217";"Tàrrega";"2";"2";"B";"734";"277";"487";"599";"135";"1";"4";"594";"598"
"25";"Lleida";"4";"Lleida";"38";"Urgell";"25217";"Tàrrega";"2";"3";"A";"534";"195";"342";"413";"121";"1";"2";"410";"412"
"25";"Lleida";"4";"Lleida";"38";"Urgell";"25217";"Tàrrega";"2";"3";"B";"588";"219";"382";"468";"120";"1";"2";"465";"467"
"25";"Lleida";"4";"Lleida";"38";"Urgell";"25217";"Tàrrega";"3";"1";"A";"539";"190";"311";"383";"156";"1";"6";"376";"382"
"25";"Lleida";"4";"Lleida";"38";"Urgell";"25217";"Tàrrega";"3";"1";"B";"553";"192";"336";"418";"135";"0";"1";"417";"418"
"25";"Lleida";"4";"Lleida";"38";"Urgell";"25217";"Tàrrega";"3";"2";"U";"649";"244";"392";"497";"152";"1";"10";"486";"496"
"25";"Lleida";"4";"Lleida";"38";"Urgell";"25217";"Tàrrega";"3";"3";"U";"1024";"380";"644";"790";"234";"3";"12";"775";"787"
"25";"Lleida";"4";"Lleida";"38";"Urgell";"25217";"Tàrrega";"4";"1";"U";"575";"193";"341";"419";"156";"2";"6";"411";"417"
"25";"Lleida";"4";"Lleida";"38";"Urgell";"25217";"Tàrrega";"4";"2";"A";"530";"194";"344";"419";"111";"1";"6";"412";"418"
"25";"Lleida";"4";"Lleida";"38";"Urgell";"25217";"Tàrrega";"4";"2";"B";"556";"179";"338";"419";"137";"0";"3";"416";"419"
"25";"Lleida";"4";"Lleida";"23";"Noguera";"25220";"Térmens";"1";"1";"U";"1029";"320";"718";"837";"192";"1";"6";"830";"836"
"25";"Lleida";"4";"Lleida";"38";"Urgell";"25238";"Vallbona de les Monges";"1";"1";"U";"215";"102";"148";"178";"37";"2";"0";"176";"176"
"25";"Lleida";"4";"Lleida";"23";"Noguera";"25240";"Vallfogona de Balaguer";"1";"1";"A";"804";"227";"519";"667";"137";"6";"9";"652";"661"
"25";"Lleida";"4";"Lleida";"23";"Noguera";"25240";"Vallfogona de Balaguer";"1";"1";"B";"235";"101";"161";"196";"39";"0";"2";"194";"196"
"25";"Lleida";"4";"Lleida";"23";"Noguera";"25240";"Vallfogona de Balaguer";"1";"1";"C";"361";"121";"221";"299";"62";"1";"1";"297";"298"
"25";"Lleida";"4";"Lleida";"38";"Urgell";"25242";"Verdú";"1";"1";"U";"733";"292";"484";"575";"158";"7";"1";"567";"568"
"25";"Lleida";"4";"Lleida";"27";"Pla d'Urgell";"25252";"Vila-sana";"1";"1";"U";"536";"164";"354";"445";"91";"2";"3";"440";"443"
"25";"Lleida";"4";"Lleida";"38";"Urgell";"25244";"Vilagrassa";"1";"1";"U";"366";"127";"240";"307";"59";"2";"4";"301";"305"
"25";"Lleida";"4";"Lleida";"27";"Pla d'Urgell";"25248";"Vilanova de Bellpuig";"1";"1";"U";"890";"270";"610";"755";"135";"5";"2";"748";"750"
"25";"Lleida";"4";"Lleida";"23";"Noguera";"25250";"Vilanova de Meià";"1";"1";"U";"347";"160";"248";"292";"55";"2";"2";"288";"290"
"25";"Lleida";"4";"Lleida";"33";"Segrià";"25251";"Vilanova de Segrià";"1";"1";"U";"710";"296";"479";"559";"151";"1";"2";"556";"558"
"25";"Lleida";"4";"Lleida";"23";"Noguera";"25249";"Vilanova de l'Aguda";"1";"1";"U";"182";"56";"120";"149";"33";"2";"6";"141";"147"
"25";"Lleida";"4";"Lleida";"33";"Segrià";"25254";"Vilanova de la Barca";"1";"1";"U";"735";"253";"488";"587";"148";"3";"2";"582";"584"
"25";"Lleida";"4";"Lleida";"18";"Garrigues";"25253";"Vilosell, el";"1";"1";"U";"164";"78";"126";"146";"18";"0";"0";"146";"146"
"25";"Lleida";"4";"Lleida";"18";"Garrigues";"25255";"Vinaixa";"1";"1";"U";"430";"165";"300";"361";"69";"3";"1";"357";"358"
"25";"Lleida";"4";"Lleida";"23";"Noguera";"25002";"Àger";"1";"1";"U";"484";"207";"322";"403";"81";"5";"3";"395";"398"
"43";"Tarragona";"6";"Camp de Tarragona";"1";"Alt Camp";"43001";"Aiguamúrcia";"1";"1";"A";"268";"113";"194";"231";"37";"3";"0";"228";"228"
"43";"Tarragona";"6";"Camp de Tarragona";"1";"Alt Camp";"43001";"Aiguamúrcia";"1";"1";"B";"421";"142";"256";"324";"97";"4";"4";"316";"320"
"43";"Tarragona";"6";"Camp de Tarragona";"12";"Baix Penedès";"43002";"Albinyana";"1";"1";"A";"533";"186";"327";"403";"130";"4";"2";"397";"399"
"43";"Tarragona";"6";"Camp de Tarragona";"12";"Baix Penedès";"43002";"Albinyana";"1";"1";"B";"442";"185";"273";"313";"129";"6";"1";"306";"307"
"43";"Tarragona";"6";"Camp de Tarragona";"12";"Baix Penedès";"43002";"Albinyana";"1";"1";"C";"445";"167";"273";"348";"97";"5";"0";"343";"343"
"43";"Tarragona";"6";"Camp de Tarragona";"12";"Baix Penedès";"43002";"Albinyana";"1";"1";"D";"390";"137";"249";"310";"80";"3";"0";"307";"307"
"43";"Tarragona";"6";"Camp de Tarragona";"8";"Baix Camp";"43003";"Albiol, l'";"1";"1";"U";"321";"105";"211";"260";"61";"0";"3";"257";"260"
"43";"Tarragona";"6";"Camp de Tarragona";"1";"Alt Camp";"43005";"Alcover";"1";"1";"A";"623";"212";"397";"492";"131";"4";"4";"484";"488"
"43";"Tarragona";"6";"Camp de Tarragona";"1";"Alt Camp";"43005";"Alcover";"1";"1";"B";"600";"214";"379";"486";"114";"1";"3";"482";"485"
"43";"Tarragona";"6";"Camp de Tarragona";"1";"Alt Camp";"43005";"Alcover";"1";"1";"C";"679";"247";"447";"554";"125";"0";"5";"549";"554"
"43";"Tarragona";"6";"Camp de Tarragona";"1";"Alt Camp";"43005";"Alcover";"2";"1";"A";"566";"190";"346";"458";"108";"2";"3";"453";"456"
"43";"Tarragona";"6";"Camp de Tarragona";"1";"Alt Camp";"43005";"Alcover";"2";"1";"B";"557";"185";"319";"395";"162";"2";"2";"391";"393"
"43";"Tarragona";"6";"Camp de Tarragona";"1";"Alt Camp";"43005";"Alcover";"2";"1";"C";"587";"207";"361";"449";"138";"0";"1";"448";"449"
"43";"Tarragona";"6";"Camp de Tarragona";"8";"Baix Camp";"43007";"Aleixar, l'";"1";"1";"U";"636";"220";"430";"520";"116";"1";"2";"517";"519"
"43";"Tarragona";"6";"Camp de Tarragona";"8";"Baix Camp";"43009";"Alforja";"1";"1";"A";"682";"226";"453";"521";"161";"4";"5";"512";"517"
"43";"Tarragona";"6";"Camp de Tarragona";"8";"Baix Camp";"43009";"Alforja";"1";"1";"B";"740";"218";"477";"562";"178";"2";"11";"549";"560"
"43";"Tarragona";"6";"Camp de Tarragona";"1";"Alt Camp";"43010";"Alió";"1";"1";"U";"322";"151";"257";"286";"36";"1";"2";"283";"285"
"43";"Tarragona";"6";"Camp de Tarragona";"8";"Baix Camp";"43011";"Almoster";"1";"1";"A";"579";"209";"421";"498";"81";"1";"2";"495";"497"
"43";"Tarragona";"6";"Camp de Tarragona";"8";"Baix Camp";"43011";"Almoster";"1";"1";"B";"512";"181";"355";"445";"67";"1";"1";"443";"444"
"43";"Tarragona";"6";"Camp de Tarragona";"36";"Tarragonès";"43012";"Altafulla";"1";"1";"A";"435";"159";"270";"337";"98";"1";"1";"335";"336"
"43";"Tarragona";"6";"Camp de Tarragona";"36";"Tarragonès";"43012";"Altafulla";"1";"1";"B";"440";"179";"295";"347";"93";"4";"1";"342";"343"
"43";"Tarragona";"6";"Camp de Tarragona";"36";"Tarragonès";"43012";"Altafulla";"1";"2";"A";"462";"181";"301";"369";"93";"3";"3";"363";"366"
"43";"Tarragona";"6";"Camp de Tarragona";"36";"Tarragonès";"43012";"Altafulla";"1";"2";"B";"461";"182";"294";"365";"96";"3";"1";"361";"362"
"43";"Tarragona";"6";"Camp de Tarragona";"36";"Tarragonès";"43012";"Altafulla";"1";"3";"A";"589";"220";"416";"499";"90";"1";"5";"493";"498"
"43";"Tarragona";"6";"Camp de Tarragona";"36";"Tarragonès";"43012";"Altafulla";"1";"3";"B";"611";"255";"425";"520";"91";"2";"3";"515";"518"
"43";"Tarragona";"6";"Camp de Tarragona";"36";"Tarragonès";"43012";"Altafulla";"1";"3";"C";"580";"224";"412";"490";"90";"2";"5";"483";"488"
"43";"Tarragona";"6";"Camp de Tarragona";"8";"Baix Camp";"43015";"Arbolí";"1";"1";"U";"112";"49";"85";"102";"10";"1";"0";"101";"101"
"43";"Tarragona";"6";"Camp de Tarragona";"12";"Baix Penedès";"43016";"Arboç, l'";"1";"1";"A";"544";"203";"342";"425";"119";"1";"2";"422";"424"
"43";"Tarragona";"6";"Camp de Tarragona";"12";"Baix Penedès";"43016";"Arboç, l'";"1";"1";"B";"443";"164";"286";"338";"105";"3";"0";"335";"335"
"43";"Tarragona";"6";"Camp de Tarragona";"12";"Baix Penedès";"43016";"Arboç, l'";"1";"1";"C";"543";"201";"354";"410";"133";"4";"0";"406";"406"
"43";"Tarragona";"6";"Camp de Tarragona";"12";"Baix Penedès";"43016";"Arboç, l'";"1";"2";"A";"589";"219";"391";"486";"103";"5";"4";"477";"481"
"43";"Tarragona";"6";"Camp de Tarragona";"12";"Baix Penedès";"43016";"Arboç, l'";"1";"2";"B";"683";"247";"429";"515";"168";"6";"1";"508";"509"
"43";"Tarragona";"6";"Camp de Tarragona";"12";"Baix Penedès";"43016";"Arboç, l'";"1";"2";"C";"621";"201";"387";"494";"127";"2";"2";"490";"492"
"43";"Tarragona";"6";"Camp de Tarragona";"8";"Baix Camp";"43017";"Argentera, l'";"1";"1";"U";"130";"51";"91";"116";"14";"0";"0";"116";"116"
"43";"Tarragona";"6";"Camp de Tarragona";"12";"Baix Penedès";"43020";"Banyeres del Penedès";"1";"1";"A";"658";"256";"432";"527";"131";"1";"2";"524";"526"
"43";"Tarragona";"6";"Camp de Tarragona";"12";"Baix Penedès";"43020";"Banyeres del Penedès";"1";"1";"B";"658";"264";"436";"540";"118";"5";"2";"533";"535"
"43";"Tarragona";"6";"Camp de Tarragona";"12";"Baix Penedès";"43020";"Banyeres del Penedès";"1";"2";"A";"464";"172";"291";"351";"113";"3";"1";"347";"348"
"43";"Tarragona";"6";"Camp de Tarragona";"12";"Baix Penedès";"43020";"Banyeres del Penedès";"1";"2";"B";"419";"155";"264";"320";"99";"3";"3";"314";"317"
"43";"Tarragona";"6";"Camp de Tarragona";"16";"Conca de Barberà";"43021";"Barberà de la Conca";"1";"1";"U";"358";"140";"238";"281";"77";"1";"1";"279";"280"
"43";"Tarragona";"6";"Camp de Tarragona";"29";"Priorat";"43023";"Bellmunt del Priorat";"1";"1";"U";"231";"96";"157";"192";"39";"0";"3";"189";"192"
"43";"Tarragona";"6";"Camp de Tarragona";"12";"Baix Penedès";"43024";"Bellvei";"1";"1";"A";"573";"215";"341";"406";"167";"5";"2";"399";"401"
"43";"Tarragona";"6";"Camp de Tarragona";"12";"Baix Penedès";"43024";"Bellvei";"1";"1";"B";"410";"163";"260";"316";"94";"1";"1";"314";"315"
"43";"Tarragona";"6";"Camp de Tarragona";"12";"Baix Penedès";"43024";"Bellvei";"1";"1";"C";"539";"226";"345";"438";"101";"1";"3";"434";"437"
"43";"Tarragona";"6";"Camp de Tarragona";"29";"Priorat";"43027";"Bisbal de Falset, la";"1";"1";"U";"168";"71";"122";"146";"22";"0";"3";"143";"146"
"43";"Tarragona";"6";"Camp de Tarragona";"12";"Baix Penedès";"43028";"Bisbal del Penedès, la";"1";"1";"A";"625";"217";"388";"481";"144";"6";"2";"473";"475"
"43";"Tarragona";"6";"Camp de Tarragona";"12";"Baix Penedès";"43028";"Bisbal del Penedès, la";"1";"1";"B";"650";"242";"408";"514";"136";"2";"3";"509";"512"
"43";"Tarragona";"6";"Camp de Tarragona";"12";"Baix Penedès";"43028";"Bisbal del Penedès, la";"1";"2";"A";"736";"194";"396";"481";"255";"5";"3";"473";"476"
"43";"Tarragona";"6";"Camp de Tarragona";"12";"Baix Penedès";"43028";"Bisbal del Penedès, la";"1";"2";"B";"701";"220";"387";"464";"237";"1";"3";"460";"463"
"43";"Tarragona";"6";"Camp de Tarragona";"16";"Conca de Barberà";"43029";"Blancafort";"1";"1";"U";"325";"115";"225";"271";"54";"3";"1";"267";"268"
"43";"Tarragona";"6";"Camp de Tarragona";"12";"Baix Penedès";"43030";"Bonastre";"1";"1";"U";"436";"185";"303";"344";"92";"7";"3";"334";"337"
"43";"Tarragona";"6";"Camp de Tarragona";"8";"Baix Camp";"43031";"Borges del Camp, les";"1";"1";"A";"741";"276";"503";"619";"122";"0";"0";"619";"619"
"43";"Tarragona";"6";"Camp de Tarragona";"8";"Baix Camp";"43031";"Borges del Camp, les";"1";"1";"B";"714";"294";"489";"590";"124";"3";"2";"585";"587"
"43";"Tarragona";"6";"Camp de Tarragona";"8";"Baix Camp";"43033";"Botarell";"1";"1";"U";"780";"268";"506";"633";"147";"0";"5";"628";"633"
"43";"Tarragona";"6";"Camp de Tarragona";"1";"Alt Camp";"43034";"Bràfim";"1";"1";"U";"481";"189";"333";"413";"68";"3";"1";"409";"410"
"43";"Tarragona";"6";"Camp de Tarragona";"29";"Priorat";"43035";"Cabacés";"1";"1";"U";"261";"100";"186";"220";"41";"1";"1";"218";"219"
"43";"Tarragona";"6";"Camp de Tarragona";"1";"Alt Camp";"43036";"Cabra del Camp";"1";"1";"A";"431";"171";"252";"316";"115";"0";"0";"316";"316"
"43";"Tarragona";"6";"Camp de Tarragona";"1";"Alt Camp";"43036";"Cabra del Camp";"1";"1";"B";"398";"166";"242";"290";"108";"0";"1";"289";"290"
"43";"Tarragona";"6";"Camp de Tarragona";"12";"Baix Penedès";"43037";"Calafell";"1";"1";"A";"557";"168";"338";"414";"143";"2";"2";"410";"412"
"43";"Tarragona";"6";"Camp de Tarragona";"12";"Baix Penedès";"43037";"Calafell";"1";"1";"B";"626";"208";"413";"482";"144";"2";"5";"475";"480"
"43";"Tarragona";"6";"Camp de Tarragona";"12";"Baix Penedès";"43037";"Calafell";"1";"1";"C";"702";"225";"452";"551";"151";"6";"2";"543";"545"
"43";"Tarragona";"6";"Camp de Tarragona";"12";"Baix Penedès";"43037";"Calafell";"1";"2";"A";"545";"196";"322";"381";"164";"3";"0";"378";"378"
"43";"Tarragona";"6";"Camp de Tarragona";"12";"Baix Penedès";"43037";"Calafell";"1";"2";"B";"672";"234";"418";"471";"201";"5";"1";"465";"466"
"43";"Tarragona";"6";"Camp de Tarragona";"12";"Baix Penedès";"43037";"Calafell";"1";"2";"C";"665";"232";"398";"473";"192";"5";"0";"468";"468"
"43";"Tarragona";"6";"Camp de Tarragona";"12";"Baix Penedès";"43037";"Calafell";"1";"3";"A";"637";"231";"391";"467";"170";"1";"2";"464";"466"
"43";"Tarragona";"6";"Camp de Tarragona";"12";"Baix Penedès";"43037";"Calafell";"1";"3";"B";"638";"238";"381";"468";"170";"3";"5";"460";"465"
"43";"Tarragona";"6";"Camp de Tarragona";"12";"Baix Penedès";"43037";"Calafell";"2";"1";"A";"455";"139";"269";"336";"119";"4";"5";"327";"332"
"43";"Tarragona";"6";"Camp de Tarragona";"12";"Baix Penedès";"43037";"Calafell";"2";"1";"B";"496";"143";"291";"348";"148";"4";"2";"342";"344"
"43";"Tarragona";"6";"Camp de Tarragona";"12";"Baix Penedès";"43037";"Calafell";"2";"1";"C";"611";"190";"384";"479";"132";"2";"3";"474";"477"
"43";"Tarragona";"6";"Camp de Tarragona";"12";"Baix Penedès";"43037";"Calafell";"2";"2";"A";"487";"177";"305";"360";"127";"1";"0";"359";"359"
"43";"Tarragona";"6";"Camp de Tarragona";"12";"Baix Penedès";"43037";"Calafell";"2";"2";"B";"556";"227";"356";"418";"138";"3";"0";"415";"415"
"43";"Tarragona";"6";"Camp de Tarragona";"12";"Baix Penedès";"43037";"Calafell";"2";"2";"C";"539";"187";"315";"389";"150";"2";"3";"384";"387"
"43";"Tarragona";"6";"Camp de Tarragona";"12";"Baix Penedès";"43037";"Calafell";"2";"3";"U";"756";"240";"421";"503";"253";"4";"2";"497";"499"
"43";"Tarragona";"6";"Camp de Tarragona";"12";"Baix Penedès";"43037";"Calafell";"3";"1";"A";"483";"132";"252";"323";"160";"0";"2";"321";"323"
"43";"Tarragona";"6";"Camp de Tarragona";"12";"Baix Penedès";"43037";"Calafell";"3";"1";"B";"593";"207";"349";"434";"159";"3";"0";"431";"431"
"43";"Tarragona";"6";"Camp de Tarragona";"12";"Baix Penedès";"43037";"Calafell";"3";"1";"C";"591";"199";"327";"416";"175";"2";"3";"411";"414"
"43";"Tarragona";"6";"Camp de Tarragona";"12";"Baix Penedès";"43037";"Calafell";"3";"2";"A";"564";"162";"329";"392";"172";"1";"4";"387";"391"
"43";"Tarragona";"6";"Camp de Tarragona";"12";"Baix Penedès";"43037";"Calafell";"3";"2";"B";"577";"191";"341";"400";"177";"5";"1";"394";"395"
"43";"Tarragona";"6";"Camp de Tarragona";"12";"Baix Penedès";"43037";"Calafell";"3";"2";"C";"615";"201";"353";"438";"177";"5";"2";"431";"433"
"43";"Tarragona";"6";"Camp de Tarragona";"12";"Baix Penedès";"43037";"Calafell";"3";"3";"A";"532";"163";"286";"349";"183";"1";"5";"343";"348"
"43";"Tarragona";"6";"Camp de Tarragona";"12";"Baix Penedès";"43037";"Calafell";"3";"3";"B";"581";"191";"336";"392";"189";"2";"6";"384";"390"
"43";"Tarragona";"6";"Camp de Tarragona";"12";"Baix Penedès";"43037";"Calafell";"3";"3";"C";"575";"193";"335";"391";"184";"2";"1";"388";"389"
"43";"Tarragona";"6";"Camp de Tarragona";"12";"Baix Penedès";"43037";"Calafell";"3";"4";"A";"564";"192";"286";"350";"214";"1";"1";"348";"349"
"43";"Tarragona";"6";"Camp de Tarragona";"12";"Baix Penedès";"43037";"Calafell";"3";"4";"B";"694";"245";"368";"425";"269";"4";"2";"419";"421"
"43";"Tarragona";"6";"Camp de Tarragona";"12";"Baix Penedès";"43037";"Calafell";"3";"4";"C";"650";"233";"348";"416";"234";"4";"2";"410";"412"
"43";"Tarragona";"6";"Camp de Tarragona";"12";"Baix Penedès";"43037";"Calafell";"4";"1";"U";"771";"212";"398";"495";"276";"3";"3";"489";"492"
"43";"Tarragona";"6";"Camp de Tarragona";"8";"Baix Camp";"43038";"Cambrils";"1";"1";"A";"722";"271";"459";"526";"196";"5";"2";"519";"521"
"43";"Tarragona";"6";"Camp de Tarragona";"8";"Baix Camp";"43038";"Cambrils";"1";"1";"B";"754";"267";"458";"531";"223";"6";"1";"524";"525"
"43";"Tarragona";"6";"Camp de Tarragona";"8";"Baix Camp";"43038";"Cambrils";"1";"2";"A";"556";"184";"326";"407";"149";"1";"2";"404";"406"
"43";"Tarragona";"6";"Camp de Tarragona";"8";"Baix Camp";"43038";"Cambrils";"1";"2";"B";"655";"196";"384";"474";"181";"1";"5";"468";"473"
"43";"Tarragona";"6";"Camp de Tarragona";"8";"Baix Camp";"43038";"Cambrils";"1";"2";"C";"648";"198";"380";"488";"160";"5";"2";"481";"483"
"43";"Tarragona";"6";"Camp de Tarragona";"8";"Baix Camp";"43038";"Cambrils";"1";"3";"A";"632";"219";"354";"443";"189";"3";"2";"438";"440"
"43";"Tarragona";"6";"Camp de Tarragona";"8";"Baix Camp";"43038";"Cambrils";"1";"3";"B";"607";"225";"356";"429";"178";"3";"1";"425";"426"
"43";"Tarragona";"6";"Camp de Tarragona";"8";"Baix Camp";"43038";"Cambrils";"1";"3";"C";"627";"238";"367";"458";"169";"0";"0";"458";"458"
"43";"Tarragona";"6";"Camp de Tarragona";"8";"Baix Camp";"43038";"Cambrils";"1";"4";"A";"401";"139";"239";"309";"92";"1";"2";"306";"308"
"43";"Tarragona";"6";"Camp de Tarragona";"8";"Baix Camp";"43038";"Cambrils";"1";"4";"B";"377";"140";"233";"278";"99";"4";"0";"274";"274"
"43";"Tarragona";"6";"Camp de Tarragona";"8";"Baix Camp";"43038";"Cambrils";"1";"5";"A";"594";"215";"384";"483";"111";"2";"5";"476";"481"
"43";"Tarragona";"6";"Camp de Tarragona";"8";"Baix Camp";"43038";"Cambrils";"1";"5";"B";"662";"240";"454";"540";"122";"2";"4";"534";"538"
"43";"Tarragona";"6";"Camp de Tarragona";"8";"Baix Camp";"43038";"Cambrils";"1";"6";"A";"618";"189";"337";"421";"197";"6";"1";"414";"415"
"43";"Tarragona";"6";"Camp de Tarragona";"8";"Baix Camp";"43038";"Cambrils";"1";"6";"B";"577";"222";"339";"409";"168";"2";"3";"404";"407"
"43";"Tarragona";"6";"Camp de Tarragona";"8";"Baix Camp";"43038";"Cambrils";"2";"1";"A";"587";"242";"379";"464";"123";"2";"3";"459";"462"
"43";"Tarragona";"6";"Camp de Tarragona";"8";"Baix Camp";"43038";"Cambrils";"2";"1";"B";"636";"249";"403";"475";"161";"2";"3";"470";"473"
"43";"Tarragona";"6";"Camp de Tarragona";"8";"Baix Camp";"43038";"Cambrils";"2";"10";"A";"454";"167";"293";"351";"103";"2";"1";"348";"349"
"43";"Tarragona";"6";"Camp de Tarragona";"8";"Baix Camp";"43038";"Cambrils";"2";"10";"B";"454";"188";"284";"353";"101";"6";"1";"346";"347"
"43";"Tarragona";"6";"Camp de Tarragona";"8";"Baix Camp";"43038";"Cambrils";"2";"2";"A";"483";"168";"286";"336";"147";"5";"1";"330";"331"
"43";"Tarragona";"6";"Camp de Tarragona";"8";"Baix Camp";"43038";"Cambrils";"2";"2";"B";"557";"211";"340";"408";"149";"3";"3";"402";"405"
"43";"Tarragona";"6";"Camp de Tarragona";"8";"Baix Camp";"43038";"Cambrils";"2";"3";"A";"499";"184";"326";"400";"99";"4";"1";"395";"396"
"43";"Tarragona";"6";"Camp de Tarragona";"8";"Baix Camp";"43038";"Cambrils";"2";"3";"B";"557";"199";"351";"434";"123";"0";"2";"432";"434"
"43";"Tarragona";"6";"Camp de Tarragona";"8";"Baix Camp";"43038";"Cambrils";"2";"3";"C";"570";"197";"361";"440";"130";"1";"0";"439";"439"
"43";"Tarragona";"6";"Camp de Tarragona";"8";"Baix Camp";"43038";"Cambrils";"2";"4";"A";"435";"153";"267";"328";"107";"1";"0";"327";"327"
"43";"Tarragona";"6";"Camp de Tarragona";"8";"Baix Camp";"43038";"Cambrils";"2";"4";"B";"504";"171";"311";"362";"142";"1";"3";"358";"361"
"43";"Tarragona";"6";"Camp de Tarragona";"8";"Baix Camp";"43038";"Cambrils";"2";"5";"A";"646";"228";"384";"483";"163";"2";"1";"480";"481"
"43";"Tarragona";"6";"Camp de Tarragona";"8";"Baix Camp";"43038";"Cambrils";"2";"5";"B";"613";"211";"351";"455";"158";"2";"2";"451";"453"
"43";"Tarragona";"6";"Camp de Tarragona";"8";"Baix Camp";"43038";"Cambrils";"2";"6";"A";"645";"202";"354";"454";"191";"3";"2";"449";"451"
"43";"Tarragona";"6";"Camp de Tarragona";"8";"Baix Camp";"43038";"Cambrils";"2";"6";"B";"619";"141";"312";"412";"207";"3";"1";"408";"409"
"43";"Tarragona";"6";"Camp de Tarragona";"8";"Baix Camp";"43038";"Cambrils";"2";"6";"C";"609";"161";"310";"412";"197";"2";"0";"410";"410"
"43";"Tarragona";"6";"Camp de Tarragona";"8";"Baix Camp";"43038";"Cambrils";"2";"7";"A";"487";"181";"313";"382";"105";"1";"3";"378";"381"
"43";"Tarragona";"6";"Camp de Tarragona";"8";"Baix Camp";"43038";"Cambrils";"2";"7";"B";"560";"213";"371";"460";"100";"0";"2";"458";"460"
"43";"Tarragona";"6";"Camp de Tarragona";"8";"Baix Camp";"43038";"Cambrils";"2";"7";"C";"548";"196";"347";"436";"112";"3";"2";"431";"433"
"43";"Tarragona";"6";"Camp de Tarragona";"8";"Baix Camp";"43038";"Cambrils";"2";"8";"A";"462";"164";"260";"315";"147";"1";"2";"312";"314"
"43";"Tarragona";"6";"Camp de Tarragona";"8";"Baix Camp";"43038";"Cambrils";"2";"8";"B";"407";"147";"246";"290";"117";"3";"3";"284";"287"
"43";"Tarragona";"6";"Camp de Tarragona";"8";"Baix Camp";"43038";"Cambrils";"2";"9";"A";"517";"193";"335";"434";"83";"1";"3";"430";"433"
"43";"Tarragona";"6";"Camp de Tarragona";"8";"Baix Camp";"43038";"Cambrils";"2";"9";"B";"528";"153";"320";"399";"129";"0";"6";"393";"399"
"43";"Tarragona";"6";"Camp de Tarragona";"8";"Baix Camp";"43038";"Cambrils";"2";"9";"C";"511";"174";"346";"422";"89";"1";"5";"416";"421"
"43";"Tarragona";"6";"Camp de Tarragona";"36";"Tarragonès";"43907";"Canonja, la";"1";"1";"A";"550";"201";"362";"440";"110";"1";"0";"439";"439"
"43";"Tarragona";"6";"Camp de Tarragona";"36";"Tarragonès";"43907";"Canonja, la";"1";"1";"B";"626";"233";"415";"500";"126";"3";"2";"495";"497"
"43";"Tarragona";"6";"Camp de Tarragona";"36";"Tarragonès";"43907";"Canonja, la";"1";"2";"A";"579";"199";"356";"457";"122";"2";"1";"454";"455"
"43";"Tarragona";"6";"Camp de Tarragona";"36";"Tarragonès";"43907";"Canonja, la";"1";"2";"B";"542";"202";"349";"419";"123";"1";"2";"416";"418"
"43";"Tarragona";"6";"Camp de Tarragona";"36";"Tarragonès";"43907";"Canonja, la";"1";"3";"A";"457";"170";"284";"363";"94";"0";"3";"360";"363"
"43";"Tarragona";"6";"Camp de Tarragona";"36";"Tarragonès";"43907";"Canonja, la";"1";"3";"B";"439";"169";"283";"352";"87";"0";"1";"351";"352"
"43";"Tarragona";"6";"Camp de Tarragona";"36";"Tarragonès";"43907";"Canonja, la";"1";"4";"A";"580";"203";"346";"428";"152";"2";"0";"426";"426"
"43";"Tarragona";"6";"Camp de Tarragona";"36";"Tarragonès";"43907";"Canonja, la";"1";"4";"B";"570";"210";"338";"422";"148";"1";"3";"418";"421"
"43";"Tarragona";"6";"Camp de Tarragona";"8";"Baix Camp";"43039";"Capafonts";"1";"1";"U";"102";"46";"71";"87";"15";"0";"1";"86";"87"
"43";"Tarragona";"6";"Camp de Tarragona";"29";"Priorat";"43040";"Capçanes";"1";"1";"U";"339";"168";"263";"299";"40";"0";"2";"297";"299"
"43";"Tarragona";"6";"Camp de Tarragona";"8";"Baix Camp";"43042";"Castellvell del Camp";"1";"1";"U";"786";"300";"552";"665";"121";"1";"3";"661";"664"
"43";"Tarragona";"6";"Camp de Tarragona";"8";"Baix Camp";"43042";"Castellvell del Camp";"1";"2";"A";"684";"246";"468";"585";"99";"1";"1";"583";"584"
"43";"Tarragona";"6";"Camp de Tarragona";"8";"Baix Camp";"43042";"Castellvell del Camp";"1";"2";"B";"679";"271";"484";"590";"89";"0";"2";"588";"590"
"43";"Tarragona";"6";"Camp de Tarragona";"36";"Tarragonès";"43043";"Catllar, el";"1";"1";"A";"522";"197";"327";"405";"117";"0";"3";"402";"405"
"43";"Tarragona";"6";"Camp de Tarragona";"36";"Tarragonès";"43043";"Catllar, el";"1";"1";"B";"581";"216";"355";"448";"133";"2";"1";"445";"446"
"43";"Tarragona";"6";"Camp de Tarragona";"36";"Tarragonès";"43043";"Catllar, el";"1";"1";"C";"581";"212";"356";"437";"144";"5";"5";"427";"432"
"43";"Tarragona";"6";"Camp de Tarragona";"36";"Tarragonès";"43043";"Catllar, el";"1";"2";"A";"730";"291";"482";"601";"129";"2";"0";"599";"599"
"43";"Tarragona";"6";"Camp de Tarragona";"36";"Tarragonès";"43043";"Catllar, el";"1";"2";"B";"714";"261";"474";"594";"120";"2";"2";"590";"592"
"43";"Tarragona";"6";"Camp de Tarragona";"8";"Baix Camp";"43045";"Colldejou";"1";"1";"U";"150";"45";"97";"126";"24";"0";"1";"125";"126"
"43";"Tarragona";"6";"Camp de Tarragona";"16";"Conca de Barberà";"43046";"Conesa";"1";"1";"U";"104";"53";"74";"87";"17";"2";"1";"84";"85"
"43";"Tarragona";"6";"Camp de Tarragona";"36";"Tarragonès";"43047";"Constantí";"1";"1";"A";"649";"232";"392";"481";"168";"7";"0";"474";"474"
"43";"Tarragona";"6";"Camp de Tarragona";"36";"Tarragonès";"43047";"Constantí";"1";"1";"B";"711";"232";"446";"552";"159";"2";"2";"548";"550"
"43";"Tarragona";"6";"Camp de Tarragona";"36";"Tarragonès";"43047";"Constantí";"1";"2";"A";"509";"111";"228";"289";"220";"2";"1";"286";"287"
"43";"Tarragona";"6";"Camp de Tarragona";"36";"Tarragonès";"43047";"Constantí";"1";"2";"B";"384";"123";"192";"233";"151";"0";"1";"232";"233"
"43";"Tarragona";"6";"Camp de Tarragona";"36";"Tarragonès";"43047";"Constantí";"2";"1";"A";"572";"180";"342";"438";"134";"4";"2";"432";"434"
"43";"Tarragona";"6";"Camp de Tarragona";"36";"Tarragonès";"43047";"Constantí";"2";"1";"B";"579";"200";"340";"432";"147";"4";"6";"422";"428"
"43";"Tarragona";"6";"Camp de Tarragona";"36";"Tarragonès";"43047";"Constantí";"2";"1";"C";"710";"256";"438";"509";"201";"4";"1";"504";"505"
"43";"Tarragona";"6";"Camp de Tarragona";"29";"Priorat";"43049";"Cornudella de Montsant";"1";"1";"U";"742";"322";"555";"634";"108";"0";"1";"633";"634"
"43";"Tarragona";"6";"Camp de Tarragona";"36";"Tarragonès";"43050";"Creixell";"1";"1";"A";"624";"246";"386";"463";"161";"3";"0";"460";"460"
"43";"Tarragona";"6";"Camp de Tarragona";"36";"Tarragonès";"43050";"Creixell";"1";"1";"B";"645";"274";"419";"484";"161";"6";"3";"475";"478"
"43";"Tarragona";"6";"Camp de Tarragona";"36";"Tarragonès";"43050";"Creixell";"1";"2";"A";"593";"235";"328";"409";"184";"2";"3";"404";"407"
"43";"Tarragona";"6";"Camp de Tarragona";"36";"Tarragonès";"43050";"Creixell";"1";"2";"B";"645";"263";"382";"448";"197";"4";"1";"443";"444"
"43";"Tarragona";"6";"Camp de Tarragona";"12";"Baix Penedès";"43051";"Cunit";"1";"1";"A";"513";"179";"311";"389";"124";"5";"3";"381";"384"
"43";"Tarragona";"6";"Camp de Tarragona";"12";"Baix Penedès";"43051";"Cunit";"1";"1";"B";"658";"258";"410";"495";"163";"8";"1";"486";"487"
"43";"Tarragona";"6";"Camp de Tarragona";"12";"Baix Penedès";"43051";"Cunit";"1";"1";"C";"623";"253";"391";"464";"159";"6";"1";"457";"458"
"43";"Tarragona";"6";"Camp de Tarragona";"12";"Baix Penedès";"43051";"Cunit";"1";"2";"A";"558";"205";"336";"416";"142";"4";"1";"411";"412"
"43";"Tarragona";"6";"Camp de Tarragona";"12";"Baix Penedès";"43051";"Cunit";"1";"2";"B";"586";"195";"360";"432";"154";"7";"3";"422";"425"
"43";"Tarragona";"6";"Camp de Tarragona";"12";"Baix Penedès";"43051";"Cunit";"1";"2";"C";"592";"217";"360";"440";"152";"2";"1";"437";"438"
"43";"Tarragona";"6";"Camp de Tarragona";"12";"Baix Penedès";"43051";"Cunit";"1";"3";"A";"553";"215";"325";"385";"168";"7";"0";"378";"378"
"43";"Tarragona";"6";"Camp de Tarragona";"12";"Baix Penedès";"43051";"Cunit";"1";"3";"B";"572";"220";"315";"395";"177";"6";"0";"389";"389"
"43";"Tarragona";"6";"Camp de Tarragona";"12";"Baix Penedès";"43051";"Cunit";"1";"3";"C";"570";"214";"360";"418";"152";"9";"1";"408";"409"
"43";"Tarragona";"6";"Camp de Tarragona";"12";"Baix Penedès";"43051";"Cunit";"1";"4";"A";"728";"237";"412";"505";"223";"8";"1";"496";"497"
"43";"Tarragona";"6";"Camp de Tarragona";"12";"Baix Penedès";"43051";"Cunit";"1";"4";"B";"695";"212";"380";"460";"235";"6";"0";"454";"454"
"43";"Tarragona";"6";"Camp de Tarragona";"12";"Baix Penedès";"43051";"Cunit";"1";"5";"A";"621";"221";"376";"446";"175";"3";"2";"441";"443"
"43";"Tarragona";"6";"Camp de Tarragona";"12";"Baix Penedès";"43051";"Cunit";"1";"5";"B";"614";"237";"357";"436";"178";"3";"3";"430";"433"
"43";"Tarragona";"6";"Camp de Tarragona";"12";"Baix Penedès";"43051";"Cunit";"1";"5";"C";"643";"244";"377";"475";"168";"2";"0";"473";"473"
"43";"Tarragona";"6";"Camp de Tarragona";"8";"Baix Camp";"43053";"Duesaigües";"1";"1";"U";"192";"76";"139";"169";"23";"0";"0";"169";"169"
"43";"Tarragona";"6";"Camp de Tarragona";"16";"Conca de Barberà";"43054";"Espluga de Francolí, l'";"1";"1";"A";"580";"192";"364";"465";"115";"3";"2";"460";"462"
"43";"Tarragona";"6";"Camp de Tarragona";"16";"Conca de Barberà";"43054";"Espluga de Francolí, l'";"1";"1";"B";"607";"169";"358";"465";"142";"5";"4";"456";"460"
"43";"Tarragona";"6";"Camp de Tarragona";"16";"Conca de Barberà";"43054";"Espluga de Francolí, l'";"1";"1";"C";"472";"177";"298";"390";"82";"2";"2";"386";"388"
"43";"Tarragona";"6";"Camp de Tarragona";"16";"Conca de Barberà";"43054";"Espluga de Francolí, l'";"2";"1";"A";"549";"171";"343";"439";"110";"1";"3";"435";"438"
"43";"Tarragona";"6";"Camp de Tarragona";"16";"Conca de Barberà";"43054";"Espluga de Francolí, l'";"2";"1";"B";"622";"208";"365";"504";"118";"2";"3";"499";"502"
"43";"Tarragona";"6";"Camp de Tarragona";"29";"Priorat";"43055";"Falset";"1";"1";"A";"395";"158";"281";"331";"64";"0";"1";"330";"331"
"43";"Tarragona";"6";"Camp de Tarragona";"29";"Priorat";"43055";"Falset";"1";"1";"B";"407";"161";"274";"330";"77";"4";"3";"323";"326"
"43";"Tarragona";"6";"Camp de Tarragona";"29";"Priorat";"43055";"Falset";"2";"1";"A";"588";"211";"401";"515";"73";"0";"4";"511";"515"
"43";"Tarragona";"6";"Camp de Tarragona";"29";"Priorat";"43055";"Falset";"2";"1";"B";"580";"230";"395";"496";"84";"0";"3";"493";"496"
"43";"Tarragona";"6";"Camp de Tarragona";"8";"Baix Camp";"43057";"Febró, la";"1";"1";"U";"40";"12";"24";"31";"9";"0";"0";"31";"31"
"43";"Tarragona";"6";"Camp de Tarragona";"29";"Priorat";"43058";"Figuera, la";"1";"1";"U";"95";"31";"55";"81";"14";"1";"0";"80";"80"
"43";"Tarragona";"6";"Camp de Tarragona";"1";"Alt Camp";"43059";"Figuerola del Camp";"1";"1";"U";"251";"98";"183";"221";"30";"1";"3";"217";"220"
"43";"Tarragona";"6";"Camp de Tarragona";"16";"Conca de Barberà";"43061";"Forès";"1";"1";"U";"48";"19";"32";"37";"11";"1";"0";"36";"36"
"43";"Tarragona";"6";"Camp de Tarragona";"1";"Alt Camp";"43066";"Garidells, els";"1";"1";"U";"154";"43";"101";"126";"28";"0";"2";"124";"126"
"43";"Tarragona";"6";"Camp de Tarragona";"29";"Priorat";"43069";"Gratallops";"1";"1";"U";"183";"71";"122";"163";"20";"0";"1";"162";"163"
"43";"Tarragona";"6";"Camp de Tarragona";"29";"Priorat";"43070";"Guiamets, els";"1";"1";"U";"238";"108";"182";"218";"20";"1";"0";"217";"217"
"43";"Tarragona";"6";"Camp de Tarragona";"29";"Priorat";"43072";"Lloar, el";"1";"1";"U";"105";"31";"69";"88";"17";"0";"0";"88";"88"
"43";"Tarragona";"6";"Camp de Tarragona";"16";"Conca de Barberà";"43073";"Llorac";"1";"1";"U";"86";"28";"48";"67";"19";"0";"1";"66";"67"
"43";"Tarragona";"6";"Camp de Tarragona";"12";"Baix Penedès";"43074";"Llorenç del Penedès";"1";"1";"A";"534";"218";"361";"425";"109";"0";"1";"424";"425"
"43";"Tarragona";"6";"Camp de Tarragona";"12";"Baix Penedès";"43074";"Llorenç del Penedès";"1";"1";"B";"553";"206";"346";"427";"126";"4";"5";"418";"423"
"43";"Tarragona";"6";"Camp de Tarragona";"12";"Baix Penedès";"43074";"Llorenç del Penedès";"1";"1";"C";"657";"224";"425";"540";"117";"4";"1";"535";"536"
"43";"Tarragona";"6";"Camp de Tarragona";"29";"Priorat";"43075";"Margalef";"1";"1";"U";"91";"48";"60";"71";"20";"0";"2";"69";"71"
"43";"Tarragona";"6";"Camp de Tarragona";"29";"Priorat";"43076";"Marçà";"1";"1";"U";"444";"190";"306";"367";"77";"0";"5";"362";"367"
"43";"Tarragona";"6";"Camp de Tarragona";"12";"Baix Penedès";"43079";"Masllorenç";"1";"1";"U";"364";"169";"248";"287";"77";"2";"2";"283";"285"
"43";"Tarragona";"6";"Camp de Tarragona";"8";"Baix Camp";"43081";"Maspujols";"1";"1";"U";"597";"220";"450";"486";"111";"3";"4";"479";"483"
"43";"Tarragona";"6";"Camp de Tarragona";"29";"Priorat";"43082";"Masroig, el";"1";"1";"U";"370";"162";"274";"327";"43";"1";"3";"323";"326"
"43";"Tarragona";"6";"Camp de Tarragona";"1";"Alt Camp";"43080";"Masó, la";"1";"1";"U";"243";"133";"187";"217";"26";"0";"4";"213";"217"
"43";"Tarragona";"6";"Camp de Tarragona";"1";"Alt Camp";"43083";"Milà, el";"1";"1";"U";"142";"54";"86";"120";"22";"0";"3";"117";"120"
"43";"Tarragona";"6";"Camp de Tarragona";"29";"Priorat";"43085";"Molar, el";"1";"1";"U";"227";"102";"171";"196";"31";"2";"1";"193";"194"
"43";"Tarragona";"6";"Camp de Tarragona";"1";"Alt Camp";"43091";"Mont-ral";"1";"1";"U";"137";"50";"88";"111";"26";"1";"0";"110";"110"
"43";"Tarragona";"6";"Camp de Tarragona";"8";"Baix Camp";"43092";"Mont-roig del Camp";"1";"1";"A";"581";"187";"377";"461";"120";"2";"1";"458";"459"
"43";"Tarragona";"6";"Camp de Tarragona";"8";"Baix Camp";"43092";"Mont-roig del Camp";"1";"1";"B";"558";"198";"365";"436";"122";"2";"2";"432";"434"
"43";"Tarragona";"6";"Camp de Tarragona";"8";"Baix Camp";"43092";"Mont-roig del Camp";"1";"2";"U";"612";"253";"387";"451";"161";"1";"2";"448";"450"
"43";"Tarragona";"6";"Camp de Tarragona";"8";"Baix Camp";"43092";"Mont-roig del Camp";"1";"3";"A";"460";"154";"285";"372";"88";"1";"1";"370";"371"
"43";"Tarragona";"6";"Camp de Tarragona";"8";"Baix Camp";"43092";"Mont-roig del Camp";"1";"3";"B";"477";"169";"324";"391";"86";"3";"1";"387";"388"
"43";"Tarragona";"6";"Camp de Tarragona";"8";"Baix Camp";"43092";"Mont-roig del Camp";"1";"4";"U";"572";"185";"296";"377";"195";"1";"2";"374";"376"
"43";"Tarragona";"6";"Camp de Tarragona";"8";"Baix Camp";"43092";"Mont-roig del Camp";"1";"5";"A";"567";"208";"333";"412";"155";"2";"4";"406";"410"
"43";"Tarragona";"6";"Camp de Tarragona";"8";"Baix Camp";"43092";"Mont-roig del Camp";"1";"5";"B";"563";"183";"334";"404";"159";"2";"2";"400";"402"
"43";"Tarragona";"6";"Camp de Tarragona";"8";"Baix Camp";"43092";"Mont-roig del Camp";"1";"6";"A";"406";"139";"233";"275";"131";"0";"1";"274";"275"
"43";"Tarragona";"6";"Camp de Tarragona";"8";"Baix Camp";"43092";"Mont-roig del Camp";"1";"6";"B";"441";"154";"255";"303";"138";"1";"0";"302";"302"
"43";"Tarragona";"6";"Camp de Tarragona";"8";"Baix Camp";"43092";"Mont-roig del Camp";"1";"7";"A";"417";"148";"236";"282";"135";"0";"2";"280";"282"
"43";"Tarragona";"6";"Camp de Tarragona";"8";"Baix Camp";"43092";"Mont-roig del Camp";"1";"7";"B";"435";"139";"230";"291";"144";"1";"3";"287";"290"
"43";"Tarragona";"6";"Camp de Tarragona";"8";"Baix Camp";"43092";"Mont-roig del Camp";"1";"8";"A";"450";"154";"223";"278";"172";"2";"0";"276";"276"
"43";"Tarragona";"6";"Camp de Tarragona";"8";"Baix Camp";"43092";"Mont-roig del Camp";"1";"8";"B";"503";"163";"259";"315";"188";"1";"0";"314";"314"
"43";"Tarragona";"6";"Camp de Tarragona";"16";"Conca de Barberà";"43086";"Montblanc";"1";"1";"U";"494";"174";"306";"382";"112";"4";"1";"377";"378"
"43";"Tarragona";"6";"Camp de Tarragona";"16";"Conca de Barberà";"43086";"Montblanc";"1";"2";"U";"501";"175";"288";"370";"131";"1";"3";"366";"369"
"43";"Tarragona";"6";"Camp de Tarragona";"16";"Conca de Barberà";"43086";"Montblanc";"2";"1";"A";"699";"254";"457";"568";"131";"2";"2";"564";"566"
"43";"Tarragona";"6";"Camp de Tarragona";"16";"Conca de Barberà";"43086";"Montblanc";"2";"1";"B";"704";"265";"446";"574";"130";"6";"1";"567";"568"
"43";"Tarragona";"6";"Camp de Tarragona";"16";"Conca de Barberà";"43086";"Montblanc";"2";"2";"A";"581";"210";"376";"471";"110";"2";"1";"468";"469"
"43";"Tarragona";"6";"Camp de Tarragona";"16";"Conca de Barberà";"43086";"Montblanc";"2";"2";"B";"582";"196";"353";"443";"139";"1";"2";"440";"442"
"43";"Tarragona";"6";"Camp de Tarragona";"16";"Conca de Barberà";"43086";"Montblanc";"2";"2";"C";"611";"212";"384";"474";"137";"5";"2";"467";"469"
"43";"Tarragona";"6";"Camp de Tarragona";"16";"Conca de Barberà";"43086";"Montblanc";"2";"3";"A";"484";"173";"345";"416";"68";"2";"1";"413";"414"
"43";"Tarragona";"6";"Camp de Tarragona";"16";"Conca de Barberà";"43086";"Montblanc";"2";"3";"B";"569";"204";"373";"474";"95";"1";"6";"467";"473"
"43";"Tarragona";"6";"Camp de Tarragona";"8";"Baix Camp";"43088";"Montbrió del Camp";"1";"1";"A";"690";"264";"466";"563";"127";"1";"4";"558";"562"
"43";"Tarragona";"6";"Camp de Tarragona";"8";"Baix Camp";"43088";"Montbrió del Camp";"1";"1";"B";"589";"231";"379";"452";"137";"4";"2";"446";"448"
"43";"Tarragona";"6";"Camp de Tarragona";"8";"Baix Camp";"43088";"Montbrió del Camp";"1";"1";"C";"683";"236";"431";"544";"139";"1";"4";"539";"543"
"43";"Tarragona";"6";"Camp de Tarragona";"1";"Alt Camp";"43089";"Montferri";"1";"1";"U";"279";"110";"185";"222";"57";"0";"0";"222";"222"
"43";"Tarragona";"6";"Camp de Tarragona";"12";"Baix Penedès";"43090";"Montmell, el";"1";"1";"A";"542";"190";"302";"353";"189";"2";"2";"349";"351"
"43";"Tarragona";"6";"Camp de Tarragona";"12";"Baix Penedès";"43090";"Montmell, el";"1";"1";"B";"533";"176";"297";"355";"178";"1";"4";"350";"354"
"43";"Tarragona";"6";"Camp de Tarragona";"36";"Tarragonès";"43095";"Morell, el";"1";"1";"A";"691";"271";"457";"525";"166";"2";"0";"523";"523"
"43";"Tarragona";"6";"Camp de Tarragona";"36";"Tarragonès";"43095";"Morell, el";"1";"1";"B";"726";"267";"464";"537";"189";"2";"3";"532";"535"
"43";"Tarragona";"6";"Camp de Tarragona";"36";"Tarragonès";"43095";"Morell, el";"1";"2";"A";"527";"170";"349";"434";"93";"2";"2";"430";"432"
"43";"Tarragona";"6";"Camp de Tarragona";"36";"Tarragonès";"43095";"Morell, el";"1";"2";"B";"524";"223";"382";"445";"79";"3";"1";"441";"442"
"43";"Tarragona";"6";"Camp de Tarragona";"29";"Priorat";"43096";"Morera de Montsant, la";"1";"1";"U";"98";"35";"66";"83";"15";"0";"0";"83";"83"
"43";"Tarragona";"6";"Camp de Tarragona";"36";"Tarragonès";"43097";"Nou de Gaià, la";"1";"1";"U";"386";"150";"294";"326";"60";"1";"1";"324";"325"
"43";"Tarragona";"6";"Camp de Tarragona";"1";"Alt Camp";"43098";"Nulles";"1";"1";"U";"337";"152";"235";"284";"53";"2";"2";"280";"282"
"43";"Tarragona";"6";"Camp de Tarragona";"36";"Tarragonès";"43100";"Pallaresos, els";"1";"1";"A";"547";"233";"373";"468";"79";"6";"2";"460";"462"
"43";"Tarragona";"6";"Camp de Tarragona";"36";"Tarragonès";"43100";"Pallaresos, els";"1";"1";"B";"615";"239";"425";"527";"88";"3";"4";"520";"524"
"43";"Tarragona";"6";"Camp de Tarragona";"36";"Tarragonès";"43100";"Pallaresos, els";"1";"2";"A";"562";"199";"366";"468";"94";"2";"2";"464";"466"
"43";"Tarragona";"6";"Camp de Tarragona";"36";"Tarragonès";"43100";"Pallaresos, els";"1";"2";"B";"618";"219";"404";"516";"102";"2";"2";"512";"514"
"43";"Tarragona";"6";"Camp de Tarragona";"36";"Tarragonès";"43100";"Pallaresos, els";"1";"3";"A";"420";"148";"253";"312";"108";"2";"4";"306";"310"
"43";"Tarragona";"6";"Camp de Tarragona";"36";"Tarragonès";"43100";"Pallaresos, els";"1";"3";"B";"488";"175";"278";"359";"129";"1";"1";"357";"358"
"43";"Tarragona";"6";"Camp de Tarragona";"16";"Conca de Barberà";"43101";"Passanant i Belltall";"1";"1";"U";"149";"77";"125";"137";"12";"0";"0";"137";"137"
"43";"Tarragona";"6";"Camp de Tarragona";"36";"Tarragonès";"43103";"Perafort";"1";"1";"A";"415";"160";"280";"328";"87";"0";"3";"325";"328"
"43";"Tarragona";"6";"Camp de Tarragona";"36";"Tarragonès";"43103";"Perafort";"1";"1";"B";"480";"187";"306";"382";"98";"0";"2";"380";"382"
"43";"Tarragona";"6";"Camp de Tarragona";"16";"Conca de Barberà";"43105";"Piles, les";"1";"1";"U";"165";"77";"123";"140";"25";"0";"2";"138";"140"
"43";"Tarragona";"6";"Camp de Tarragona";"16";"Conca de Barberà";"43107";"Pira";"1";"1";"U";"371";"140";"246";"304";"67";"6";"2";"296";"298"
"43";"Tarragona";"6";"Camp de Tarragona";"1";"Alt Camp";"43108";"Pla de Santa Maria, el";"1";"1";"A";"633";"250";"436";"534";"99";"2";"2";"530";"532"
"43";"Tarragona";"6";"Camp de Tarragona";"1";"Alt Camp";"43108";"Pla de Santa Maria, el";"1";"1";"B";"521";"213";"332";"414";"107";"4";"2";"408";"410"
"43";"Tarragona";"6";"Camp de Tarragona";"1";"Alt Camp";"43108";"Pla de Santa Maria, el";"1";"1";"C";"624";"240";"420";"506";"118";"5";"5";"496";"501"
"43";"Tarragona";"6";"Camp de Tarragona";"36";"Tarragonès";"43109";"Pobla de Mafumet, la";"1";"1";"A";"581";"202";"356";"430";"151";"2";"1";"427";"428"
"43";"Tarragona";"6";"Camp de Tarragona";"36";"Tarragonès";"43109";"Pobla de Mafumet, la";"1";"1";"B";"659";"211";"374";"478";"181";"4";"1";"473";"474"
"43";"Tarragona";"6";"Camp de Tarragona";"36";"Tarragonès";"43109";"Pobla de Mafumet, la";"1";"1";"C";"639";"222";"394";"476";"163";"3";"4";"469";"473"
"43";"Tarragona";"6";"Camp de Tarragona";"36";"Tarragonès";"43109";"Pobla de Mafumet, la";"1";"2";"U";"673";"196";"386";"486";"187";"3";"2";"481";"483"
"43";"Tarragona";"6";"Camp de Tarragona";"36";"Tarragonès";"43111";"Pobla de Montornès, la";"1";"1";"U";"786";"309";"502";"611";"175";"5";"3";"603";"606"
"43";"Tarragona";"6";"Camp de Tarragona";"36";"Tarragonès";"43111";"Pobla de Montornès, la";"1";"2";"A";"648";"228";"373";"455";"193";"2";"0";"453";"453"
"43";"Tarragona";"6";"Camp de Tarragona";"36";"Tarragonès";"43111";"Pobla de Montornès, la";"1";"2";"B";"617";"253";"373";"448";"169";"3";"0";"445";"445"
"43";"Tarragona";"6";"Camp de Tarragona";"29";"Priorat";"43112";"Poboleda";"1";"1";"U";"283";"118";"193";"242";"41";"0";"3";"239";"242"
"43";"Tarragona";"6";"Camp de Tarragona";"1";"Alt Camp";"43113";"Pont d'Armentera, el";"1";"1";"U";"410";"157";"272";"334";"76";"0";"3";"331";"334"
"43";"Tarragona";"6";"Camp de Tarragona";"16";"Conca de Barberà";"43141";"Pontils";"1";"1";"U";"112";"59";"80";"92";"20";"2";"1";"89";"90"
"43";"Tarragona";"6";"Camp de Tarragona";"29";"Priorat";"43114";"Porrera";"1";"1";"U";"385";"116";"230";"307";"78";"0";"1";"306";"307"
"43";"Tarragona";"6";"Camp de Tarragona";"29";"Priorat";"43115";"Pradell de la Teixeta";"1";"1";"U";"154";"69";"106";"134";"20";"0";"2";"132";"134"
"43";"Tarragona";"6";"Camp de Tarragona";"8";"Baix Camp";"43116";"Prades";"1";"1";"U";"457";"218";"335";"394";"63";"3";"3";"388";"391"
"43";"Tarragona";"6";"Camp de Tarragona";"8";"Baix Camp";"43118";"Pratdip";"1";"1";"U";"413";"167";"304";"354";"59";"1";"1";"352";"353"
"43";"Tarragona";"6";"Camp de Tarragona";"1";"Alt Camp";"43119";"Puigpelat";"1";"1";"U";"788";"235";"501";"605";"183";"4";"3";"598";"601"
"43";"Tarragona";"6";"Camp de Tarragona";"1";"Alt Camp";"43120";"Querol";"1";"1";"U";"453";"169";"254";"328";"125";"1";"1";"326";"327"
"43";"Tarragona";"6";"Camp de Tarragona";"36";"Tarragonès";"43122";"Renau";"1";"1";"U";"104";"37";"60";"87";"17";"0";"0";"87";"87"
"43";"Tarragona";"6";"Camp de Tarragona";"8";"Baix Camp";"43123";"Reus";"1";"1";"U";"753";"237";"437";"516";"237";"0";"3";"513";"516"
"43";"Tarragona";"6";"Camp de Tarragona";"8";"Baix Camp";"43123";"Reus";"1";"2";"A";"617";"227";"405";"490";"127";"1";"3";"486";"489"
"43";"Tarragona";"6";"Camp de Tarragona";"8";"Baix Camp";"43123";"Reus";"1";"2";"B";"667";"271";"464";"535";"132";"2";"1";"532";"533"
"43";"Tarragona";"6";"Camp de Tarragona";"8";"Baix Camp";"43123";"Reus";"1";"3";"A";"530";"216";"354";"427";"103";"2";"3";"422";"425"
"43";"Tarragona";"6";"Camp de Tarragona";"8";"Baix Camp";"43123";"Reus";"1";"3";"B";"512";"189";"317";"391";"121";"2";"2";"387";"389"
"43";"Tarragona";"6";"Camp de Tarragona";"8";"Baix Camp";"43123";"Reus";"10";"1";"A";"502";"164";"301";"395";"107";"0";"3";"392";"395"
"43";"Tarragona";"6";"Camp de Tarragona";"8";"Baix Camp";"43123";"Reus";"10";"1";"B";"575";"195";"352";"462";"113";"0";"3";"459";"462"
"43";"Tarragona";"6";"Camp de Tarragona";"8";"Baix Camp";"43123";"Reus";"10";"1";"C";"584";"200";"355";"450";"134";"1";"3";"446";"449"
"43";"Tarragona";"6";"Camp de Tarragona";"8";"Baix Camp";"43123";"Reus";"2";"1";"U";"533";"277";"306";"355";"178";"0";"0";"355";"355"
"43";"Tarragona";"6";"Camp de Tarragona";"8";"Baix Camp";"43123";"Reus";"2";"10";"A";"733";"250";"453";"571";"162";"1";"0";"570";"570"
"43";"Tarragona";"6";"Camp de Tarragona";"8";"Baix Camp";"43123";"Reus";"2";"10";"B";"769";"281";"464";"598";"171";"1";"1";"596";"597"
"43";"Tarragona";"6";"Camp de Tarragona";"8";"Baix Camp";"43123";"Reus";"2";"11";"U";"684";"247";"407";"477";"207";"2";"3";"472";"475"
"43";"Tarragona";"6";"Camp de Tarragona";"8";"Baix Camp";"43123";"Reus";"2";"12";"A";"466";"167";"273";"363";"103";"1";"1";"361";"362"
"43";"Tarragona";"6";"Camp de Tarragona";"8";"Baix Camp";"43123";"Reus";"2";"12";"B";"541";"184";"324";"432";"109";"0";"2";"430";"432"
"43";"Tarragona";"6";"Camp de Tarragona";"8";"Baix Camp";"43123";"Reus";"2";"13";"A";"415";"161";"256";"317";"98";"1";"1";"315";"316"
"43";"Tarragona";"6";"Camp de Tarragona";"8";"Baix Camp";"43123";"Reus";"2";"13";"B";"405";"144";"250";"313";"92";"0";"0";"313";"313"
"43";"Tarragona";"6";"Camp de Tarragona";"8";"Baix Camp";"43123";"Reus";"2";"14";"U";"562";"270";"401";"470";"92";"0";"3";"467";"470"
"43";"Tarragona";"6";"Camp de Tarragona";"8";"Baix Camp";"43123";"Reus";"2";"15";"U";"732";"299";"522";"639";"93";"3";"4";"632";"636"
"43";"Tarragona";"6";"Camp de Tarragona";"8";"Baix Camp";"43123";"Reus";"2";"2";"A";"678";"189";"398";"544";"134";"2";"5";"537";"542"
"43";"Tarragona";"6";"Camp de Tarragona";"8";"Baix Camp";"43123";"Reus";"2";"2";"B";"727";"236";"454";"493";"234";"2";"7";"484";"491"
"43";"Tarragona";"6";"Camp de Tarragona";"8";"Baix Camp";"43123";"Reus";"2";"3";"U";"783";"348";"529";"628";"155";"0";"3";"625";"628"
"43";"Tarragona";"6";"Camp de Tarragona";"8";"Baix Camp";"43123";"Reus";"2";"4";"A";"536";"213";"310";"384";"152";"1";"2";"381";"383"
"43";"Tarragona";"6";"Camp de Tarragona";"8";"Baix Camp";"43123";"Reus";"2";"4";"B";"541";"217";"325";"386";"155";"2";"1";"383";"384"
"43";"Tarragona";"6";"Camp de Tarragona";"8";"Baix Camp";"43123";"Reus";"2";"6";"A";"738";"296";"480";"585";"153";"6";"6";"573";"579"
"43";"Tarragona";"6";"Camp de Tarragona";"8";"Baix Camp";"43123";"Reus";"2";"6";"B";"766";"270";"485";"586";"180";"4";"5";"577";"582"
"43";"Tarragona";"6";"Camp de Tarragona";"8";"Baix Camp";"43123";"Reus";"2";"7";"A";"563";"197";"348";"441";"122";"4";"4";"433";"437"
"43";"Tarragona";"6";"Camp de Tarragona";"8";"Baix Camp";"43123";"Reus";"2";"7";"B";"626";"259";"420";"503";"123";"4";"1";"498";"499"
"43";"Tarragona";"6";"Camp de Tarragona";"8";"Baix Camp";"43123";"Reus";"2";"8";"U";"725";"261";"432";"536";"189";"3";"1";"532";"533"
"43";"Tarragona";"6";"Camp de Tarragona";"8";"Baix Camp";"43123";"Reus";"2";"9";"U";"730";"315";"518";"623";"107";"1";"3";"619";"622"
"43";"Tarragona";"6";"Camp de Tarragona";"8";"Baix Camp";"43123";"Reus";"3";"1";"U";"771";"248";"442";"540";"231";"3";"2";"535";"537"
"43";"Tarragona";"6";"Camp de Tarragona";"8";"Baix Camp";"43123";"Reus";"3";"10";"A";"528";"180";"292";"364";"164";"0";"4";"360";"364"
"43";"Tarragona";"6";"Camp de Tarragona";"8";"Baix Camp";"43123";"Reus";"3";"10";"B";"530";"195";"303";"378";"152";"0";"3";"375";"378"
"43";"Tarragona";"6";"Camp de Tarragona";"8";"Baix Camp";"43123";"Reus";"3";"11";"A";"488";"189";"284";"357";"131";"1";"0";"356";"356"
"43";"Tarragona";"6";"Camp de Tarragona";"8";"Baix Camp";"43123";"Reus";"3";"11";"B";"585";"216";"356";"447";"138";"0";"2";"445";"447"
"43";"Tarragona";"6";"Camp de Tarragona";"8";"Baix Camp";"43123";"Reus";"3";"11";"C";"576";"209";"346";"441";"135";"1";"1";"439";"440"
"43";"Tarragona";"6";"Camp de Tarragona";"8";"Baix Camp";"43123";"Reus";"3";"12";"A";"426";"154";"253";"309";"117";"2";"0";"307";"307"
"43";"Tarragona";"6";"Camp de Tarragona";"8";"Baix Camp";"43123";"Reus";"3";"12";"B";"449";"181";"268";"331";"118";"2";"1";"328";"329"
"43";"Tarragona";"6";"Camp de Tarragona";"8";"Baix Camp";"43123";"Reus";"3";"13";"A";"438";"176";"280";"333";"105";"2";"1";"330";"331"
"43";"Tarragona";"6";"Camp de Tarragona";"8";"Baix Camp";"43123";"Reus";"3";"13";"B";"492";"189";"307";"374";"118";"2";"0";"372";"372"
"43";"Tarragona";"6";"Camp de Tarragona";"8";"Baix Camp";"43123";"Reus";"3";"3";"U";"749";"298";"458";"546";"203";"4";"1";"541";"542"
"43";"Tarragona";"6";"Camp de Tarragona";"8";"Baix Camp";"43123";"Reus";"3";"4";"A";"472";"153";"283";"356";"116";"3";"0";"353";"353"
"43";"Tarragona";"6";"Camp de Tarragona";"8";"Baix Camp";"43123";"Reus";"3";"4";"B";"530";"212";"344";"422";"108";"3";"2";"417";"419"
"43";"Tarragona";"6";"Camp de Tarragona";"8";"Baix Camp";"43123";"Reus";"3";"5";"A";"473";"164";"259";"305";"168";"0";"2";"303";"305"
"43";"Tarragona";"6";"Camp de Tarragona";"8";"Baix Camp";"43123";"Reus";"3";"5";"B";"464";"146";"251";"300";"164";"2";"1";"297";"298"
"43";"Tarragona";"6";"Camp de Tarragona";"8";"Baix Camp";"43123";"Reus";"3";"7";"A";"555";"178";"314";"396";"159";"0";"5";"391";"396"
"43";"Tarragona";"6";"Camp de Tarragona";"8";"Baix Camp";"43123";"Reus";"3";"7";"B";"581";"221";"375";"469";"112";"1";"2";"466";"468"
"43";"Tarragona";"6";"Camp de Tarragona";"8";"Baix Camp";"43123";"Reus";"3";"8";"A";"576";"223";"369";"436";"140";"2";"0";"434";"434"
"43";"Tarragona";"6";"Camp de Tarragona";"8";"Baix Camp";"43123";"Reus";"3";"8";"B";"644";"297";"416";"500";"144";"3";"2";"495";"497"
"43";"Tarragona";"6";"Camp de Tarragona";"8";"Baix Camp";"43123";"Reus";"3";"9";"U";"749";"253";"432";"521";"228";"3";"3";"515";"518"
"43";"Tarragona";"6";"Camp de Tarragona";"8";"Baix Camp";"43123";"Reus";"4";"2";"A";"478";"175";"274";"343";"135";"1";"1";"341";"342"
"43";"Tarragona";"6";"Camp de Tarragona";"8";"Baix Camp";"43123";"Reus";"4";"2";"B";"505";"209";"331";"386";"119";"1";"2";"383";"385"
"43";"Tarragona";"6";"Camp de Tarragona";"8";"Baix Camp";"43123";"Reus";"4";"3";"A";"675";"256";"410";"496";"179";"3";"6";"487";"493"
"43";"Tarragona";"6";"Camp de Tarragona";"8";"Baix Camp";"43123";"Reus";"4";"3";"B";"671";"216";"402";"481";"190";"4";"4";"473";"477"
"43";"Tarragona";"6";"Camp de Tarragona";"8";"Baix Camp";"43123";"Reus";"4";"4";"A";"456";"150";"244";"313";"143";"1";"3";"309";"312"
"43";"Tarragona";"6";"Camp de Tarragona";"8";"Baix Camp";"43123";"Reus";"4";"4";"B";"531";"206";"311";"394";"137";"0";"1";"393";"394"
"43";"Tarragona";"6";"Camp de Tarragona";"8";"Baix Camp";"43123";"Reus";"4";"5";"U";"625";"209";"381";"498";"127";"2";"3";"493";"496"
"43";"Tarragona";"6";"Camp de Tarragona";"8";"Baix Camp";"43123";"Reus";"4";"7";"A";"443";"158";"254";"307";"136";"7";"0";"300";"300"
"43";"Tarragona";"6";"Camp de Tarragona";"8";"Baix Camp";"43123";"Reus";"4";"7";"B";"534";"186";"306";"391";"143";"2";"3";"386";"389"
"43";"Tarragona";"6";"Camp de Tarragona";"8";"Baix Camp";"43123";"Reus";"4";"8";"A";"546";"195";"320";"393";"153";"1";"3";"389";"392"
"43";"Tarragona";"6";"Camp de Tarragona";"8";"Baix Camp";"43123";"Reus";"4";"8";"B";"552";"112";"321";"406";"146";"2";"2";"402";"404"
"43";"Tarragona";"6";"Camp de Tarragona";"8";"Baix Camp";"43123";"Reus";"5";"1";"A";"578";"220";"383";"431";"147";"5";"5";"421";"426"
"43";"Tarragona";"6";"Camp de Tarragona";"8";"Baix Camp";"43123";"Reus";"5";"1";"B";"643";"231";"350";"475";"168";"3";"3";"469";"472"
"43";"Tarragona";"6";"Camp de Tarragona";"8";"Baix Camp";"43123";"Reus";"5";"2";"A";"781";"274";"490";"614";"167";"4";"1";"609";"610"
"43";"Tarragona";"6";"Camp de Tarragona";"8";"Baix Camp";"43123";"Reus";"5";"2";"B";"719";"275";"461";"564";"155";"1";"4";"559";"563"
"43";"Tarragona";"6";"Camp de Tarragona";"8";"Baix Camp";"43123";"Reus";"5";"3";"U";"602";"253";"350";"407";"195";"4";"2";"401";"403"
"43";"Tarragona";"6";"Camp de Tarragona";"8";"Baix Camp";"43123";"Reus";"5";"4";"A";"621";"236";"413";"490";"131";"8";"2";"480";"482"
"43";"Tarragona";"6";"Camp de Tarragona";"8";"Baix Camp";"43123";"Reus";"5";"4";"B";"675";"256";"423";"526";"149";"8";"4";"514";"518"
"43";"Tarragona";"6";"Camp de Tarragona";"8";"Baix Camp";"43123";"Reus";"5";"5";"A";"514";"171";"273";"338";"176";"5";"2";"331";"333"
"43";"Tarragona";"6";"Camp de Tarragona";"8";"Baix Camp";"43123";"Reus";"5";"5";"B";"548";"190";"315";"362";"186";"1";"3";"358";"361"
"43";"Tarragona";"6";"Camp de Tarragona";"8";"Baix Camp";"43123";"Reus";"5";"7";"A";"538";"220";"357";"423";"115";"1";"3";"419";"422"
"43";"Tarragona";"6";"Camp de Tarragona";"8";"Baix Camp";"43123";"Reus";"5";"7";"B";"515";"224";"342";"405";"110";"0";"3";"402";"405"
"43";"Tarragona";"6";"Camp de Tarragona";"8";"Baix Camp";"43123";"Reus";"6";"1";"U";"658";"241";"415";"491";"167";"2";"2";"487";"489"
"43";"Tarragona";"6";"Camp de Tarragona";"8";"Baix Camp";"43123";"Reus";"6";"11";"A";"616";"292";"440";"528";"88";"1";"3";"524";"527"
"43";"Tarragona";"6";"Camp de Tarragona";"8";"Baix Camp";"43123";"Reus";"6";"11";"B";"694";"280";"487";"609";"85";"1";"6";"602";"608"
"43";"Tarragona";"6";"Camp de Tarragona";"8";"Baix Camp";"43123";"Reus";"6";"12";"A";"464";"78";"316";"379";"85";"0";"4";"375";"379"
"43";"Tarragona";"6";"Camp de Tarragona";"8";"Baix Camp";"43123";"Reus";"6";"12";"B";"422";"170";"276";"357";"65";"1";"1";"355";"356"
"43";"Tarragona";"6";"Camp de Tarragona";"8";"Baix Camp";"43123";"Reus";"6";"13";"U";"647";"231";"443";"506";"141";"4";"1";"501";"502"
"43";"Tarragona";"6";"Camp de Tarragona";"8";"Baix Camp";"43123";"Reus";"6";"2";"A";"501";"170";"340";"432";"69";"4";"0";"428";"428"
"43";"Tarragona";"6";"Camp de Tarragona";"8";"Baix Camp";"43123";"Reus";"6";"2";"B";"552";"196";"385";"471";"81";"0";"4";"467";"471"
"43";"Tarragona";"6";"Camp de Tarragona";"8";"Baix Camp";"43123";"Reus";"6";"3";"A";"669";"230";"456";"556";"113";"3";"0";"553";"553"
"43";"Tarragona";"6";"Camp de Tarragona";"8";"Baix Camp";"43123";"Reus";"6";"3";"B";"755";"273";"502";"626";"129";"2";"6";"618";"624"
"43";"Tarragona";"6";"Camp de Tarragona";"8";"Baix Camp";"43123";"Reus";"6";"4";"A";"636";"268";"471";"561";"75";"3";"3";"555";"558"
"43";"Tarragona";"6";"Camp de Tarragona";"8";"Baix Camp";"43123";"Reus";"6";"4";"B";"694";"304";"509";"621";"73";"0";"1";"620";"621"
"43";"Tarragona";"6";"Camp de Tarragona";"8";"Baix Camp";"43123";"Reus";"6";"5";"A";"656";"229";"400";"485";"171";"2";"0";"483";"483"
"43";"Tarragona";"6";"Camp de Tarragona";"8";"Baix Camp";"43123";"Reus";"6";"5";"B";"633";"227";"403";"489";"144";"3";"3";"483";"486"
"43";"Tarragona";"6";"Camp de Tarragona";"8";"Baix Camp";"43123";"Reus";"6";"6";"A";"680";"277";"486";"575";"105";"1";"3";"571";"574"
"43";"Tarragona";"6";"Camp de Tarragona";"8";"Baix Camp";"43123";"Reus";"6";"6";"B";"556";"204";"385";"473";"83";"2";"1";"470";"471"
"43";"Tarragona";"6";"Camp de Tarragona";"8";"Baix Camp";"43123";"Reus";"6";"6";"C";"626";"248";"441";"528";"98";"2";"3";"523";"526"
"43";"Tarragona";"6";"Camp de Tarragona";"8";"Baix Camp";"43123";"Reus";"6";"7";"A";"450";"170";"291";"345";"105";"1";"1";"343";"344"
"43";"Tarragona";"6";"Camp de Tarragona";"8";"Baix Camp";"43123";"Reus";"6";"7";"B";"446";"147";"280";"347";"99";"0";"0";"347";"347"
"43";"Tarragona";"6";"Camp de Tarragona";"8";"Baix Camp";"43123";"Reus";"6";"8";"A";"419";"158";"266";"323";"96";"0";"0";"323";"323"
"43";"Tarragona";"6";"Camp de Tarragona";"8";"Baix Camp";"43123";"Reus";"6";"8";"B";"489";"159";"282";"343";"146";"2";"4";"337";"341"
"43";"Tarragona";"6";"Camp de Tarragona";"8";"Baix Camp";"43123";"Reus";"6";"9";"A";"514";"173";"284";"363";"151";"0";"2";"361";"363"
"43";"Tarragona";"6";"Camp de Tarragona";"8";"Baix Camp";"43123";"Reus";"6";"9";"B";"570";"192";"323";"411";"159";"4";"1";"406";"407"
"43";"Tarragona";"6";"Camp de Tarragona";"8";"Baix Camp";"43123";"Reus";"7";"1";"A";"563";"147";"258";"308";"255";"4";"3";"301";"304"
"43";"Tarragona";"6";"Camp de Tarragona";"8";"Baix Camp";"43123";"Reus";"7";"1";"B";"548";"146";"235";"298";"250";"0";"0";"298";"298"
"43";"Tarragona";"6";"Camp de Tarragona";"8";"Baix Camp";"43123";"Reus";"7";"2";"A";"641";"161";"320";"429";"212";"1";"3";"425";"428"
"43";"Tarragona";"6";"Camp de Tarragona";"8";"Baix Camp";"43123";"Reus";"7";"2";"B";"583";"149";"268";"362";"221";"3";"0";"359";"359"
"43";"Tarragona";"6";"Camp de Tarragona";"8";"Baix Camp";"43123";"Reus";"7";"3";"A";"511";"187";"285";"360";"151";"2";"1";"357";"358"
"43";"Tarragona";"6";"Camp de Tarragona";"8";"Baix Camp";"43123";"Reus";"7";"3";"B";"618";"198";"366";"453";"165";"0";"4";"449";"453"
"43";"Tarragona";"6";"Camp de Tarragona";"8";"Baix Camp";"43123";"Reus";"7";"3";"C";"567";"195";"335";"408";"159";"2";"6";"400";"406"
"43";"Tarragona";"6";"Camp de Tarragona";"8";"Baix Camp";"43123";"Reus";"7";"5";"A";"642";"215";"416";"497";"145";"3";"5";"489";"494"
"43";"Tarragona";"6";"Camp de Tarragona";"8";"Baix Camp";"43123";"Reus";"7";"5";"B";"624";"227";"418";"497";"127";"2";"6";"489";"495"
"43";"Tarragona";"6";"Camp de Tarragona";"8";"Baix Camp";"43123";"Reus";"8";"1";"U";"690";"219";"407";"498";"192";"5";"3";"490";"493"
"43";"Tarragona";"6";"Camp de Tarragona";"8";"Baix Camp";"43123";"Reus";"8";"2";"A";"490";"158";"281";"360";"130";"6";"2";"352";"354"
"43";"Tarragona";"6";"Camp de Tarragona";"8";"Baix Camp";"43123";"Reus";"8";"2";"B";"490";"177";"291";"347";"143";"4";"1";"342";"343"
"43";"Tarragona";"6";"Camp de Tarragona";"8";"Baix Camp";"43123";"Reus";"8";"3";"A";"533";"185";"335";"409";"124";"1";"3";"405";"408"
"43";"Tarragona";"6";"Camp de Tarragona";"8";"Baix Camp";"43123";"Reus";"8";"3";"B";"538";"189";"375";"452";"86";"6";"0";"446";"446"
"43";"Tarragona";"6";"Camp de Tarragona";"8";"Baix Camp";"43123";"Reus";"8";"4";"A";"473";"210";"289";"343";"130";"1";"0";"342";"342"
"43";"Tarragona";"6";"Camp de Tarragona";"8";"Baix Camp";"43123";"Reus";"8";"4";"B";"423";"178";"260";"315";"108";"1";"3";"311";"314"
"43";"Tarragona";"6";"Camp de Tarragona";"8";"Baix Camp";"43123";"Reus";"8";"5";"A";"463";"195";"308";"381";"82";"3";"4";"374";"378"
"43";"Tarragona";"6";"Camp de Tarragona";"8";"Baix Camp";"43123";"Reus";"8";"5";"B";"453";"166";"296";"361";"92";"0";"3";"358";"361"
"43";"Tarragona";"6";"Camp de Tarragona";"8";"Baix Camp";"43123";"Reus";"8";"6";"A";"745";"280";"489";"596";"149";"0";"1";"595";"596"
"43";"Tarragona";"6";"Camp de Tarragona";"8";"Baix Camp";"43123";"Reus";"8";"6";"B";"694";"238";"439";"543";"151";"1";"4";"538";"542"
"43";"Tarragona";"6";"Camp de Tarragona";"8";"Baix Camp";"43123";"Reus";"8";"7";"A";"651";"200";"433";"526";"125";"2";"4";"520";"524"
"43";"Tarragona";"6";"Camp de Tarragona";"8";"Baix Camp";"43123";"Reus";"8";"7";"B";"639";"212";"425";"526";"113";"1";"2";"523";"525"
"43";"Tarragona";"6";"Camp de Tarragona";"8";"Baix Camp";"43123";"Reus";"8";"7";"C";"662";"210";"440";"525";"137";"3";"1";"521";"522"
"43";"Tarragona";"6";"Camp de Tarragona";"8";"Baix Camp";"43123";"Reus";"9";"1";"A";"585";"207";"392";"469";"116";"0";"0";"469";"469"
"43";"Tarragona";"6";"Camp de Tarragona";"8";"Baix Camp";"43123";"Reus";"9";"1";"B";"587";"203";"380";"488";"99";"0";"1";"487";"488"
"43";"Tarragona";"6";"Camp de Tarragona";"8";"Baix Camp";"43123";"Reus";"9";"2";"U";"581";"168";"287";"365";"216";"0";"2";"363";"365"
"43";"Tarragona";"6";"Camp de Tarragona";"1";"Alt Camp";"43124";"Riba, la";"1";"1";"U";"488";"173";"342";"399";"89";"4";"3";"392";"395"
"43";"Tarragona";"6";"Camp de Tarragona";"36";"Tarragonès";"43126";"Riera de Gaià, la";"1";"1";"A";"565";"229";"391";"460";"105";"4";"2";"454";"456"
"43";"Tarragona";"6";"Camp de Tarragona";"36";"Tarragonès";"43126";"Riera de Gaià, la";"1";"1";"B";"612";"233";"412";"500";"112";"0";"4";"496";"500"
"43";"Tarragona";"6";"Camp de Tarragona";"8";"Baix Camp";"43127";"Riudecanyes";"1";"1";"U";"769";"294";"570";"641";"128";"1";"0";"640";"640"
"43";"Tarragona";"6";"Camp de Tarragona";"8";"Baix Camp";"43128";"Riudecols";"1";"1";"A";"425";"138";"288";"339";"86";"2";"2";"335";"337"
"43";"Tarragona";"6";"Camp de Tarragona";"8";"Baix Camp";"43128";"Riudecols";"1";"1";"B";"485";"224";"362";"409";"76";"2";"3";"404";"407"
"43";"Tarragona";"6";"Camp de Tarragona";"8";"Baix Camp";"43129";"Riudoms";"1";"1";"A";"509";"181";"314";"409";"100";"8";"3";"398";"401"
"43";"Tarragona";"6";"Camp de Tarragona";"8";"Baix Camp";"43129";"Riudoms";"1";"1";"B";"459";"165";"289";"372";"87";"3";"6";"363";"369"
"43";"Tarragona";"6";"Camp de Tarragona";"8";"Baix Camp";"43129";"Riudoms";"2";"1";"U";"576";"215";"375";"467";"109";"5";"4";"458";"462"
"43";"Tarragona";"6";"Camp de Tarragona";"8";"Baix Camp";"43129";"Riudoms";"2";"2";"A";"592";"206";"385";"490";"102";"6";"3";"481";"484"
"43";"Tarragona";"6";"Camp de Tarragona";"8";"Baix Camp";"43129";"Riudoms";"2";"2";"B";"583";"210";"371";"466";"117";"1";"2";"463";"465"
"43";"Tarragona";"6";"Camp de Tarragona";"8";"Baix Camp";"43129";"Riudoms";"2";"2";"C";"567";"208";"376";"468";"99";"3";"3";"462";"465"
"43";"Tarragona";"6";"Camp de Tarragona";"8";"Baix Camp";"43129";"Riudoms";"2";"3";"A";"641";"203";"423";"530";"111";"2";"1";"527";"528"
"43";"Tarragona";"6";"Camp de Tarragona";"8";"Baix Camp";"43129";"Riudoms";"2";"3";"B";"675";"223";"432";"548";"127";"3";"5";"540";"545"
"43";"Tarragona";"6";"Camp de Tarragona";"16";"Conca de Barberà";"43130";"Rocafort de Queralt";"1";"1";"U";"198";"96";"141";"160";"38";"1";"0";"159";"159"
"43";"Tarragona";"6";"Camp de Tarragona";"36";"Tarragonès";"43131";"Roda de Berà";"1";"1";"A";"598";"225";"356";"436";"162";"1";"1";"434";"435"
"43";"Tarragona";"6";"Camp de Tarragona";"36";"Tarragonès";"43131";"Roda de Berà";"1";"1";"B";"751";"283";"446";"536";"215";"1";"1";"534";"535"
"43";"Tarragona";"6";"Camp de Tarragona";"36";"Tarragonès";"43131";"Roda de Berà";"1";"1";"C";"620";"231";"380";"452";"168";"0";"2";"450";"452"
"43";"Tarragona";"6";"Camp de Tarragona";"36";"Tarragonès";"43131";"Roda de Berà";"1";"2";"A";"667";"235";"387";"470";"197";"2";"0";"468";"468"
"43";"Tarragona";"6";"Camp de Tarragona";"36";"Tarragonès";"43131";"Roda de Berà";"1";"2";"B";"631";"240";"373";"446";"185";"2";"1";"443";"444"
"43";"Tarragona";"6";"Camp de Tarragona";"36";"Tarragonès";"43131";"Roda de Berà";"1";"3";"A";"703";"253";"450";"529";"174";"1";"2";"526";"528"
"43";"Tarragona";"6";"Camp de Tarragona";"36";"Tarragonès";"43131";"Roda de Berà";"1";"3";"B";"648";"217";"396";"489";"159";"6";"1";"482";"483"
"43";"Tarragona";"6";"Camp de Tarragona";"1";"Alt Camp";"43132";"Rodonyà";"1";"1";"U";"368";"129";"238";"299";"69";"0";"2";"297";"299"
"43";"Tarragona";"6";"Camp de Tarragona";"1";"Alt Camp";"43134";"Rourell, el";"1";"1";"U";"281";"134";"211";"248";"33";"0";"2";"246";"248"
"43";"Tarragona";"6";"Camp de Tarragona";"36";"Tarragonès";"43135";"Salomó";"1";"1";"U";"339";"130";"246";"281";"58";"1";"4";"276";"280"
"43";"Tarragona";"6";"Camp de Tarragona";"36";"Tarragonès";"43905";"Salou";"1";"1";"A";"560";"184";"330";"395";"165";"1";"3";"391";"394"
"43";"Tarragona";"6";"Camp de Tarragona";"36";"Tarragonès";"43905";"Salou";"1";"1";"B";"606";"199";"356";"426";"180";"0";"0";"426";"426"
"43";"Tarragona";"6";"Camp de Tarragona";"36";"Tarragonès";"43905";"Salou";"1";"1";"C";"669";"224";"386";"480";"189";"4";"1";"475";"476"
"43";"Tarragona";"6";"Camp de Tarragona";"36";"Tarragonès";"43905";"Salou";"1";"10";"A";"659";"205";"395";"508";"151";"2";"5";"501";"506"
"43";"Tarragona";"6";"Camp de Tarragona";"36";"Tarragonès";"43905";"Salou";"1";"10";"B";"687";"245";"429";"554";"133";"0";"0";"554";"554"
"43";"Tarragona";"6";"Camp de Tarragona";"36";"Tarragonès";"43905";"Salou";"1";"11";"A";"563";"186";"363";"453";"110";"0";"1";"452";"453"
"43";"Tarragona";"6";"Camp de Tarragona";"36";"Tarragonès";"43905";"Salou";"1";"11";"B";"548";"212";"314";"405";"143";"0";"0";"405";"405"
"43";"Tarragona";"6";"Camp de Tarragona";"36";"Tarragonès";"43905";"Salou";"1";"12";"A";"435";"153";"261";"324";"111";"1";"2";"321";"323"
"43";"Tarragona";"6";"Camp de Tarragona";"36";"Tarragonès";"43905";"Salou";"1";"12";"B";"494";"136";"267";"358";"136";"1";"1";"356";"357"
"43";"Tarragona";"6";"Camp de Tarragona";"36";"Tarragonès";"43905";"Salou";"1";"2";"A";"668";"141";"313";"406";"262";"2";"0";"404";"404"
"43";"Tarragona";"6";"Camp de Tarragona";"36";"Tarragonès";"43905";"Salou";"1";"2";"B";"662";"145";"318";"400";"262";"2";"0";"398";"398"
"43";"Tarragona";"6";"Camp de Tarragona";"36";"Tarragonès";"43905";"Salou";"1";"3";"U";"748";"218";"436";"537";"211";"1";"2";"534";"536"
"43";"Tarragona";"6";"Camp de Tarragona";"36";"Tarragonès";"43905";"Salou";"1";"4";"A";"402";"143";"236";"273";"129";"2";"0";"271";"271"
"43";"Tarragona";"6";"Camp de Tarragona";"36";"Tarragonès";"43905";"Salou";"1";"4";"B";"482";"127";"257";"305";"177";"1";"0";"304";"304"
"43";"Tarragona";"6";"Camp de Tarragona";"36";"Tarragonès";"43905";"Salou";"1";"5";"U";"782";"277";"482";"590";"192";"5";"0";"585";"585"
"43";"Tarragona";"6";"Camp de Tarragona";"36";"Tarragonès";"43905";"Salou";"1";"6";"A";"567";"117";"249";"313";"254";"3";"1";"309";"310"
"43";"Tarragona";"6";"Camp de Tarragona";"36";"Tarragonès";"43905";"Salou";"1";"6";"B";"540";"151";"272";"334";"206";"2";"1";"331";"332"
"43";"Tarragona";"6";"Camp de Tarragona";"36";"Tarragonès";"43905";"Salou";"1";"6";"C";"639";"156";"289";"383";"256";"2";"1";"380";"381"
"43";"Tarragona";"6";"Camp de Tarragona";"36";"Tarragonès";"43905";"Salou";"1";"7";"A";"492";"159";"271";"337";"155";"4";"1";"332";"333"
"43";"Tarragona";"6";"Camp de Tarragona";"36";"Tarragonès";"43905";"Salou";"1";"7";"B";"601";"198";"344";"418";"183";"0";"0";"418";"418"
"43";"Tarragona";"6";"Camp de Tarragona";"36";"Tarragonès";"43905";"Salou";"1";"7";"C";"557";"171";"295";"377";"180";"5";"2";"370";"372"
"43";"Tarragona";"6";"Camp de Tarragona";"36";"Tarragonès";"43905";"Salou";"1";"8";"A";"599";"204";"352";"439";"160";"1";"2";"436";"438"
"43";"Tarragona";"6";"Camp de Tarragona";"36";"Tarragonès";"43905";"Salou";"1";"8";"B";"552";"159";"313";"400";"152";"3";"0";"397";"397"
"43";"Tarragona";"6";"Camp de Tarragona";"36";"Tarragonès";"43905";"Salou";"1";"9";"A";"467";"152";"300";"361";"106";"0";"2";"359";"361"
"43";"Tarragona";"6";"Camp de Tarragona";"36";"Tarragonès";"43905";"Salou";"1";"9";"B";"366";"92";"210";"272";"94";"3";"1";"268";"269"
"43";"Tarragona";"6";"Camp de Tarragona";"12";"Baix Penedès";"43137";"Sant Jaume dels Domenys";"1";"1";"A";"581";"199";"379";"456";"125";"4";"5";"447";"452"
"43";"Tarragona";"6";"Camp de Tarragona";"12";"Baix Penedès";"43137";"Sant Jaume dels Domenys";"1";"1";"B";"595";"236";"393";"471";"124";"2";"4";"465";"469"
"43";"Tarragona";"6";"Camp de Tarragona";"12";"Baix Penedès";"43137";"Sant Jaume dels Domenys";"1";"1";"C";"694";"256";"441";"541";"153";"3";"4";"534";"538"
"43";"Tarragona";"6";"Camp de Tarragona";"16";"Conca de Barberà";"43139";"Santa Coloma de Queralt";"1";"1";"A";"607";"189";"373";"477";"130";"0";"2";"475";"477"
"43";"Tarragona";"6";"Camp de Tarragona";"16";"Conca de Barberà";"43139";"Santa Coloma de Queralt";"1";"1";"B";"671";"236";"440";"548";"123";"1";"2";"545";"547"
"43";"Tarragona";"6";"Camp de Tarragona";"16";"Conca de Barberà";"43139";"Santa Coloma de Queralt";"2";"1";"U";"772";"273";"509";"658";"114";"7";"5";"646";"651"
"43";"Tarragona";"6";"Camp de Tarragona";"12";"Baix Penedès";"43140";"Santa Oliva";"1";"1";"A";"790";"289";"541";"669";"121";"10";"4";"655";"659"
"43";"Tarragona";"6";"Camp de Tarragona";"12";"Baix Penedès";"43140";"Santa Oliva";"1";"1";"B";"286";"100";"169";"206";"80";"0";"1";"205";"206"
"43";"Tarragona";"6";"Camp de Tarragona";"12";"Baix Penedès";"43140";"Santa Oliva";"1";"2";"A";"645";"219";"408";"483";"162";"4";"7";"472";"479"
"43";"Tarragona";"6";"Camp de Tarragona";"12";"Baix Penedès";"43140";"Santa Oliva";"1";"2";"B";"659";"218";"406";"477";"182";"3";"3";"471";"474"
"43";"Tarragona";"6";"Camp de Tarragona";"16";"Conca de Barberà";"43142";"Sarral";"1";"1";"A";"515";"213";"339";"400";"115";"2";"8";"390";"398"
"43";"Tarragona";"6";"Camp de Tarragona";"16";"Conca de Barberà";"43142";"Sarral";"1";"1";"B";"600";"252";"435";"499";"101";"2";"3";"494";"497"
"43";"Tarragona";"6";"Camp de Tarragona";"16";"Conca de Barberà";"43143";"Savallà del Comtat";"1";"1";"U";"56";"28";"48";"52";"4";"2";"1";"49";"50"
"43";"Tarragona";"6";"Camp de Tarragona";"36";"Tarragonès";"43144";"Secuita, la";"1";"1";"A";"579";"241";"397";"474";"105";"8";"1";"465";"466"
"43";"Tarragona";"6";"Camp de Tarragona";"36";"Tarragonès";"43144";"Secuita, la";"1";"1";"B";"667";"273";"470";"558";"109";"4";"4";"550";"554"
"43";"Tarragona";"6";"Camp de Tarragona";"8";"Baix Camp";"43145";"Selva del Camp, la";"1";"1";"A";"633";"176";"424";"521";"112";"1";"2";"518";"520"
"43";"Tarragona";"6";"Camp de Tarragona";"8";"Baix Camp";"43145";"Selva del Camp, la";"1";"1";"B";"554";"229";"345";"437";"117";"3";"2";"432";"434"
"43";"Tarragona";"6";"Camp de Tarragona";"8";"Baix Camp";"43145";"Selva del Camp, la";"1";"1";"C";"608";"243";"425";"507";"101";"3";"2";"502";"504"
"43";"Tarragona";"6";"Camp de Tarragona";"8";"Baix Camp";"43145";"Selva del Camp, la";"2";"1";"A";"579";"231";"395";"474";"105";"1";"3";"470";"473"
"43";"Tarragona";"6";"Camp de Tarragona";"8";"Baix Camp";"43145";"Selva del Camp, la";"2";"1";"B";"626";"242";"415";"515";"111";"5";"1";"509";"510"
"43";"Tarragona";"6";"Camp de Tarragona";"8";"Baix Camp";"43145";"Selva del Camp, la";"2";"2";"A";"523";"198";"353";"443";"80";"3";"2";"438";"440"
"43";"Tarragona";"6";"Camp de Tarragona";"8";"Baix Camp";"43145";"Selva del Camp, la";"2";"2";"B";"544";"202";"378";"474";"70";"1";"4";"469";"473"
"43";"Tarragona";"6";"Camp de Tarragona";"16";"Conca de Barberà";"43146";"Senan";"1";"1";"U";"38";"13";"21";"32";"6";"0";"1";"31";"32"
"43";"Tarragona";"6";"Camp de Tarragona";"16";"Conca de Barberà";"43147";"Solivella";"1";"1";"U";"519";"232";"401";"450";"69";"5";"0";"445";"445"
"43";"Tarragona";"6";"Camp de Tarragona";"36";"Tarragonès";"43148";"Tarragona";"1";"1";"A";"512";"150";"284";"356";"156";"1";"2";"353";"355"
"43";"Tarragona";"6";"Camp de Tarragona";"36";"Tarragonès";"43148";"Tarragona";"1";"1";"B";"514";"147";"259";"343";"171";"0";"3";"340";"343"
"43";"Tarragona";"6";"Camp de Tarragona";"36";"Tarragonès";"43148";"Tarragona";"2";"1";"A";"443";"144";"245";"302";"141";"1";"0";"301";"301"
"43";"Tarragona";"6";"Camp de Tarragona";"36";"Tarragonès";"43148";"Tarragona";"2";"1";"B";"415";"138";"247";"290";"125";"2";"4";"284";"288"
"43";"Tarragona";"6";"Camp de Tarragona";"36";"Tarragonès";"43148";"Tarragona";"3";"1";"A";"423";"128";"268";"322";"101";"1";"2";"319";"321"
"43";"Tarragona";"6";"Camp de Tarragona";"36";"Tarragonès";"43148";"Tarragona";"3";"1";"B";"396";"123";"237";"283";"113";"1";"0";"282";"282"
"43";"Tarragona";"6";"Camp de Tarragona";"36";"Tarragonès";"43148";"Tarragona";"3";"2";"A";"688";"232";"440";"556";"132";"5";"3";"548";"551"
"43";"Tarragona";"6";"Camp de Tarragona";"36";"Tarragonès";"43148";"Tarragona";"3";"2";"B";"664";"217";"431";"533";"131";"0";"3";"530";"533"
"43";"Tarragona";"6";"Camp de Tarragona";"36";"Tarragonès";"43148";"Tarragona";"3";"3";"A";"545";"185";"379";"456";"89";"2";"2";"452";"454"
"43";"Tarragona";"6";"Camp de Tarragona";"36";"Tarragonès";"43148";"Tarragona";"3";"3";"B";"551";"180";"360";"457";"94";"1";"1";"455";"456"
"43";"Tarragona";"6";"Camp de Tarragona";"36";"Tarragonès";"43148";"Tarragona";"3";"3";"C";"569";"190";"404";"475";"94";"1";"1";"473";"474"
"43";"Tarragona";"6";"Camp de Tarragona";"36";"Tarragonès";"43148";"Tarragona";"4";"1";"A";"489";"196";"315";"380";"109";"0";"3";"377";"380"
"43";"Tarragona";"6";"Camp de Tarragona";"36";"Tarragonès";"43148";"Tarragona";"4";"1";"B";"538";"214";"360";"407";"131";"4";"1";"402";"403"
"43";"Tarragona";"6";"Camp de Tarragona";"36";"Tarragonès";"43148";"Tarragona";"4";"10";"A";"440";"183";"295";"341";"99";"3";"2";"336";"338"
"43";"Tarragona";"6";"Camp de Tarragona";"36";"Tarragonès";"43148";"Tarragona";"4";"10";"B";"421";"137";"280";"320";"101";"3";"5";"312";"317"
"43";"Tarragona";"6";"Camp de Tarragona";"36";"Tarragonès";"43148";"Tarragona";"4";"12";"U";"530";"197";"341";"440";"90";"3";"0";"437";"437"
"43";"Tarragona";"6";"Camp de Tarragona";"36";"Tarragonès";"43148";"Tarragona";"4";"14";"A";"582";"237";"404";"459";"123";"0";"3";"456";"459"
"43";"Tarragona";"6";"Camp de Tarragona";"36";"Tarragonès";"43148";"Tarragona";"4";"14";"B";"656";"235";"451";"522";"134";"1";"6";"515";"521"
"43";"Tarragona";"6";"Camp de Tarragona";"36";"Tarragonès";"43148";"Tarragona";"4";"15";"U";"699";"253";"497";"567";"132";"1";"3";"563";"566"
"43";"Tarragona";"6";"Camp de Tarragona";"36";"Tarragonès";"43148";"Tarragona";"4";"16";"A";"623";"230";"444";"540";"83";"0";"2";"538";"540"
"43";"Tarragona";"6";"Camp de Tarragona";"36";"Tarragonès";"43148";"Tarragona";"4";"16";"B";"710";"279";"502";"616";"94";"1";"5";"610";"615"
"43";"Tarragona";"6";"Camp de Tarragona";"36";"Tarragonès";"43148";"Tarragona";"4";"2";"U";"533";"184";"326";"405";"128";"0";"3";"402";"405"
"43";"Tarragona";"6";"Camp de Tarragona";"36";"Tarragonès";"43148";"Tarragona";"4";"3";"U";"578";"210";"349";"430";"148";"2";"6";"422";"428"
"43";"Tarragona";"6";"Camp de Tarragona";"36";"Tarragonès";"43148";"Tarragona";"4";"4";"A";"423";"153";"268";"332";"91";"2";"2";"328";"330"
"43";"Tarragona";"6";"Camp de Tarragona";"36";"Tarragonès";"43148";"Tarragona";"4";"4";"B";"417";"162";"279";"333";"84";"0";"0";"333";"333"
"43";"Tarragona";"6";"Camp de Tarragona";"36";"Tarragonès";"43148";"Tarragona";"4";"5";"A";"428";"177";"297";"348";"80";"3";"0";"345";"345"
"43";"Tarragona";"6";"Camp de Tarragona";"36";"Tarragonès";"43148";"Tarragona";"4";"5";"B";"408";"171";"272";"340";"68";"0";"0";"340";"340"
"43";"Tarragona";"6";"Camp de Tarragona";"36";"Tarragonès";"43148";"Tarragona";"4";"6";"A";"475";"212";"344";"400";"75";"2";"2";"396";"398"
"43";"Tarragona";"6";"Camp de Tarragona";"36";"Tarragonès";"43148";"Tarragona";"4";"6";"B";"545";"242";"373";"452";"93";"0";"2";"450";"452"
"43";"Tarragona";"6";"Camp de Tarragona";"36";"Tarragonès";"43148";"Tarragona";"4";"7";"U";"659";"210";"443";"511";"148";"2";"3";"506";"509"
"43";"Tarragona";"6";"Camp de Tarragona";"36";"Tarragonès";"43148";"Tarragona";"4";"8";"A";"591";"195";"367";"462";"129";"0";"4";"458";"462"
"43";"Tarragona";"6";"Camp de Tarragona";"36";"Tarragonès";"43148";"Tarragona";"4";"8";"B";"591";"202";"406";"485";"106";"0";"4";"481";"485"
"43";"Tarragona";"6";"Camp de Tarragona";"36";"Tarragonès";"43148";"Tarragona";"4";"9";"A";"684";"264";"471";"604";"80";"2";"3";"599";"602"
"43";"Tarragona";"6";"Camp de Tarragona";"36";"Tarragonès";"43148";"Tarragona";"4";"9";"B";"664";"261";"453";"582";"82";"0";"1";"581";"582"
"43";"Tarragona";"6";"Camp de Tarragona";"36";"Tarragonès";"43148";"Tarragona";"5";"1";"U";"748";"209";"523";"578";"170";"0";"1";"577";"578"
"43";"Tarragona";"6";"Camp de Tarragona";"36";"Tarragonès";"43148";"Tarragona";"5";"2";"A";"440";"120";"286";"352";"88";"3";"3";"346";"349"
"43";"Tarragona";"6";"Camp de Tarragona";"36";"Tarragonès";"43148";"Tarragona";"5";"2";"B";"374";"101";"224";"281";"93";"1";"2";"278";"280"
"43";"Tarragona";"6";"Camp de Tarragona";"36";"Tarragonès";"43148";"Tarragona";"5";"3";"A";"616";"184";"378";"479";"137";"1";"1";"477";"478"
"43";"Tarragona";"6";"Camp de Tarragona";"36";"Tarragonès";"43148";"Tarragona";"5";"3";"B";"651";"183";"415";"485";"166";"0";"1";"484";"485"
"43";"Tarragona";"6";"Camp de Tarragona";"36";"Tarragonès";"43148";"Tarragona";"5";"4";"A";"457";"168";"301";"354";"103";"1";"2";"351";"353"
"43";"Tarragona";"6";"Camp de Tarragona";"36";"Tarragonès";"43148";"Tarragona";"5";"4";"B";"421";"138";"278";"335";"86";"0";"1";"334";"335"
"43";"Tarragona";"6";"Camp de Tarragona";"36";"Tarragonès";"43148";"Tarragona";"5";"5";"A";"595";"152";"298";"402";"193";"3";"1";"398";"399"
"43";"Tarragona";"6";"Camp de Tarragona";"36";"Tarragonès";"43148";"Tarragona";"5";"5";"B";"633";"169";"351";"475";"158";"1";"1";"473";"474"
"43";"Tarragona";"6";"Camp de Tarragona";"36";"Tarragonès";"43148";"Tarragona";"5";"6";"U";"807";"208";"430";"525";"282";"2";"2";"521";"523"
"43";"Tarragona";"6";"Camp de Tarragona";"36";"Tarragonès";"43148";"Tarragona";"5";"7";"U";"689";"230";"417";"506";"183";"1";"3";"502";"505"
"43";"Tarragona";"6";"Camp de Tarragona";"36";"Tarragonès";"43148";"Tarragona";"5";"8";"A";"570";"201";"349";"450";"120";"2";"2";"446";"448"
"43";"Tarragona";"6";"Camp de Tarragona";"36";"Tarragonès";"43148";"Tarragona";"5";"8";"B";"637";"221";"404";"508";"129";"1";"3";"504";"507"
"43";"Tarragona";"6";"Camp de Tarragona";"36";"Tarragonès";"43148";"Tarragona";"6";"1";"A";"656";"237";"464";"544";"112";"3";"3";"538";"541"
"43";"Tarragona";"6";"Camp de Tarragona";"36";"Tarragonès";"43148";"Tarragona";"6";"1";"B";"605";"204";"407";"510";"95";"2";"7";"501";"508"
"43";"Tarragona";"6";"Camp de Tarragona";"36";"Tarragonès";"43148";"Tarragona";"6";"10";"A";"545";"234";"354";"435";"110";"1";"0";"434";"434"
"43";"Tarragona";"6";"Camp de Tarragona";"36";"Tarragonès";"43148";"Tarragona";"6";"10";"B";"520";"219";"348";"435";"85";"2";"1";"432";"433"
"43";"Tarragona";"6";"Camp de Tarragona";"36";"Tarragonès";"43148";"Tarragona";"6";"11";"A";"562";"196";"356";"423";"139";"2";"1";"420";"421"
"43";"Tarragona";"6";"Camp de Tarragona";"36";"Tarragonès";"43148";"Tarragona";"6";"11";"B";"548";"212";"358";"429";"119";"4";"6";"419";"425"
"43";"Tarragona";"6";"Camp de Tarragona";"36";"Tarragonès";"43148";"Tarragona";"6";"12";"A";"568";"209";"388";"487";"81";"0";"1";"486";"487"
"43";"Tarragona";"6";"Camp de Tarragona";"36";"Tarragonès";"43148";"Tarragona";"6";"12";"B";"623";"219";"414";"525";"98";"2";"1";"522";"523"
"43";"Tarragona";"6";"Camp de Tarragona";"36";"Tarragonès";"43148";"Tarragona";"6";"13";"U";"696";"217";"460";"555";"141";"2";"3";"550";"553"
"43";"Tarragona";"6";"Camp de Tarragona";"36";"Tarragonès";"43148";"Tarragona";"6";"15";"A";"608";"226";"391";"440";"168";"3";"3";"434";"437"
"43";"Tarragona";"6";"Camp de Tarragona";"36";"Tarragonès";"43148";"Tarragona";"6";"15";"B";"274";"112";"156";"184";"90";"3";"3";"178";"181"
"43";"Tarragona";"6";"Camp de Tarragona";"36";"Tarragonès";"43148";"Tarragona";"6";"16";"A";"610";"222";"415";"504";"106";"4";"8";"492";"500"
"43";"Tarragona";"6";"Camp de Tarragona";"36";"Tarragonès";"43148";"Tarragona";"6";"16";"B";"603";"233";"413";"515";"88";"2";"2";"511";"513"
"43";"Tarragona";"6";"Camp de Tarragona";"36";"Tarragonès";"43148";"Tarragona";"6";"16";"C";"682";"250";"470";"584";"98";"4";"4";"576";"580"
"43";"Tarragona";"6";"Camp de Tarragona";"36";"Tarragonès";"43148";"Tarragona";"6";"2";"A";"579";"205";"383";"481";"98";"1";"1";"479";"480"
"43";"Tarragona";"6";"Camp de Tarragona";"36";"Tarragonès";"43148";"Tarragona";"6";"2";"B";"598";"225";"409";"495";"103";"2";"3";"490";"493"
"43";"Tarragona";"6";"Camp de Tarragona";"36";"Tarragonès";"43148";"Tarragona";"6";"2";"C";"656";"271";"439";"528";"128";"1";"3";"524";"527"
"43";"Tarragona";"6";"Camp de Tarragona";"36";"Tarragonès";"43148";"Tarragona";"6";"3";"A";"714";"272";"440";"522";"192";"0";"3";"519";"522"
"43";"Tarragona";"6";"Camp de Tarragona";"36";"Tarragonès";"43148";"Tarragona";"6";"3";"B";"775";"287";"478";"580";"195";"2";"3";"575";"578"
"43";"Tarragona";"6";"Camp de Tarragona";"36";"Tarragonès";"43148";"Tarragona";"6";"4";"U";"647";"220";"387";"453";"194";"2";"3";"448";"451"
"43";"Tarragona";"6";"Camp de Tarragona";"36";"Tarragonès";"43148";"Tarragona";"6";"5";"A";"315";"105";"180";"214";"101";"1";"0";"213";"213"
"43";"Tarragona";"6";"Camp de Tarragona";"36";"Tarragonès";"43148";"Tarragona";"6";"5";"B";"545";"200";"361";"437";"108";"1";"0";"436";"436"
"43";"Tarragona";"6";"Camp de Tarragona";"36";"Tarragonès";"43148";"Tarragona";"6";"6";"U";"541";"193";"298";"378";"163";"0";"0";"378";"378"
"43";"Tarragona";"6";"Camp de Tarragona";"36";"Tarragonès";"43148";"Tarragona";"6";"8";"A";"568";"186";"368";"438";"130";"1";"2";"435";"437"
"43";"Tarragona";"6";"Camp de Tarragona";"36";"Tarragonès";"43148";"Tarragona";"6";"8";"B";"652";"250";"436";"526";"126";"3";"2";"521";"523"
"43";"Tarragona";"6";"Camp de Tarragona";"36";"Tarragonès";"43148";"Tarragona";"6";"9";"A";"732";"258";"483";"585";"147";"3";"5";"577";"582"
"43";"Tarragona";"6";"Camp de Tarragona";"36";"Tarragonès";"43148";"Tarragona";"6";"9";"B";"773";"244";"493";"622";"151";"1";"0";"621";"621"
"43";"Tarragona";"6";"Camp de Tarragona";"36";"Tarragonès";"43148";"Tarragona";"7";"1";"A";"546";"173";"289";"369";"177";"0";"4";"365";"369"
"43";"Tarragona";"6";"Camp de Tarragona";"36";"Tarragonès";"43148";"Tarragona";"7";"1";"B";"599";"217";"359";"440";"159";"4";"5";"431";"436"
"43";"Tarragona";"6";"Camp de Tarragona";"36";"Tarragonès";"43148";"Tarragona";"7";"10";"A";"453";"149";"259";"310";"143";"0";"2";"308";"310"
"43";"Tarragona";"6";"Camp de Tarragona";"36";"Tarragonès";"43148";"Tarragona";"7";"10";"B";"505";"179";"291";"350";"155";"0";"1";"349";"350"
"43";"Tarragona";"6";"Camp de Tarragona";"36";"Tarragonès";"43148";"Tarragona";"7";"11";"A";"713";"250";"449";"542";"171";"1";"1";"540";"541"
"43";"Tarragona";"6";"Camp de Tarragona";"36";"Tarragonès";"43148";"Tarragona";"7";"11";"B";"699";"270";"464";"545";"154";"2";"1";"542";"543"
"43";"Tarragona";"6";"Camp de Tarragona";"36";"Tarragonès";"43148";"Tarragona";"7";"12";"A";"549";"192";"280";"425";"124";"0";"6";"419";"425"
"43";"Tarragona";"6";"Camp de Tarragona";"36";"Tarragonès";"43148";"Tarragona";"7";"12";"B";"582";"190";"378";"405";"177";"2";"1";"402";"403"
"43";"Tarragona";"6";"Camp de Tarragona";"36";"Tarragonès";"43148";"Tarragona";"7";"13";"A";"629";"237";"460";"531";"98";"0";"4";"527";"531"
"43";"Tarragona";"6";"Camp de Tarragona";"36";"Tarragonès";"43148";"Tarragona";"7";"13";"B";"604";"230";"431";"504";"100";"1";"4";"499";"503"
"43";"Tarragona";"6";"Camp de Tarragona";"36";"Tarragonès";"43148";"Tarragona";"7";"13";"C";"692";"251";"482";"577";"115";"1";"2";"574";"576"
"43";"Tarragona";"6";"Camp de Tarragona";"36";"Tarragonès";"43148";"Tarragona";"7";"14";"U";"763";"261";"529";"673";"90";"3";"1";"669";"670"
"43";"Tarragona";"6";"Camp de Tarragona";"36";"Tarragonès";"43148";"Tarragona";"7";"15";"A";"557";"204";"365";"438";"119";"4";"7";"427";"434"
"43";"Tarragona";"6";"Camp de Tarragona";"36";"Tarragonès";"43148";"Tarragona";"7";"15";"B";"520";"195";"359";"425";"95";"2";"3";"420";"423"
"43";"Tarragona";"6";"Camp de Tarragona";"36";"Tarragonès";"43148";"Tarragona";"7";"16";"A";"564";"205";"390";"465";"99";"3";"1";"461";"462"
"43";"Tarragona";"6";"Camp de Tarragona";"36";"Tarragonès";"43148";"Tarragona";"7";"16";"B";"594";"266";"441";"525";"69";"0";"8";"517";"525"
"43";"Tarragona";"6";"Camp de Tarragona";"36";"Tarragonès";"43148";"Tarragona";"7";"16";"C";"654";"267";"450";"563";"91";"1";"2";"560";"562"
"43";"Tarragona";"6";"Camp de Tarragona";"36";"Tarragonès";"43148";"Tarragona";"7";"17";"A";"700";"239";"479";"608";"92";"2";"6";"600";"606"
"43";"Tarragona";"6";"Camp de Tarragona";"36";"Tarragonès";"43148";"Tarragona";"7";"17";"B";"706";"207";"460";"597";"109";"6";"3";"588";"591"
"43";"Tarragona";"6";"Camp de Tarragona";"36";"Tarragonès";"43148";"Tarragona";"7";"18";"A";"665";"223";"414";"524";"141";"1";"4";"519";"523"
"43";"Tarragona";"6";"Camp de Tarragona";"36";"Tarragonès";"43148";"Tarragona";"7";"18";"B";"643";"191";"393";"484";"159";"0";"2";"482";"484"
"43";"Tarragona";"6";"Camp de Tarragona";"36";"Tarragonès";"43148";"Tarragona";"7";"19";"A";"518";"186";"321";"405";"113";"1";"1";"403";"404"
"43";"Tarragona";"6";"Camp de Tarragona";"36";"Tarragonès";"43148";"Tarragona";"7";"19";"B";"597";"184";"343";"456";"141";"1";"2";"453";"455"
"43";"Tarragona";"6";"Camp de Tarragona";"36";"Tarragonès";"43148";"Tarragona";"7";"19";"C";"608";"193";"368";"457";"151";"0";"1";"456";"457"
"43";"Tarragona";"6";"Camp de Tarragona";"36";"Tarragonès";"43148";"Tarragona";"7";"2";"A";"583";"155";"349";"453";"130";"2";"2";"449";"451"
"43";"Tarragona";"6";"Camp de Tarragona";"36";"Tarragonès";"43148";"Tarragona";"7";"2";"B";"583";"163";"330";"447";"136";"4";"5";"438";"443"
"43";"Tarragona";"6";"Camp de Tarragona";"36";"Tarragonès";"43148";"Tarragona";"7";"2";"C";"592";"167";"374";"479";"113";"2";"2";"475";"477"
"43";"Tarragona";"6";"Camp de Tarragona";"36";"Tarragonès";"43148";"Tarragona";"7";"20";"A";"648";"225";"463";"580";"68";"1";"6";"573";"579"
"43";"Tarragona";"6";"Camp de Tarragona";"36";"Tarragonès";"43148";"Tarragona";"7";"20";"B";"612";"219";"414";"521";"91";"2";"0";"519";"519"
"43";"Tarragona";"6";"Camp de Tarragona";"36";"Tarragonès";"43148";"Tarragona";"7";"20";"C";"714";"230";"497";"607";"107";"1";"2";"604";"606"
"43";"Tarragona";"6";"Camp de Tarragona";"36";"Tarragonès";"43148";"Tarragona";"7";"21";"A";"684";"201";"410";"541";"143";"0";"0";"541";"541"
"43";"Tarragona";"6";"Camp de Tarragona";"36";"Tarragonès";"43148";"Tarragona";"7";"21";"B";"722";"189";"438";"582";"140";"2";"0";"580";"580"
"43";"Tarragona";"6";"Camp de Tarragona";"36";"Tarragonès";"43148";"Tarragona";"7";"22";"A";"479";"166";"298";"381";"98";"1";"2";"378";"380"
"43";"Tarragona";"6";"Camp de Tarragona";"36";"Tarragonès";"43148";"Tarragona";"7";"22";"B";"542";"171";"360";"441";"101";"3";"0";"438";"438"
"43";"Tarragona";"6";"Camp de Tarragona";"36";"Tarragonès";"43148";"Tarragona";"7";"3";"A";"713";"195";"393";"483";"230";"1";"1";"481";"482"
"43";"Tarragona";"6";"Camp de Tarragona";"36";"Tarragonès";"43148";"Tarragona";"7";"3";"B";"647";"243";"393";"471";"176";"1";"1";"469";"470"
"43";"Tarragona";"6";"Camp de Tarragona";"36";"Tarragonès";"43148";"Tarragona";"7";"4";"A";"590";"197";"474";"486";"104";"0";"2";"484";"486"
"43";"Tarragona";"6";"Camp de Tarragona";"36";"Tarragonès";"43148";"Tarragona";"7";"4";"B";"614";"175";"368";"474";"140";"5";"4";"465";"469"
"43";"Tarragona";"6";"Camp de Tarragona";"36";"Tarragonès";"43148";"Tarragona";"7";"4";"C";"676";"195";"414";"539";"137";"3";"1";"535";"536"
"43";"Tarragona";"6";"Camp de Tarragona";"36";"Tarragonès";"43148";"Tarragona";"7";"5";"U";"610";"200";"208";"350";"260";"5";"1";"344";"345"
"43";"Tarragona";"6";"Camp de Tarragona";"36";"Tarragonès";"43148";"Tarragona";"7";"6";"U";"794";"270";"363";"571";"223";"3";"3";"565";"568"
"43";"Tarragona";"6";"Camp de Tarragona";"36";"Tarragonès";"43148";"Tarragona";"7";"7";"A";"448";"208";"342";"377";"71";"0";"1";"376";"377"
"43";"Tarragona";"6";"Camp de Tarragona";"36";"Tarragonès";"43148";"Tarragona";"7";"7";"B";"524";"194";"379";"427";"97";"1";"1";"425";"426"
"43";"Tarragona";"6";"Camp de Tarragona";"36";"Tarragonès";"43148";"Tarragona";"7";"7";"C";"278";"100";"160";"192";"86";"1";"1";"190";"191"
"43";"Tarragona";"6";"Camp de Tarragona";"36";"Tarragonès";"43148";"Tarragona";"7";"8";"A";"587";"182";"420";"525";"62";"2";"1";"522";"523"
"43";"Tarragona";"6";"Camp de Tarragona";"36";"Tarragonès";"43148";"Tarragona";"7";"8";"B";"622";"169";"414";"521";"101";"0";"5";"516";"521"
"43";"Tarragona";"6";"Camp de Tarragona";"36";"Tarragonès";"43148";"Tarragona";"7";"8";"C";"685";"189";"448";"581";"104";"3";"3";"575";"578"
"43";"Tarragona";"6";"Camp de Tarragona";"36";"Tarragonès";"43148";"Tarragona";"8";"1";"A";"553";"178";"276";"348";"205";"2";"0";"346";"346"
"43";"Tarragona";"6";"Camp de Tarragona";"36";"Tarragonès";"43148";"Tarragona";"8";"1";"B";"563";"166";"279";"363";"200";"1";"0";"362";"362"
"43";"Tarragona";"6";"Camp de Tarragona";"36";"Tarragonès";"43148";"Tarragona";"8";"10";"U";"807";"191";"349";"414";"393";"0";"1";"413";"414"
"43";"Tarragona";"6";"Camp de Tarragona";"36";"Tarragonès";"43148";"Tarragona";"8";"11";"A";"459";"174";"307";"364";"95";"0";"0";"364";"364"
"43";"Tarragona";"6";"Camp de Tarragona";"36";"Tarragonès";"43148";"Tarragona";"8";"11";"B";"457";"158";"290";"353";"104";"1";"1";"351";"352"
"43";"Tarragona";"6";"Camp de Tarragona";"36";"Tarragonès";"43148";"Tarragona";"8";"12";"U";"542";"110";"201";"264";"278";"1";"0";"263";"263"
"43";"Tarragona";"6";"Camp de Tarragona";"36";"Tarragonès";"43148";"Tarragona";"8";"13";"U";"719";"237";"420";"522";"197";"1";"0";"521";"521"
"43";"Tarragona";"6";"Camp de Tarragona";"36";"Tarragonès";"43148";"Tarragona";"8";"14";"U";"534";"180";"316";"368";"166";"2";"3";"363";"366"
"43";"Tarragona";"6";"Camp de Tarragona";"36";"Tarragonès";"43148";"Tarragona";"8";"2";"A";"442";"142";"243";"294";"148";"3";"0";"291";"291"
"43";"Tarragona";"6";"Camp de Tarragona";"36";"Tarragonès";"43148";"Tarragona";"8";"2";"B";"410";"136";"242";"279";"131";"4";"0";"275";"275"
"43";"Tarragona";"6";"Camp de Tarragona";"36";"Tarragonès";"43148";"Tarragona";"8";"3";"A";"607";"189";"346";"416";"191";"1";"1";"414";"415"
"43";"Tarragona";"6";"Camp de Tarragona";"36";"Tarragonès";"43148";"Tarragona";"8";"3";"B";"641";"195";"356";"455";"186";"4";"2";"449";"451"
"43";"Tarragona";"6";"Camp de Tarragona";"36";"Tarragonès";"43148";"Tarragona";"8";"4";"U";"774";"278";"436";"549";"225";"6";"5";"538";"543"
"43";"Tarragona";"6";"Camp de Tarragona";"36";"Tarragonès";"43148";"Tarragona";"8";"5";"A";"455";"129";"252";"305";"150";"1";"0";"304";"304"
"43";"Tarragona";"6";"Camp de Tarragona";"36";"Tarragonès";"43148";"Tarragona";"8";"5";"B";"451";"172";"275";"328";"123";"2";"0";"326";"326"
"43";"Tarragona";"6";"Camp de Tarragona";"36";"Tarragonès";"43148";"Tarragona";"8";"6";"A";"678";"250";"441";"514";"164";"3";"0";"511";"511"
"43";"Tarragona";"6";"Camp de Tarragona";"36";"Tarragonès";"43148";"Tarragona";"8";"6";"B";"652";"208";"426";"526";"126";"4";"5";"517";"522"
"43";"Tarragona";"6";"Camp de Tarragona";"36";"Tarragonès";"43148";"Tarragona";"8";"7";"A";"546";"200";"317";"397";"149";"0";"3";"394";"397"
"43";"Tarragona";"6";"Camp de Tarragona";"36";"Tarragonès";"43148";"Tarragona";"8";"7";"B";"593";"232";"366";"448";"145";"0";"1";"447";"448"
"43";"Tarragona";"6";"Camp de Tarragona";"36";"Tarragonès";"43148";"Tarragona";"8";"8";"A";"423";"142";"272";"317";"106";"1";"2";"314";"316"
"43";"Tarragona";"6";"Camp de Tarragona";"36";"Tarragonès";"43148";"Tarragona";"8";"8";"B";"443";"181";"270";"282";"161";"0";"1";"281";"282"
"43";"Tarragona";"6";"Camp de Tarragona";"36";"Tarragonès";"43148";"Tarragona";"8";"9";"A";"610";"170";"348";"464";"146";"1";"3";"460";"463"
"43";"Tarragona";"6";"Camp de Tarragona";"36";"Tarragonès";"43148";"Tarragona";"8";"9";"B";"653";"191";"402";"511";"142";"0";"6";"505";"511"
"43";"Tarragona";"6";"Camp de Tarragona";"36";"Tarragonès";"43148";"Tarragona";"8";"9";"C";"683";"228";"397";"522";"161";"2";"3";"517";"520"
"43";"Tarragona";"6";"Camp de Tarragona";"36";"Tarragonès";"43148";"Tarragona";"9";"1";"A";"500";"176";"285";"365";"135";"0";"1";"364";"365"
"43";"Tarragona";"6";"Camp de Tarragona";"36";"Tarragonès";"43148";"Tarragona";"9";"1";"B";"533";"189";"328";"395";"138";"3";"4";"388";"392"
"43";"Tarragona";"6";"Camp de Tarragona";"36";"Tarragonès";"43148";"Tarragona";"9";"10";"A";"467";"158";"246";"309";"158";"1";"3";"305";"308"
"43";"Tarragona";"6";"Camp de Tarragona";"36";"Tarragonès";"43148";"Tarragona";"9";"10";"B";"502";"166";"259";"331";"171";"4";"1";"326";"327"
"43";"Tarragona";"6";"Camp de Tarragona";"36";"Tarragonès";"43148";"Tarragona";"9";"2";"U";"726";"196";"389";"493";"233";"3";"1";"489";"490"
"43";"Tarragona";"6";"Camp de Tarragona";"36";"Tarragonès";"43148";"Tarragona";"9";"3";"U";"690";"221";"394";"504";"186";"0";"2";"502";"504"
"43";"Tarragona";"6";"Camp de Tarragona";"36";"Tarragonès";"43148";"Tarragona";"9";"4";"A";"451";"154";"236";"280";"171";"1";"0";"279";"279"
"43";"Tarragona";"6";"Camp de Tarragona";"36";"Tarragonès";"43148";"Tarragona";"9";"4";"B";"476";"163";"271";"323";"153";"0";"0";"323";"323"
"43";"Tarragona";"6";"Camp de Tarragona";"36";"Tarragonès";"43148";"Tarragona";"9";"8";"U";"608";"166";"319";"408";"200";"0";"3";"405";"408"
"43";"Tarragona";"6";"Camp de Tarragona";"36";"Tarragonès";"43148";"Tarragona";"9";"9";"U";"648";"240";"376";"473";"175";"5";"0";"468";"468"
"43";"Tarragona";"6";"Camp de Tarragona";"29";"Priorat";"43151";"Torre de Fontaubella, la";"1";"1";"U";"108";"60";"83";"98";"10";"1";"0";"97";"97"
"43";"Tarragona";"6";"Camp de Tarragona";"36";"Tarragonès";"43153";"Torredembarra";"1";"1";"A";"752";"205";"415";"525";"227";"5";"1";"519";"520"
"43";"Tarragona";"6";"Camp de Tarragona";"36";"Tarragonès";"43153";"Torredembarra";"1";"1";"B";"778";"276";"485";"581";"197";"6";"2";"573";"575"
"43";"Tarragona";"6";"Camp de Tarragona";"36";"Tarragonès";"43153";"Torredembarra";"1";"2";"A";"454";"155";"292";"359";"95";"1";"3";"355";"358"
"43";"Tarragona";"6";"Camp de Tarragona";"36";"Tarragonès";"43153";"Torredembarra";"1";"2";"B";"417";"167";"271";"326";"91";"0";"0";"326";"326"
"43";"Tarragona";"6";"Camp de Tarragona";"36";"Tarragonès";"43153";"Torredembarra";"1";"3";"A";"577";"211";"367";"448";"129";"5";"1";"442";"443"
"43";"Tarragona";"6";"Camp de Tarragona";"36";"Tarragonès";"43153";"Torredembarra";"1";"3";"B";"631";"230";"397";"481";"150";"8";"3";"470";"473"
"43";"Tarragona";"6";"Camp de Tarragona";"36";"Tarragonès";"43153";"Torredembarra";"1";"4";"A";"452";"167";"297";"364";"88";"1";"0";"363";"363"
"43";"Tarragona";"6";"Camp de Tarragona";"36";"Tarragonès";"43153";"Torredembarra";"1";"4";"B";"564";"211";"370";"449";"115";"0";"2";"447";"449"
"43";"Tarragona";"6";"Camp de Tarragona";"36";"Tarragonès";"43153";"Torredembarra";"1";"4";"C";"559";"218";"373";"452";"107";"0";"1";"451";"452"
"43";"Tarragona";"6";"Camp de Tarragona";"36";"Tarragonès";"43153";"Torredembarra";"1";"5";"A";"618";"243";"385";"460";"158";"1";"4";"455";"459"
"43";"Tarragona";"6";"Camp de Tarragona";"36";"Tarragonès";"43153";"Torredembarra";"1";"5";"B";"602";"217";"361";"449";"153";"1";"0";"448";"448"
"43";"Tarragona";"6";"Camp de Tarragona";"36";"Tarragonès";"43153";"Torredembarra";"1";"6";"A";"574";"202";"316";"395";"179";"2";"2";"391";"393"
"43";"Tarragona";"6";"Camp de Tarragona";"36";"Tarragonès";"43153";"Torredembarra";"1";"6";"B";"640";"216";"354";"451";"189";"2";"2";"447";"449"
"43";"Tarragona";"6";"Camp de Tarragona";"36";"Tarragonès";"43153";"Torredembarra";"1";"6";"C";"675";"241";"383";"489";"186";"6";"1";"482";"483"
"43";"Tarragona";"6";"Camp de Tarragona";"36";"Tarragonès";"43153";"Torredembarra";"1";"7";"A";"654";"207";"381";"478";"176";"0";"5";"473";"478"
"43";"Tarragona";"6";"Camp de Tarragona";"36";"Tarragonès";"43153";"Torredembarra";"1";"7";"B";"661";"226";"418";"509";"152";"5";"5";"499";"504"
"43";"Tarragona";"6";"Camp de Tarragona";"36";"Tarragonès";"43153";"Torredembarra";"1";"8";"A";"473";"174";"289";"354";"119";"3";"3";"348";"351"
"43";"Tarragona";"6";"Camp de Tarragona";"36";"Tarragonès";"43153";"Torredembarra";"1";"8";"B";"536";"211";"322";"393";"143";"3";"2";"388";"390"
"43";"Tarragona";"6";"Camp de Tarragona";"29";"Priorat";"43154";"Torroja del Priorat";"1";"1";"U";"133";"62";"92";"120";"13";"3";"1";"116";"117"
"43";"Tarragona";"6";"Camp de Tarragona";"29";"Priorat";"43157";"Ulldemolins";"1";"1";"U";"352";"155";"270";"311";"41";"4";"2";"305";"307"
"43";"Tarragona";"6";"Camp de Tarragona";"16";"Conca de Barberà";"43158";"Vallclara";"1";"1";"U";"88";"30";"58";"74";"14";"0";"1";"73";"74"
"43";"Tarragona";"6";"Camp de Tarragona";"16";"Conca de Barberà";"43159";"Vallfogona de Riucorb";"1";"1";"U";"81";"34";"57";"69";"12";"0";"0";"69";"69"
"43";"Tarragona";"6";"Camp de Tarragona";"1";"Alt Camp";"43160";"Vallmoll";"1";"1";"A";"630";"265";"420";"498";"132";"3";"1";"494";"495"
"43";"Tarragona";"6";"Camp de Tarragona";"1";"Alt Camp";"43160";"Vallmoll";"1";"1";"B";"642";"259";"426";"489";"153";"4";"2";"483";"485"
"43";"Tarragona";"6";"Camp de Tarragona";"1";"Alt Camp";"43161";"Valls";"1";"1";"U";"541";"208";"306";"352";"189";"3";"0";"349";"349"
"43";"Tarragona";"6";"Camp de Tarragona";"1";"Alt Camp";"43161";"Valls";"2";"1";"U";"553";"176";"294";"347";"206";"3";"5";"339";"344"
"43";"Tarragona";"6";"Camp de Tarragona";"1";"Alt Camp";"43161";"Valls";"3";"1";"A";"577";"245";"405";"469";"108";"0";"3";"466";"469"
"43";"Tarragona";"6";"Camp de Tarragona";"1";"Alt Camp";"43161";"Valls";"3";"1";"B";"681";"245";"380";"464";"217";"5";"2";"457";"459"
"43";"Tarragona";"6";"Camp de Tarragona";"1";"Alt Camp";"43161";"Valls";"4";"1";"A";"430";"201";"312";"348";"82";"0";"5";"343";"348"
"43";"Tarragona";"6";"Camp de Tarragona";"1";"Alt Camp";"43161";"Valls";"4";"1";"B";"461";"199";"346";"399";"62";"4";"4";"391";"395"
"43";"Tarragona";"6";"Camp de Tarragona";"1";"Alt Camp";"43161";"Valls";"4";"2";"A";"392";"190";"235";"280";"112";"1";"2";"277";"279"
"43";"Tarragona";"6";"Camp de Tarragona";"1";"Alt Camp";"43161";"Valls";"4";"2";"B";"536";"185";"332";"399";"137";"3";"1";"395";"396"
"43";"Tarragona";"6";"Camp de Tarragona";"1";"Alt Camp";"43161";"Valls";"4";"2";"C";"351";"166";"261";"307";"44";"1";"3";"303";"306"
"43";"Tarragona";"6";"Camp de Tarragona";"1";"Alt Camp";"43161";"Valls";"4";"3";"A";"611";"205";"367";"442";"169";"2";"1";"439";"440"
"43";"Tarragona";"6";"Camp de Tarragona";"1";"Alt Camp";"43161";"Valls";"4";"3";"B";"599";"200";"353";"433";"166";"2";"2";"429";"431"
"43";"Tarragona";"6";"Camp de Tarragona";"1";"Alt Camp";"43161";"Valls";"5";"1";"A";"610";"250";"399";"494";"116";"2";"2";"490";"492"
"43";"Tarragona";"6";"Camp de Tarragona";"1";"Alt Camp";"43161";"Valls";"5";"1";"B";"673";"278";"455";"536";"137";"2";"5";"529";"534"
"43";"Tarragona";"6";"Camp de Tarragona";"1";"Alt Camp";"43161";"Valls";"5";"2";"A";"541";"197";"347";"419";"122";"0";"1";"418";"419"
"43";"Tarragona";"6";"Camp de Tarragona";"1";"Alt Camp";"43161";"Valls";"5";"2";"B";"597";"233";"370";"456";"141";"0";"3";"453";"456"
"43";"Tarragona";"6";"Camp de Tarragona";"1";"Alt Camp";"43161";"Valls";"5";"2";"C";"656";"274";"432";"533";"123";"1";"3";"529";"532"
"43";"Tarragona";"6";"Camp de Tarragona";"1";"Alt Camp";"43161";"Valls";"5";"3";"A";"436";"171";"253";"317";"119";"1";"2";"314";"316"
"43";"Tarragona";"6";"Camp de Tarragona";"1";"Alt Camp";"43161";"Valls";"5";"3";"B";"418";"180";"263";"309";"109";"1";"3";"305";"308"
"43";"Tarragona";"6";"Camp de Tarragona";"1";"Alt Camp";"43161";"Valls";"6";"1";"A";"539";"212";"341";"420";"119";"2";"0";"418";"418"
"43";"Tarragona";"6";"Camp de Tarragona";"1";"Alt Camp";"43161";"Valls";"6";"1";"B";"549";"233";"346";"425";"124";"0";"1";"424";"425"
"43";"Tarragona";"6";"Camp de Tarragona";"1";"Alt Camp";"43161";"Valls";"6";"1";"C";"564";"236";"365";"439";"125";"2";"2";"435";"437"
"43";"Tarragona";"6";"Camp de Tarragona";"1";"Alt Camp";"43161";"Valls";"6";"2";"A";"562";"226";"388";"468";"94";"0";"4";"464";"468"
"43";"Tarragona";"6";"Camp de Tarragona";"1";"Alt Camp";"43161";"Valls";"6";"2";"B";"527";"189";"356";"421";"106";"0";"2";"419";"421"
"43";"Tarragona";"6";"Camp de Tarragona";"1";"Alt Camp";"43161";"Valls";"6";"2";"C";"545";"197";"358";"432";"113";"1";"2";"429";"431"
"43";"Tarragona";"6";"Camp de Tarragona";"1";"Alt Camp";"43161";"Valls";"6";"3";"A";"596";"237";"409";"487";"109";"1";"0";"486";"486"
"43";"Tarragona";"6";"Camp de Tarragona";"1";"Alt Camp";"43161";"Valls";"6";"3";"B";"618";"252";"419";"491";"127";"1";"1";"489";"490"
"43";"Tarragona";"6";"Camp de Tarragona";"1";"Alt Camp";"43161";"Valls";"6";"4";"A";"411";"160";"240";"291";"120";"6";"2";"283";"285"
"43";"Tarragona";"6";"Camp de Tarragona";"1";"Alt Camp";"43161";"Valls";"6";"4";"B";"397";"148";"225";"276";"121";"1";"2";"273";"275"
"43";"Tarragona";"6";"Camp de Tarragona";"1";"Alt Camp";"43161";"Valls";"6";"5";"A";"640";"258";"405";"500";"140";"2";"3";"495";"498"
"43";"Tarragona";"6";"Camp de Tarragona";"1";"Alt Camp";"43161";"Valls";"6";"5";"B";"681";"267";"437";"538";"143";"2";"1";"535";"536"
"43";"Tarragona";"6";"Camp de Tarragona";"1";"Alt Camp";"43161";"Valls";"6";"6";"A";"453";"191";"287";"354";"99";"4";"5";"345";"350"
"43";"Tarragona";"6";"Camp de Tarragona";"1";"Alt Camp";"43161";"Valls";"6";"6";"B";"476";"160";"276";"358";"118";"0";"2";"356";"358"
"43";"Tarragona";"6";"Camp de Tarragona";"8";"Baix Camp";"43162";"Vandellòs i l'Hospitalet de l'Infant";"1";"1";"A";"388";"127";"287";"338";"50";"4";"3";"331";"334"
"43";"Tarragona";"6";"Camp de Tarragona";"8";"Baix Camp";"43162";"Vandellòs i l'Hospitalet de l'Infant";"1";"1";"B";"358";"114";"257";"295";"63";"2";"2";"291";"293"
"43";"Tarragona";"6";"Camp de Tarragona";"8";"Baix Camp";"43162";"Vandellòs i l'Hospitalet de l'Infant";"1";"2";"A";"486";"160";"311";"380";"106";"2";"0";"378";"378"
"43";"Tarragona";"6";"Camp de Tarragona";"8";"Baix Camp";"43162";"Vandellòs i l'Hospitalet de l'Infant";"1";"2";"B";"486";"153";"302";"374";"112";"2";"3";"369";"372"
"43";"Tarragona";"6";"Camp de Tarragona";"8";"Baix Camp";"43162";"Vandellòs i l'Hospitalet de l'Infant";"1";"3";"A";"558";"181";"333";"433";"125";"3";"4";"426";"430"
"43";"Tarragona";"6";"Camp de Tarragona";"8";"Baix Camp";"43162";"Vandellòs i l'Hospitalet de l'Infant";"1";"3";"B";"537";"178";"333";"404";"133";"0";"5";"399";"404"
"43";"Tarragona";"6";"Camp de Tarragona";"8";"Baix Camp";"43162";"Vandellòs i l'Hospitalet de l'Infant";"1";"3";"C";"536";"179";"333";"416";"120";"1";"1";"414";"415"
"43";"Tarragona";"6";"Camp de Tarragona";"8";"Baix Camp";"43162";"Vandellòs i l'Hospitalet de l'Infant";"1";"4";"A";"477";"135";"281";"349";"128";"0";"2";"347";"349"
"43";"Tarragona";"6";"Camp de Tarragona";"8";"Baix Camp";"43162";"Vandellòs i l'Hospitalet de l'Infant";"1";"4";"B";"482";"161";"296";"364";"118";"2";"2";"360";"362"
"43";"Tarragona";"6";"Camp de Tarragona";"12";"Baix Penedès";"43163";"Vendrell, el";"1";"1";"A";"446";"177";"280";"338";"108";"1";"1";"336";"337"
"43";"Tarragona";"6";"Camp de Tarragona";"12";"Baix Penedès";"43163";"Vendrell, el";"1";"1";"B";"504";"194";"315";"381";"123";"3";"1";"377";"378"
"43";"Tarragona";"6";"Camp de Tarragona";"12";"Baix Penedès";"43163";"Vendrell, el";"1";"2";"A";"445";"174";"284";"329";"116";"2";"4";"323";"327"
"43";"Tarragona";"6";"Camp de Tarragona";"12";"Baix Penedès";"43163";"Vendrell, el";"1";"2";"B";"488";"207";"322";"364";"124";"0";"1";"363";"364"
"43";"Tarragona";"6";"Camp de Tarragona";"12";"Baix Penedès";"43163";"Vendrell, el";"1";"3";"A";"600";"193";"335";"438";"162";"5";"2";"431";"433"
"43";"Tarragona";"6";"Camp de Tarragona";"12";"Baix Penedès";"43163";"Vendrell, el";"1";"3";"B";"644";"202";"394";"491";"153";"2";"3";"486";"489"
"43";"Tarragona";"6";"Camp de Tarragona";"12";"Baix Penedès";"43163";"Vendrell, el";"2";"1";"A";"396";"116";"225";"281";"115";"3";"1";"277";"278"
"43";"Tarragona";"6";"Camp de Tarragona";"12";"Baix Penedès";"43163";"Vendrell, el";"2";"1";"B";"394";"143";"243";"292";"102";"1";"1";"290";"291"
"43";"Tarragona";"6";"Camp de Tarragona";"12";"Baix Penedès";"43163";"Vendrell, el";"2";"2";"A";"638";"215";"317";"392";"246";"2";"3";"387";"390"
"43";"Tarragona";"6";"Camp de Tarragona";"12";"Baix Penedès";"43163";"Vendrell, el";"2";"2";"B";"706";"249";"395";"481";"225";"8";"2";"471";"473"
"43";"Tarragona";"6";"Camp de Tarragona";"12";"Baix Penedès";"43163";"Vendrell, el";"2";"3";"A";"527";"188";"295";"345";"182";"2";"4";"339";"343"
"43";"Tarragona";"6";"Camp de Tarragona";"12";"Baix Penedès";"43163";"Vendrell, el";"2";"3";"B";"559";"185";"304";"365";"194";"2";"1";"362";"363"
"43";"Tarragona";"6";"Camp de Tarragona";"12";"Baix Penedès";"43163";"Vendrell, el";"2";"3";"C";"543";"175";"301";"353";"190";"1";"4";"348";"352"
"43";"Tarragona";"6";"Camp de Tarragona";"12";"Baix Penedès";"43163";"Vendrell, el";"2";"4";"A";"795";"198";"417";"536";"259";"5";"3";"528";"531"
"43";"Tarragona";"6";"Camp de Tarragona";"12";"Baix Penedès";"43163";"Vendrell, el";"2";"4";"B";"770";"224";"426";"521";"249";"6";"2";"513";"515"
"43";"Tarragona";"6";"Camp de Tarragona";"12";"Baix Penedès";"43163";"Vendrell, el";"2";"5";"A";"584";"209";"391";"428";"156";"2";"2";"424";"426"
"43";"Tarragona";"6";"Camp de Tarragona";"12";"Baix Penedès";"43163";"Vendrell, el";"2";"5";"B";"606";"235";"367";"436";"170";"3";"3";"430";"433"
"43";"Tarragona";"6";"Camp de Tarragona";"12";"Baix Penedès";"43163";"Vendrell, el";"2";"5";"C";"647";"249";"408";"471";"176";"4";"2";"465";"467"
"43";"Tarragona";"6";"Camp de Tarragona";"12";"Baix Penedès";"43163";"Vendrell, el";"3";"1";"A";"535";"174";"352";"386";"149";"0";"2";"384";"386"
"43";"Tarragona";"6";"Camp de Tarragona";"12";"Baix Penedès";"43163";"Vendrell, el";"3";"1";"B";"574";"206";"315";"449";"125";"0";"0";"449";"449"
"43";"Tarragona";"6";"Camp de Tarragona";"12";"Baix Penedès";"43163";"Vendrell, el";"3";"10";"U";"658";"200";"435";"534";"124";"4";"2";"528";"530"
"43";"Tarragona";"6";"Camp de Tarragona";"12";"Baix Penedès";"43163";"Vendrell, el";"3";"11";"A";"441";"247";"289";"351";"90";"0";"1";"350";"351"
"43";"Tarragona";"6";"Camp de Tarragona";"12";"Baix Penedès";"43163";"Vendrell, el";"3";"11";"B";"514";"197";"334";"399";"115";"4";"2";"393";"395"
"43";"Tarragona";"6";"Camp de Tarragona";"12";"Baix Penedès";"43163";"Vendrell, el";"3";"12";"A";"676";"204";"372";"463";"213";"6";"0";"457";"457"
"43";"Tarragona";"6";"Camp de Tarragona";"12";"Baix Penedès";"43163";"Vendrell, el";"3";"12";"B";"660";"232";"443";"465";"195";"2";"2";"461";"463"
"43";"Tarragona";"6";"Camp de Tarragona";"12";"Baix Penedès";"43163";"Vendrell, el";"3";"13";"A";"444";"154";"232";"304";"140";"3";"2";"299";"301"
"43";"Tarragona";"6";"Camp de Tarragona";"12";"Baix Penedès";"43163";"Vendrell, el";"3";"13";"B";"373";"151";"258";"282";"91";"3";"0";"279";"279"
"43";"Tarragona";"6";"Camp de Tarragona";"12";"Baix Penedès";"43163";"Vendrell, el";"3";"2";"A";"764";"251";"428";"530";"234";"2";"7";"521";"528"
"43";"Tarragona";"6";"Camp de Tarragona";"12";"Baix Penedès";"43163";"Vendrell, el";"3";"2";"B";"753";"245";"432";"530";"223";"2";"9";"519";"528"
"43";"Tarragona";"6";"Camp de Tarragona";"12";"Baix Penedès";"43163";"Vendrell, el";"3";"3";"A";"661";"246";"393";"463";"198";"4";"1";"458";"459"
"43";"Tarragona";"6";"Camp de Tarragona";"12";"Baix Penedès";"43163";"Vendrell, el";"3";"3";"B";"606";"220";"357";"427";"179";"3";"1";"423";"424"
"43";"Tarragona";"6";"Camp de Tarragona";"12";"Baix Penedès";"43163";"Vendrell, el";"3";"4";"A";"605";"207";"355";"442";"163";"7";"5";"430";"435"
"43";"Tarragona";"6";"Camp de Tarragona";"12";"Baix Penedès";"43163";"Vendrell, el";"3";"4";"B";"615";"230";"369";"455";"160";"7";"4";"444";"448"
"43";"Tarragona";"6";"Camp de Tarragona";"12";"Baix Penedès";"43163";"Vendrell, el";"3";"5";"A";"454";"156";"274";"334";"120";"1";"2";"331";"333"
"43";"Tarragona";"6";"Camp de Tarragona";"12";"Baix Penedès";"43163";"Vendrell, el";"3";"5";"B";"451";"140";"244";"319";"132";"2";"1";"316";"317"
"43";"Tarragona";"6";"Camp de Tarragona";"12";"Baix Penedès";"43163";"Vendrell, el";"3";"6";"A";"729";"216";"423";"532";"197";"2";"4";"526";"530"
"43";"Tarragona";"6";"Camp de Tarragona";"12";"Baix Penedès";"43163";"Vendrell, el";"3";"6";"B";"720";"250";"435";"541";"179";"4";"3";"534";"537"
"43";"Tarragona";"6";"Camp de Tarragona";"12";"Baix Penedès";"43163";"Vendrell, el";"3";"7";"A";"455";"179";"267";"318";"137";"5";"2";"311";"313"
"43";"Tarragona";"6";"Camp de Tarragona";"12";"Baix Penedès";"43163";"Vendrell, el";"3";"7";"B";"421";"170";"254";"313";"108";"2";"1";"310";"311"
"43";"Tarragona";"6";"Camp de Tarragona";"12";"Baix Penedès";"43163";"Vendrell, el";"3";"8";"A";"463";"148";"293";"350";"113";"3";"1";"346";"347"
"43";"Tarragona";"6";"Camp de Tarragona";"12";"Baix Penedès";"43163";"Vendrell, el";"3";"8";"B";"578";"188";"369";"435";"143";"2";"2";"431";"433"
"43";"Tarragona";"6";"Camp de Tarragona";"12";"Baix Penedès";"43163";"Vendrell, el";"3";"8";"C";"569";"209";"349";"422";"147";"1";"0";"421";"421"
"43";"Tarragona";"6";"Camp de Tarragona";"12";"Baix Penedès";"43163";"Vendrell, el";"3";"9";"A";"586";"196";"339";"432";"154";"2";"2";"428";"430"
"43";"Tarragona";"6";"Camp de Tarragona";"12";"Baix Penedès";"43163";"Vendrell, el";"3";"9";"B";"617";"207";"377";"464";"153";"0";"1";"463";"464"
"43";"Tarragona";"6";"Camp de Tarragona";"36";"Tarragonès";"43164";"Vespella de Gaià";"1";"1";"U";"300";"132";"178";"233";"67";"2";"2";"229";"231"
"43";"Tarragona";"6";"Camp de Tarragona";"1";"Alt Camp";"43170";"Vila-rodona";"1";"1";"A";"449";"182";"307";"382";"67";"3";"6";"373";"379"
"43";"Tarragona";"6";"Camp de Tarragona";"1";"Alt Camp";"43170";"Vila-rodona";"1";"1";"B";"415";"159";"285";"345";"70";"3";"5";"337";"342"
"43";"Tarragona";"6";"Camp de Tarragona";"36";"Tarragonès";"43171";"Vila-seca";"1";"1";"A";"539";"179";"324";"400";"139";"1";"0";"399";"399"
"43";"Tarragona";"6";"Camp de Tarragona";"36";"Tarragonès";"43171";"Vila-seca";"1";"1";"B";"593";"211";"386";"469";"124";"1";"2";"466";"468"
"43";"Tarragona";"6";"Camp de Tarragona";"36";"Tarragonès";"43171";"Vila-seca";"1";"1";"C";"569";"203";"364";"453";"116";"1";"5";"447";"452"
"43";"Tarragona";"6";"Camp de Tarragona";"36";"Tarragonès";"43171";"Vila-seca";"1";"10";"A";"554";"163";"309";"407";"147";"3";"2";"402";"404"
"43";"Tarragona";"6";"Camp de Tarragona";"36";"Tarragonès";"43171";"Vila-seca";"1";"10";"B";"511";"160";"295";"390";"121";"2";"0";"388";"388"
"43";"Tarragona";"6";"Camp de Tarragona";"36";"Tarragonès";"43171";"Vila-seca";"1";"11";"A";"522";"197";"329";"418";"104";"1";"1";"416";"417"
"43";"Tarragona";"6";"Camp de Tarragona";"36";"Tarragonès";"43171";"Vila-seca";"1";"11";"B";"599";"187";"368";"456";"143";"2";"1";"453";"454"
"43";"Tarragona";"6";"Camp de Tarragona";"36";"Tarragonès";"43171";"Vila-seca";"1";"11";"C";"604";"236";"404";"491";"113";"0";"2";"489";"491"
"43";"Tarragona";"6";"Camp de Tarragona";"36";"Tarragonès";"43171";"Vila-seca";"1";"12";"U";"497";"158";"316";"382";"115";"4";"1";"377";"378"
"43";"Tarragona";"6";"Camp de Tarragona";"36";"Tarragonès";"43171";"Vila-seca";"1";"2";"A";"511";"180";"316";"394";"117";"1";"2";"391";"393"
"43";"Tarragona";"6";"Camp de Tarragona";"36";"Tarragonès";"43171";"Vila-seca";"1";"2";"B";"568";"177";"342";"442";"126";"2";"2";"438";"440"
"43";"Tarragona";"6";"Camp de Tarragona";"36";"Tarragonès";"43171";"Vila-seca";"1";"2";"C";"588";"234";"397";"484";"104";"1";"1";"482";"483"
"43";"Tarragona";"6";"Camp de Tarragona";"36";"Tarragonès";"43171";"Vila-seca";"1";"3";"A";"330";"125";"183";"247";"83";"1";"2";"244";"246"
"43";"Tarragona";"6";"Camp de Tarragona";"36";"Tarragonès";"43171";"Vila-seca";"1";"3";"B";"492";"158";"280";"348";"144";"2";"0";"346";"346"
"43";"Tarragona";"6";"Camp de Tarragona";"36";"Tarragonès";"43171";"Vila-seca";"1";"4";"U";"618";"273";"413";"487";"131";"2";"1";"484";"485"
"43";"Tarragona";"6";"Camp de Tarragona";"36";"Tarragonès";"43171";"Vila-seca";"1";"5";"A";"483";"184";"285";"348";"135";"2";"2";"344";"346"
"43";"Tarragona";"6";"Camp de Tarragona";"36";"Tarragonès";"43171";"Vila-seca";"1";"5";"B";"506";"189";"314";"385";"121";"1";"2";"382";"384"
"43";"Tarragona";"6";"Camp de Tarragona";"36";"Tarragonès";"43171";"Vila-seca";"1";"6";"A";"594";"210";"367";"464";"130";"1";"3";"460";"463"
"43";"Tarragona";"6";"Camp de Tarragona";"36";"Tarragonès";"43171";"Vila-seca";"1";"6";"B";"547";"191";"315";"417";"130";"1";"1";"415";"416"
"43";"Tarragona";"6";"Camp de Tarragona";"36";"Tarragonès";"43171";"Vila-seca";"1";"7";"A";"698";"240";"404";"506";"192";"2";"0";"504";"504"
"43";"Tarragona";"6";"Camp de Tarragona";"36";"Tarragonès";"43171";"Vila-seca";"1";"7";"B";"776";"257";"443";"574";"202";"2";"3";"569";"572"
"43";"Tarragona";"6";"Camp de Tarragona";"36";"Tarragonès";"43171";"Vila-seca";"1";"8";"A";"537";"172";"279";"340";"197";"3";"1";"336";"337"
"43";"Tarragona";"6";"Camp de Tarragona";"36";"Tarragonès";"43171";"Vila-seca";"1";"8";"B";"599";"137";"253";"336";"263";"2";"3";"331";"334"
"43";"Tarragona";"6";"Camp de Tarragona";"36";"Tarragonès";"43171";"Vila-seca";"1";"8";"C";"578";"187";"290";"351";"227";"0";"0";"351";"351"
"43";"Tarragona";"6";"Camp de Tarragona";"36";"Tarragonès";"43171";"Vila-seca";"1";"9";"A";"524";"177";"302";"396";"128";"3";"0";"393";"393"
"43";"Tarragona";"6";"Camp de Tarragona";"36";"Tarragonès";"43171";"Vila-seca";"1";"9";"B";"621";"221";"390";"490";"131";"2";"1";"487";"488"
"43";"Tarragona";"6";"Camp de Tarragona";"1";"Alt Camp";"43165";"Vilabella";"1";"1";"U";"582";"262";"447";"507";"75";"1";"6";"500";"506"
"43";"Tarragona";"6";"Camp de Tarragona";"36";"Tarragonès";"43166";"Vilallonga del Camp";"1";"1";"A";"475";"161";"289";"375";"100";"3";"1";"371";"372"
"43";"Tarragona";"6";"Camp de Tarragona";"36";"Tarragonès";"43166";"Vilallonga del Camp";"1";"1";"B";"532";"211";"339";"432";"100";"4";"1";"427";"428"
"43";"Tarragona";"6";"Camp de Tarragona";"36";"Tarragonès";"43166";"Vilallonga del Camp";"1";"1";"C";"555";"206";"365";"454";"101";"2";"2";"450";"452"
"43";"Tarragona";"6";"Camp de Tarragona";"8";"Baix Camp";"43167";"Vilanova d'Escornalbou";"1";"1";"U";"381";"166";"267";"327";"54";"1";"1";"325";"326"
"43";"Tarragona";"6";"Camp de Tarragona";"16";"Conca de Barberà";"43168";"Vilanova de Prades";"1";"1";"U";"94";"44";"64";"78";"16";"0";"1";"77";"78"
"43";"Tarragona";"6";"Camp de Tarragona";"8";"Baix Camp";"43169";"Vilaplana";"1";"1";"U";"458";"192";"353";"409";"49";"4";"7";"398";"405"
"43";"Tarragona";"6";"Camp de Tarragona";"16";"Conca de Barberà";"43172";"Vilaverd";"1";"1";"U";"350";"154";"252";"293";"57";"5";"1";"287";"288"
"43";"Tarragona";"6";"Camp de Tarragona";"29";"Priorat";"43173";"Vilella Alta, la";"1";"1";"U";"99";"43";"72";"87";"12";"1";"1";"85";"86"
"43";"Tarragona";"6";"Camp de Tarragona";"29";"Priorat";"43174";"Vilella Baixa, la";"1";"1";"U";"142";"55";"100";"125";"17";"0";"2";"123";"125"
"43";"Tarragona";"6";"Camp de Tarragona";"16";"Conca de Barberà";"43176";"Vimbodí i Poblet";"1";"1";"A";"417";"192";"308";"359";"58";"0";"5";"354";"359"
"43";"Tarragona";"6";"Camp de Tarragona";"16";"Conca de Barberà";"43176";"Vimbodí i Poblet";"1";"1";"B";"376";"172";"275";"314";"62";"1";"4";"309";"313"
"43";"Tarragona";"6";"Camp de Tarragona";"8";"Baix Camp";"43178";"Vinyols i els Arcs";"1";"1";"A";"409";"188";"273";"336";"73";"2";"6";"328";"334"
"43";"Tarragona";"6";"Camp de Tarragona";"8";"Baix Camp";"43178";"Vinyols i els Arcs";"1";"1";"B";"574";"282";"407";"481";"93";"1";"4";"476";"480"
"43";"Tarragona";"6";"Camp de Tarragona";"8";"Baix Camp";"43178";"Vinyols i els Arcs";"1";"1";"C";"342";"143";"217";"263";"79";"2";"1";"260";"261"
"43";"Tarragona";"7";"Terres de l'Ebre";"22";"Montsià";"43004";"Alcanar";"1";"1";"A";"497";"164";"275";"356";"141";"2";"8";"346";"354"
"43";"Tarragona";"7";"Terres de l'Ebre";"22";"Montsià";"43004";"Alcanar";"1";"1";"B";"575";"223";"361";"452";"123";"4";"4";"444";"448"
"43";"Tarragona";"7";"Terres de l'Ebre";"22";"Montsià";"43004";"Alcanar";"1";"2";"A";"582";"199";"361";"440";"142";"3";"6";"431";"437"
"43";"Tarragona";"7";"Terres de l'Ebre";"22";"Montsià";"43004";"Alcanar";"1";"2";"B";"597";"200";"345";"444";"153";"4";"9";"431";"440"
"43";"Tarragona";"7";"Terres de l'Ebre";"22";"Montsià";"43004";"Alcanar";"1";"3";"A";"770";"281";"458";"557";"213";"0";"1";"556";"557"
"43";"Tarragona";"7";"Terres de l'Ebre";"22";"Montsià";"43004";"Alcanar";"1";"3";"B";"764";"237";"427";"539";"225";"2";"5";"532";"537"
"43";"Tarragona";"7";"Terres de l'Ebre";"22";"Montsià";"43004";"Alcanar";"1";"4";"A";"509";"196";"327";"410";"99";"3";"5";"402";"407"
"43";"Tarragona";"7";"Terres de l'Ebre";"22";"Montsià";"43004";"Alcanar";"1";"4";"B";"536";"200";"340";"434";"102";"6";"2";"426";"428"
"43";"Tarragona";"7";"Terres de l'Ebre";"22";"Montsià";"43004";"Alcanar";"2";"1";"A";"455";"161";"270";"325";"130";"4";"6";"315";"321"
"43";"Tarragona";"7";"Terres de l'Ebre";"22";"Montsià";"43004";"Alcanar";"2";"1";"B";"493";"162";"290";"365";"128";"9";"4";"352";"356"
"43";"Tarragona";"7";"Terres de l'Ebre";"22";"Montsià";"43004";"Alcanar";"2";"2";"U";"553";"219";"350";"411";"142";"4";"3";"404";"407"
"43";"Tarragona";"7";"Terres de l'Ebre";"9";"Baix Ebre";"43904";"Aldea, l'";"1";"1";"A";"563";"212";"320";"415";"148";"10";"5";"400";"405"
"43";"Tarragona";"7";"Terres de l'Ebre";"9";"Baix Ebre";"43904";"Aldea, l'";"1";"1";"B";"541";"196";"304";"374";"167";"5";"10";"359";"369"
"43";"Tarragona";"7";"Terres de l'Ebre";"9";"Baix Ebre";"43904";"Aldea, l'";"1";"1";"C";"549";"199";"317";"396";"153";"6";"10";"380";"390"
"43";"Tarragona";"7";"Terres de l'Ebre";"9";"Baix Ebre";"43904";"Aldea, l'";"1";"2";"A";"705";"246";"419";"514";"191";"5";"9";"500";"509"
"43";"Tarragona";"7";"Terres de l'Ebre";"9";"Baix Ebre";"43904";"Aldea, l'";"1";"2";"B";"556";"195";"315";"399";"157";"0";"11";"388";"399"
"43";"Tarragona";"7";"Terres de l'Ebre";"9";"Baix Ebre";"43006";"Aldover";"1";"1";"U";"689";"234";"423";"518";"171";"7";"3";"508";"511"
"43";"Tarragona";"7";"Terres de l'Ebre";"9";"Baix Ebre";"43008";"Alfara de Carles";"1";"1";"U";"306";"66";"166";"205";"101";"3";"5";"197";"202"
"43";"Tarragona";"7";"Terres de l'Ebre";"9";"Baix Ebre";"43013";"Ametlla de Mar, l'";"1";"1";"A";"672";"267";"433";"534";"138";"4";"3";"527";"530"
"43";"Tarragona";"7";"Terres de l'Ebre";"9";"Baix Ebre";"43013";"Ametlla de Mar, l'";"1";"1";"B";"739";"319";"500";"580";"159";"7";"1";"572";"573"
"43";"Tarragona";"7";"Terres de l'Ebre";"9";"Baix Ebre";"43013";"Ametlla de Mar, l'";"1";"2";"A";"510";"203";"339";"415";"95";"2";"1";"412";"413"
"43";"Tarragona";"7";"Terres de l'Ebre";"9";"Baix Ebre";"43013";"Ametlla de Mar, l'";"1";"2";"B";"526";"257";"350";"412";"114";"0";"2";"410";"412"
"43";"Tarragona";"7";"Terres de l'Ebre";"9";"Baix Ebre";"43013";"Ametlla de Mar, l'";"1";"3";"A";"653";"273";"390";"494";"159";"4";"1";"489";"490"
"43";"Tarragona";"7";"Terres de l'Ebre";"9";"Baix Ebre";"43013";"Ametlla de Mar, l'";"1";"3";"B";"680";"278";"411";"505";"175";"0";"1";"504";"505"
"43";"Tarragona";"7";"Terres de l'Ebre";"9";"Baix Ebre";"43013";"Ametlla de Mar, l'";"1";"3";"C";"642";"241";"336";"451";"191";"4";"2";"445";"447"
"43";"Tarragona";"7";"Terres de l'Ebre";"9";"Baix Ebre";"43906";"Ampolla, l'";"1";"1";"A";"589";"245";"378";"462";"127";"6";"1";"455";"456"
"43";"Tarragona";"7";"Terres de l'Ebre";"9";"Baix Ebre";"43906";"Ampolla, l'";"1";"1";"B";"552";"209";"343";"421";"131";"3";"3";"415";"418"
"43";"Tarragona";"7";"Terres de l'Ebre";"9";"Baix Ebre";"43906";"Ampolla, l'";"1";"2";"A";"510";"224";"349";"424";"86";"2";"5";"417";"422"
"43";"Tarragona";"7";"Terres de l'Ebre";"9";"Baix Ebre";"43906";"Ampolla, l'";"1";"2";"B";"454";"207";"311";"363";"91";"5";"1";"357";"358"
"43";"Tarragona";"7";"Terres de l'Ebre";"22";"Montsià";"43014";"Amposta";"1";"1";"U";"596";"240";"355";"420";"176";"2";"2";"416";"418"
"43";"Tarragona";"7";"Terres de l'Ebre";"22";"Montsià";"43014";"Amposta";"1";"2";"A";"751";"330";"467";"565";"186";"5";"3";"557";"560"
"43";"Tarragona";"7";"Terres de l'Ebre";"22";"Montsià";"43014";"Amposta";"1";"2";"B";"208";"110";"144";"159";"49";"0";"2";"157";"159"
"43";"Tarragona";"7";"Terres de l'Ebre";"22";"Montsià";"43014";"Amposta";"2";"1";"U";"708";"277";"428";"543";"165";"2";"2";"539";"541"
"43";"Tarragona";"7";"Terres de l'Ebre";"22";"Montsià";"43014";"Amposta";"2";"2";"U";"665";"267";"427";"482";"183";"2";"9";"471";"480"
"43";"Tarragona";"7";"Terres de l'Ebre";"22";"Montsià";"43014";"Amposta";"3";"1";"A";"452";"145";"245";"316";"136";"1";"5";"310";"315"
"43";"Tarragona";"7";"Terres de l'Ebre";"22";"Montsià";"43014";"Amposta";"3";"1";"B";"376";"134";"236";"290";"86";"0";"3";"287";"290"
"43";"Tarragona";"7";"Terres de l'Ebre";"22";"Montsià";"43014";"Amposta";"3";"2";"A";"690";"276";"423";"504";"186";"2";"8";"494";"502"
"43";"Tarragona";"7";"Terres de l'Ebre";"22";"Montsià";"43014";"Amposta";"3";"2";"B";"655";"242";"354";"440";"215";"5";"1";"434";"435"
"43";"Tarragona";"7";"Terres de l'Ebre";"22";"Montsià";"43014";"Amposta";"4";"1";"A";"516";"195";"315";"377";"139";"3";"3";"371";"374"
"43";"Tarragona";"7";"Terres de l'Ebre";"22";"Montsià";"43014";"Amposta";"4";"1";"B";"491";"187";"307";"367";"124";"2";"1";"364";"365"
"43";"Tarragona";"7";"Terres de l'Ebre";"22";"Montsià";"43014";"Amposta";"4";"2";"A";"558";"200";"320";"397";"161";"6";"2";"389";"391"
"43";"Tarragona";"7";"Terres de l'Ebre";"22";"Montsià";"43014";"Amposta";"4";"2";"B";"535";"190";"316";"383";"152";"10";"8";"365";"373"
"43";"Tarragona";"7";"Terres de l'Ebre";"22";"Montsià";"43014";"Amposta";"4";"3";"A";"568";"217";"340";"420";"148";"2";"2";"416";"418"
"43";"Tarragona";"7";"Terres de l'Ebre";"22";"Montsià";"43014";"Amposta";"4";"3";"B";"508";"202";"311";"375";"133";"4";"2";"369";"371"
"43";"Tarragona";"7";"Terres de l'Ebre";"22";"Montsià";"43014";"Amposta";"4";"3";"C";"579";"221";"341";"417";"162";"3";"4";"410";"414"
"43";"Tarragona";"7";"Terres de l'Ebre";"22";"Montsià";"43014";"Amposta";"4";"4";"A";"579";"205";"332";"428";"151";"4";"3";"421";"424"
"43";"Tarragona";"7";"Terres de l'Ebre";"22";"Montsià";"43014";"Amposta";"4";"4";"B";"673";"257";"415";"523";"150";"2";"5";"516";"521"
"43";"Tarragona";"7";"Terres de l'Ebre";"22";"Montsià";"43014";"Amposta";"4";"4";"C";"682";"278";"441";"537";"145";"2";"2";"533";"535"
"43";"Tarragona";"7";"Terres de l'Ebre";"22";"Montsià";"43014";"Amposta";"4";"5";"A";"671";"190";"361";"476";"195";"1";"3";"472";"475"
"43";"Tarragona";"7";"Terres de l'Ebre";"22";"Montsià";"43014";"Amposta";"4";"5";"B";"590";"181";"329";"425";"165";"0";"4";"421";"425"
"43";"Tarragona";"7";"Terres de l'Ebre";"22";"Montsià";"43014";"Amposta";"4";"5";"C";"672";"195";"353";"459";"213";"2";"1";"456";"457"
"43";"Tarragona";"7";"Terres de l'Ebre";"22";"Montsià";"43014";"Amposta";"4";"6";"A";"761";"220";"408";"540";"221";"3";"6";"531";"537"
"43";"Tarragona";"7";"Terres de l'Ebre";"22";"Montsià";"43014";"Amposta";"4";"6";"B";"775";"215";"398";"528";"247";"4";"6";"518";"524"
"43";"Tarragona";"7";"Terres de l'Ebre";"37";"Terra Alta";"43018";"Arnes";"1";"1";"U";"413";"185";"311";"346";"67";"4";"6";"336";"342"
"43";"Tarragona";"7";"Terres de l'Ebre";"30";"Ribera d'Ebre";"43019";"Ascó";"1";"1";"A";"686";"231";"414";"533";"153";"4";"3";"526";"529"
"43";"Tarragona";"7";"Terres de l'Ebre";"30";"Ribera d'Ebre";"43019";"Ascó";"1";"1";"B";"684";"209";"390";"513";"171";"11";"4";"498";"502"
"43";"Tarragona";"7";"Terres de l'Ebre";"37";"Terra Alta";"43022";"Batea";"1";"1";"A";"400";"115";"248";"318";"82";"3";"4";"311";"315"
"43";"Tarragona";"7";"Terres de l'Ebre";"37";"Terra Alta";"43022";"Batea";"1";"1";"B";"445";"110";"246";"343";"102";"3";"3";"337";"340"
"43";"Tarragona";"7";"Terres de l'Ebre";"37";"Terra Alta";"43022";"Batea";"1";"2";"U";"662";"205";"375";"508";"154";"6";"4";"498";"502"
"43";"Tarragona";"7";"Terres de l'Ebre";"9";"Baix Ebre";"43025";"Benifallet";"1";"1";"U";"608";"199";"364";"473";"135";"4";"3";"466";"469"
"43";"Tarragona";"7";"Terres de l'Ebre";"30";"Ribera d'Ebre";"43026";"Benissanet";"1";"1";"A";"384";"134";"254";"320";"64";"3";"5";"312";"317"
"43";"Tarragona";"7";"Terres de l'Ebre";"30";"Ribera d'Ebre";"43026";"Benissanet";"1";"1";"B";"411";"158";"278";"332";"79";"3";"1";"328";"329"
"43";"Tarragona";"7";"Terres de l'Ebre";"37";"Terra Alta";"43032";"Bot";"1";"1";"U";"520";"182";"285";"410";"110";"1";"6";"403";"409"
"43";"Tarragona";"7";"Terres de l'Ebre";"9";"Baix Ebre";"43903";"Camarles";"1";"1";"A";"596";"231";"373";"457";"139";"1";"5";"451";"456"
"43";"Tarragona";"7";"Terres de l'Ebre";"9";"Baix Ebre";"43903";"Camarles";"1";"1";"B";"545";"196";"330";"405";"140";"6";"2";"397";"399"
"43";"Tarragona";"7";"Terres de l'Ebre";"9";"Baix Ebre";"43903";"Camarles";"1";"1";"C";"467";"183";"295";"362";"105";"2";"2";"358";"360"
"43";"Tarragona";"7";"Terres de l'Ebre";"9";"Baix Ebre";"43903";"Camarles";"1";"2";"U";"767";"225";"394";"475";"292";"1";"15";"459";"474"
"43";"Tarragona";"7";"Terres de l'Ebre";"37";"Terra Alta";"43041";"Caseres";"1";"1";"U";"226";"53";"136";"172";"54";"6";"1";"165";"166"
"43";"Tarragona";"7";"Terres de l'Ebre";"37";"Terra Alta";"43048";"Corbera d'Ebre";"1";"1";"A";"438";"136";"266";"350";"88";"4";"5";"341";"346"
"43";"Tarragona";"7";"Terres de l'Ebre";"37";"Terra Alta";"43048";"Corbera d'Ebre";"1";"1";"B";"364";"117";"229";"295";"69";"2";"9";"284";"293"
"43";"Tarragona";"7";"Terres de l'Ebre";"9";"Baix Ebre";"43901";"Deltebre";"1";"1";"A";"775";"217";"380";"497";"278";"12";"8";"477";"485"
"43";"Tarragona";"7";"Terres de l'Ebre";"9";"Baix Ebre";"43901";"Deltebre";"1";"1";"B";"788";"228";"404";"521";"267";"10";"10";"501";"511"
"43";"Tarragona";"7";"Terres de l'Ebre";"9";"Baix Ebre";"43901";"Deltebre";"1";"2";"A";"704";"235";"397";"476";"228";"2";"5";"469";"474"
"43";"Tarragona";"7";"Terres de l'Ebre";"9";"Baix Ebre";"43901";"Deltebre";"1";"2";"B";"521";"170";"284";"353";"168";"3";"10";"340";"350"
"43";"Tarragona";"7";"Terres de l'Ebre";"9";"Baix Ebre";"43901";"Deltebre";"1";"2";"C";"565";"182";"291";"371";"194";"5";"7";"359";"366"
"43";"Tarragona";"7";"Terres de l'Ebre";"9";"Baix Ebre";"43901";"Deltebre";"1";"3";"A";"487";"150";"280";"362";"125";"3";"8";"351";"359"
"43";"Tarragona";"7";"Terres de l'Ebre";"9";"Baix Ebre";"43901";"Deltebre";"1";"3";"B";"528";"170";"281";"373";"155";"5";"6";"362";"368"
"43";"Tarragona";"7";"Terres de l'Ebre";"9";"Baix Ebre";"43901";"Deltebre";"1";"4";"A";"746";"276";"427";"526";"220";"2";"5";"519";"524"
"43";"Tarragona";"7";"Terres de l'Ebre";"9";"Baix Ebre";"43901";"Deltebre";"1";"4";"B";"716";"249";"396";"496";"220";"8";"7";"481";"488"
"43";"Tarragona";"7";"Terres de l'Ebre";"9";"Baix Ebre";"43901";"Deltebre";"1";"5";"A";"667";"243";"387";"488";"179";"7";"6";"475";"481"
"43";"Tarragona";"7";"Terres de l'Ebre";"9";"Baix Ebre";"43901";"Deltebre";"1";"5";"B";"619";"195";"322";"420";"199";"6";"11";"403";"414"
"43";"Tarragona";"7";"Terres de l'Ebre";"9";"Baix Ebre";"43901";"Deltebre";"1";"6";"A";"639";"240";"383";"473";"166";"7";"9";"457";"466"
"43";"Tarragona";"7";"Terres de l'Ebre";"9";"Baix Ebre";"43901";"Deltebre";"1";"6";"B";"481";"156";"232";"299";"182";"10";"5";"284";"289"
"43";"Tarragona";"7";"Terres de l'Ebre";"9";"Baix Ebre";"43901";"Deltebre";"1";"6";"C";"538";"178";"298";"370";"168";"3";"8";"359";"367"
"43";"Tarragona";"7";"Terres de l'Ebre";"37";"Terra Alta";"43056";"Fatarella, la";"1";"1";"A";"456";"127";"273";"357";"99";"8";"4";"345";"349"
"43";"Tarragona";"7";"Terres de l'Ebre";"37";"Terra Alta";"43056";"Fatarella, la";"1";"1";"B";"416";"100";"239";"315";"101";"1";"3";"311";"314"
"43";"Tarragona";"7";"Terres de l'Ebre";"30";"Ribera d'Ebre";"43060";"Flix";"1";"1";"A";"475";"175";"310";"394";"81";"1";"3";"390";"393"
"43";"Tarragona";"7";"Terres de l'Ebre";"30";"Ribera d'Ebre";"43060";"Flix";"1";"1";"B";"404";"150";"262";"324";"80";"3";"1";"320";"321"
"43";"Tarragona";"7";"Terres de l'Ebre";"30";"Ribera d'Ebre";"43060";"Flix";"1";"2";"A";"534";"178";"346";"438";"96";"3";"4";"431";"435"
"43";"Tarragona";"7";"Terres de l'Ebre";"30";"Ribera d'Ebre";"43060";"Flix";"1";"2";"B";"596";"205";"370";"487";"109";"3";"7";"477";"484"
"43";"Tarragona";"7";"Terres de l'Ebre";"30";"Ribera d'Ebre";"43060";"Flix";"2";"1";"A";"453";"177";"305";"361";"92";"2";"6";"353";"359"
"43";"Tarragona";"7";"Terres de l'Ebre";"30";"Ribera d'Ebre";"43060";"Flix";"2";"1";"B";"429";"141";"279";"344";"85";"0";"3";"341";"344"
"43";"Tarragona";"7";"Terres de l'Ebre";"22";"Montsià";"43062";"Freginals";"1";"1";"U";"275";"136";"208";"235";"40";"2";"5";"228";"233"
"43";"Tarragona";"7";"Terres de l'Ebre";"22";"Montsià";"43063";"Galera, la";"1";"1";"U";"556";"200";"346";"412";"144";"3";"6";"403";"409"
"43";"Tarragona";"7";"Terres de l'Ebre";"37";"Terra Alta";"43064";"Gandesa";"1";"1";"A";"587";"199";"352";"461";"126";"4";"9";"448";"457"
"43";"Tarragona";"7";"Terres de l'Ebre";"37";"Terra Alta";"43064";"Gandesa";"1";"1";"B";"599";"237";"377";"476";"123";"1";"7";"468";"475"
"43";"Tarragona";"7";"Terres de l'Ebre";"37";"Terra Alta";"43064";"Gandesa";"2";"1";"A";"401";"146";"244";"323";"78";"4";"3";"316";"319"
"43";"Tarragona";"7";"Terres de l'Ebre";"37";"Terra Alta";"43064";"Gandesa";"2";"1";"B";"429";"156";"269";"352";"77";"2";"3";"347";"350"
"43";"Tarragona";"7";"Terres de l'Ebre";"30";"Ribera d'Ebre";"43065";"Garcia";"1";"1";"U";"400";"145";"258";"318";"82";"1";"8";"309";"317"
"43";"Tarragona";"7";"Terres de l'Ebre";"30";"Ribera d'Ebre";"43067";"Ginestar";"1";"1";"U";"557";"240";"412";"474";"83";"5";"3";"466";"469"
"43";"Tarragona";"7";"Terres de l'Ebre";"22";"Montsià";"43068";"Godall";"1";"1";"U";"525";"180";"329";"406";"119";"2";"3";"401";"404"
"43";"Tarragona";"7";"Terres de l'Ebre";"37";"Terra Alta";"43071";"Horta de Sant Joan";"1";"1";"A";"467";"164";"312";"388";"79";"6";"4";"378";"382"
"43";"Tarragona";"7";"Terres de l'Ebre";"37";"Terra Alta";"43071";"Horta de Sant Joan";"1";"1";"B";"464";"160";"292";"381";"83";"4";"4";"373";"377"
"43";"Tarragona";"7";"Terres de l'Ebre";"22";"Montsià";"43077";"Mas de Barberans";"1";"1";"U";"464";"180";"267";"330";"134";"3";"5";"322";"327"
"43";"Tarragona";"7";"Terres de l'Ebre";"22";"Montsià";"43078";"Masdenverge";"1";"1";"A";"456";"184";"320";"369";"87";"1";"4";"364";"368"
"43";"Tarragona";"7";"Terres de l'Ebre";"22";"Montsià";"43078";"Masdenverge";"1";"1";"B";"397";"141";"255";"318";"79";"5";"2";"311";"313"
"43";"Tarragona";"7";"Terres de l'Ebre";"30";"Ribera d'Ebre";"43084";"Miravet";"1";"1";"U";"534";"203";"343";"446";"88";"4";"1";"441";"442"
"43";"Tarragona";"7";"Terres de l'Ebre";"30";"Ribera d'Ebre";"43093";"Móra d'Ebre";"1";"1";"A";"589";"204";"370";"462";"127";"7";"7";"448";"455"
"43";"Tarragona";"7";"Terres de l'Ebre";"30";"Ribera d'Ebre";"43093";"Móra d'Ebre";"1";"1";"B";"633";"227";"395";"485";"148";"5";"2";"478";"480"
"43";"Tarragona";"7";"Terres de l'Ebre";"30";"Ribera d'Ebre";"43093";"Móra d'Ebre";"1";"2";"A";"575";"204";"342";"439";"136";"4";"3";"432";"435"
"43";"Tarragona";"7";"Terres de l'Ebre";"30";"Ribera d'Ebre";"43093";"Móra d'Ebre";"1";"2";"B";"528";"179";"317";"409";"119";"0";"3";"406";"409"
"43";"Tarragona";"7";"Terres de l'Ebre";"30";"Ribera d'Ebre";"43093";"Móra d'Ebre";"1";"2";"C";"564";"173";"340";"441";"123";"2";"3";"436";"439"
"43";"Tarragona";"7";"Terres de l'Ebre";"30";"Ribera d'Ebre";"43093";"Móra d'Ebre";"2";"1";"A";"500";"151";"275";"367";"133";"5";"5";"357";"362"
"43";"Tarragona";"7";"Terres de l'Ebre";"30";"Ribera d'Ebre";"43093";"Móra d'Ebre";"2";"1";"B";"527";"183";"317";"404";"123";"3";"2";"399";"401"
"43";"Tarragona";"7";"Terres de l'Ebre";"30";"Ribera d'Ebre";"43094";"Móra la Nova";"1";"1";"A";"664";"225";"403";"516";"148";"7";"3";"506";"509"
"43";"Tarragona";"7";"Terres de l'Ebre";"30";"Ribera d'Ebre";"43094";"Móra la Nova";"1";"1";"B";"625";"219";"406";"507";"118";"2";"7";"498";"505"
"43";"Tarragona";"7";"Terres de l'Ebre";"30";"Ribera d'Ebre";"43094";"Móra la Nova";"2";"1";"A";"423";"153";"278";"348";"75";"4";"3";"341";"344"
"43";"Tarragona";"7";"Terres de l'Ebre";"30";"Ribera d'Ebre";"43094";"Móra la Nova";"2";"1";"B";"464";"149";"270";"347";"117";"3";"1";"343";"344"
"43";"Tarragona";"7";"Terres de l'Ebre";"30";"Ribera d'Ebre";"43099";"Palma d'Ebre, la";"1";"1";"U";"309";"120";"220";"267";"42";"0";"3";"264";"267"
"43";"Tarragona";"7";"Terres de l'Ebre";"9";"Baix Ebre";"43102";"Paüls";"1";"1";"U";"485";"137";"292";"395";"90";"6";"7";"382";"389"
"43";"Tarragona";"7";"Terres de l'Ebre";"9";"Baix Ebre";"43104";"Perelló, el";"1";"1";"U";"568";"262";"385";"456";"112";"2";"13";"441";"454"
"43";"Tarragona";"7";"Terres de l'Ebre";"9";"Baix Ebre";"43104";"Perelló, el";"1";"2";"A";"570";"246";"389";"470";"100";"7";"2";"461";"463"
"43";"Tarragona";"7";"Terres de l'Ebre";"9";"Baix Ebre";"43104";"Perelló, el";"1";"2";"B";"668";"295";"468";"567";"101";"5";"5";"557";"562"
"43";"Tarragona";"7";"Terres de l'Ebre";"37";"Terra Alta";"43106";"Pinell de Brai, el";"1";"1";"A";"360";"120";"246";"301";"59";"4";"6";"291";"297"
"43";"Tarragona";"7";"Terres de l'Ebre";"37";"Terra Alta";"43106";"Pinell de Brai, el";"1";"1";"B";"454";"146";"287";"377";"77";"4";"4";"369";"373"
"43";"Tarragona";"7";"Terres de l'Ebre";"37";"Terra Alta";"43110";"Pobla de Massaluca, la";"1";"1";"U";"271";"76";"156";"206";"65";"0";"3";"203";"206"
"43";"Tarragona";"7";"Terres de l'Ebre";"37";"Terra Alta";"43117";"Prat de Comte";"1";"1";"U";"142";"46";"101";"128";"14";"2";"1";"125";"126"
"43";"Tarragona";"7";"Terres de l'Ebre";"30";"Ribera d'Ebre";"43121";"Rasquera";"1";"1";"U";"606";"199";"386";"483";"123";"5";"1";"477";"478"
"43";"Tarragona";"7";"Terres de l'Ebre";"30";"Ribera d'Ebre";"43125";"Riba-roja d'Ebre";"1";"1";"A";"493";"167";"307";"397";"96";"0";"3";"394";"397"
"43";"Tarragona";"7";"Terres de l'Ebre";"30";"Ribera d'Ebre";"43125";"Riba-roja d'Ebre";"1";"1";"B";"448";"155";"273";"379";"69";"2";"8";"369";"377"
"43";"Tarragona";"7";"Terres de l'Ebre";"9";"Baix Ebre";"43133";"Roquetes";"1";"1";"A";"502";"186";"311";"380";"122";"5";"1";"374";"375"
"43";"Tarragona";"7";"Terres de l'Ebre";"9";"Baix Ebre";"43133";"Roquetes";"1";"1";"B";"471";"142";"269";"330";"141";"4";"1";"325";"326"
"43";"Tarragona";"7";"Terres de l'Ebre";"9";"Baix Ebre";"43133";"Roquetes";"1";"2";"A";"658";"228";"374";"503";"155";"6";"2";"495";"497"
"43";"Tarragona";"7";"Terres de l'Ebre";"9";"Baix Ebre";"43133";"Roquetes";"1";"2";"B";"606";"213";"352";"457";"149";"6";"5";"446";"451"
"43";"Tarragona";"7";"Terres de l'Ebre";"9";"Baix Ebre";"43133";"Roquetes";"2";"1";"A";"625";"195";"387";"471";"154";"1";"3";"467";"470"
"43";"Tarragona";"7";"Terres de l'Ebre";"9";"Baix Ebre";"43133";"Roquetes";"2";"1";"B";"587";"221";"356";"451";"136";"4";"2";"445";"447"
"43";"Tarragona";"7";"Terres de l'Ebre";"9";"Baix Ebre";"43133";"Roquetes";"2";"1";"C";"540";"203";"327";"407";"133";"8";"1";"398";"399"
"43";"Tarragona";"7";"Terres de l'Ebre";"9";"Baix Ebre";"43133";"Roquetes";"2";"2";"A";"569";"189";"314";"396";"173";"4";"6";"386";"392"
"43";"Tarragona";"7";"Terres de l'Ebre";"9";"Baix Ebre";"43133";"Roquetes";"2";"2";"B";"567";"216";"331";"421";"146";"2";"2";"417";"419"
"43";"Tarragona";"7";"Terres de l'Ebre";"9";"Baix Ebre";"43133";"Roquetes";"2";"2";"C";"567";"188";"335";"420";"147";"5";"3";"412";"415"
"43";"Tarragona";"7";"Terres de l'Ebre";"22";"Montsià";"43136";"Sant Carles de la Ràpita";"1";"1";"A";"677";"242";"385";"477";"200";"4";"2";"471";"473"
"43";"Tarragona";"7";"Terres de l'Ebre";"22";"Montsià";"43136";"Sant Carles de la Ràpita";"1";"1";"B";"500";"174";"278";"346";"154";"1";"2";"343";"345"
"43";"Tarragona";"7";"Terres de l'Ebre";"22";"Montsià";"43136";"Sant Carles de la Ràpita";"1";"1";"C";"736";"316";"481";"540";"196";"3";"2";"535";"537"
"43";"Tarragona";"7";"Terres de l'Ebre";"22";"Montsià";"43136";"Sant Carles de la Ràpita";"1";"2";"A";"564";"196";"309";"405";"159";"2";"8";"395";"403"
"43";"Tarragona";"7";"Terres de l'Ebre";"22";"Montsià";"43136";"Sant Carles de la Ràpita";"1";"2";"B";"554";"189";"312";"405";"149";"4";"3";"398";"401"
"43";"Tarragona";"7";"Terres de l'Ebre";"22";"Montsià";"43136";"Sant Carles de la Ràpita";"1";"3";"A";"440";"166";"253";"315";"125";"2";"2";"311";"313"
"43";"Tarragona";"7";"Terres de l'Ebre";"22";"Montsià";"43136";"Sant Carles de la Ràpita";"1";"3";"B";"451";"191";"286";"337";"114";"0";"5";"332";"337"
"43";"Tarragona";"7";"Terres de l'Ebre";"22";"Montsià";"43136";"Sant Carles de la Ràpita";"1";"4";"A";"735";"270";"422";"530";"205";"2";"4";"524";"528"
"43";"Tarragona";"7";"Terres de l'Ebre";"22";"Montsià";"43136";"Sant Carles de la Ràpita";"1";"4";"B";"755";"263";"431";"536";"219";"1";"2";"533";"535"
"43";"Tarragona";"7";"Terres de l'Ebre";"22";"Montsià";"43136";"Sant Carles de la Ràpita";"1";"5";"A";"463";"150";"249";"323";"140";"1";"3";"319";"322"
"43";"Tarragona";"7";"Terres de l'Ebre";"22";"Montsià";"43136";"Sant Carles de la Ràpita";"1";"5";"B";"462";"148";"225";"292";"170";"2";"0";"290";"290"
"43";"Tarragona";"7";"Terres de l'Ebre";"22";"Montsià";"43136";"Sant Carles de la Ràpita";"2";"1";"U";"571";"232";"351";"421";"150";"1";"3";"417";"420"
"43";"Tarragona";"7";"Terres de l'Ebre";"22";"Montsià";"43136";"Sant Carles de la Ràpita";"2";"2";"U";"554";"201";"322";"387";"167";"1";"3";"383";"386"
"43";"Tarragona";"7";"Terres de l'Ebre";"22";"Montsià";"43136";"Sant Carles de la Ràpita";"2";"3";"A";"449";"173";"265";"319";"130";"3";"2";"314";"316"
"43";"Tarragona";"7";"Terres de l'Ebre";"22";"Montsià";"43136";"Sant Carles de la Ràpita";"2";"3";"B";"469";"160";"253";"316";"153";"3";"5";"308";"313"
"43";"Tarragona";"7";"Terres de l'Ebre";"22";"Montsià";"43136";"Sant Carles de la Ràpita";"2";"4";"U";"779";"315";"518";"610";"169";"6";"5";"599";"604"
"43";"Tarragona";"7";"Terres de l'Ebre";"22";"Montsià";"43136";"Sant Carles de la Ràpita";"2";"5";"A";"590";"239";"380";"454";"136";"3";"3";"448";"451"
"43";"Tarragona";"7";"Terres de l'Ebre";"22";"Montsià";"43136";"Sant Carles de la Ràpita";"2";"5";"B";"598";"236";"382";"448";"150";"1";"3";"444";"447"
"43";"Tarragona";"7";"Terres de l'Ebre";"22";"Montsià";"43902";"Sant Jaume d'Enveja";"1";"1";"A";"788";"237";"429";"529";"259";"8";"9";"512";"521"
"43";"Tarragona";"7";"Terres de l'Ebre";"22";"Montsià";"43902";"Sant Jaume d'Enveja";"1";"1";"B";"401";"175";"254";"313";"88";"4";"8";"301";"309"
"43";"Tarragona";"7";"Terres de l'Ebre";"22";"Montsià";"43902";"Sant Jaume d'Enveja";"1";"2";"A";"475";"153";"230";"315";"160";"1";"2";"312";"314"
"43";"Tarragona";"7";"Terres de l'Ebre";"22";"Montsià";"43902";"Sant Jaume d'Enveja";"1";"2";"B";"599";"220";"331";"415";"184";"4";"5";"406";"411"
"43";"Tarragona";"7";"Terres de l'Ebre";"22";"Montsià";"43902";"Sant Jaume d'Enveja";"1";"2";"C";"499";"153";"248";"339";"160";"2";"4";"333";"337"
"43";"Tarragona";"7";"Terres de l'Ebre";"22";"Montsià";"43138";"Santa Bàrbara";"1";"1";"A";"727";"222";"411";"537";"190";"10";"6";"521";"527"
"43";"Tarragona";"7";"Terres de l'Ebre";"22";"Montsià";"43138";"Santa Bàrbara";"1";"1";"B";"734";"240";"405";"541";"193";"13";"3";"525";"528"
"43";"Tarragona";"7";"Terres de l'Ebre";"22";"Montsià";"43138";"Santa Bàrbara";"2";"1";"A";"639";"176";"426";"483";"156";"9";"5";"469";"474"
"43";"Tarragona";"7";"Terres de l'Ebre";"22";"Montsià";"43138";"Santa Bàrbara";"2";"1";"B";"583";"164";"314";"420";"163";"11";"3";"406";"409"
"43";"Tarragona";"7";"Terres de l'Ebre";"22";"Montsià";"43044";"Sénia, la";"1";"1";"A";"709";"235";"420";"530";"179";"1";"4";"525";"529"
"43";"Tarragona";"7";"Terres de l'Ebre";"22";"Montsià";"43044";"Sénia, la";"1";"1";"B";"798";"271";"479";"632";"166";"3";"13";"616";"629"
"43";"Tarragona";"7";"Terres de l'Ebre";"22";"Montsià";"43044";"Sénia, la";"2";"1";"A";"559";"182";"340";"424";"135";"5";"5";"414";"419"
"43";"Tarragona";"7";"Terres de l'Ebre";"22";"Montsià";"43044";"Sénia, la";"2";"1";"B";"472";"141";"285";"362";"110";"4";"10";"348";"358"
"43";"Tarragona";"7";"Terres de l'Ebre";"22";"Montsià";"43044";"Sénia, la";"2";"1";"C";"570";"182";"332";"434";"136";"3";"12";"419";"431"
"43";"Tarragona";"7";"Terres de l'Ebre";"22";"Montsià";"43044";"Sénia, la";"2";"2";"A";"451";"140";"261";"326";"125";"0";"6";"320";"326"
"43";"Tarragona";"7";"Terres de l'Ebre";"22";"Montsià";"43044";"Sénia, la";"2";"2";"B";"421";"140";"271";"331";"90";"4";"7";"320";"327"
"43";"Tarragona";"7";"Terres de l'Ebre";"9";"Baix Ebre";"43149";"Tivenys";"1";"1";"U";"700";"252";"466";"548";"152";"7";"5";"536";"541"
"43";"Tarragona";"7";"Terres de l'Ebre";"30";"Ribera d'Ebre";"43150";"Tivissa";"1";"1";"A";"538";"165";"379";"456";"82";"3";"4";"449";"453"
"43";"Tarragona";"7";"Terres de l'Ebre";"30";"Ribera d'Ebre";"43150";"Tivissa";"1";"1";"B";"556";"174";"397";"479";"77";"6";"4";"469";"473"
"43";"Tarragona";"7";"Terres de l'Ebre";"30";"Ribera d'Ebre";"43150";"Tivissa";"1";"1";"C";"201";"99";"144";"168";"33";"4";"0";"164";"164"
"43";"Tarragona";"7";"Terres de l'Ebre";"30";"Ribera d'Ebre";"43152";"Torre de l'Espanyol, la";"1";"1";"U";"448";"182";"323";"389";"59";"2";"2";"385";"387"
"43";"Tarragona";"7";"Terres de l'Ebre";"9";"Baix Ebre";"43155";"Tortosa";"1";"1";"U";"715";"211";"366";"451";"264";"4";"1";"446";"447"
"43";"Tarragona";"7";"Terres de l'Ebre";"9";"Baix Ebre";"43155";"Tortosa";"1";"2";"U";"507";"200";"318";"402";"105";"3";"1";"398";"399"
"43";"Tarragona";"7";"Terres de l'Ebre";"9";"Baix Ebre";"43155";"Tortosa";"1";"3";"A";"421";"177";"266";"324";"97";"2";"3";"319";"322"
"43";"Tarragona";"7";"Terres de l'Ebre";"9";"Baix Ebre";"43155";"Tortosa";"1";"3";"B";"411";"171";"262";"330";"81";"3";"0";"327";"327"
"43";"Tarragona";"7";"Terres de l'Ebre";"9";"Baix Ebre";"43155";"Tortosa";"1";"4";"A";"717";"285";"478";"575";"142";"0";"6";"569";"575"
"43";"Tarragona";"7";"Terres de l'Ebre";"9";"Baix Ebre";"43155";"Tortosa";"1";"4";"B";"643";"267";"405";"502";"141";"2";"4";"496";"500"
"43";"Tarragona";"7";"Terres de l'Ebre";"9";"Baix Ebre";"43155";"Tortosa";"1";"5";"U";"603";"158";"221";"257";"346";"2";"4";"251";"255"
"43";"Tarragona";"7";"Terres de l'Ebre";"9";"Baix Ebre";"43155";"Tortosa";"1";"6";"U";"767";"295";"450";"549";"218";"3";"3";"543";"546"
"43";"Tarragona";"7";"Terres de l'Ebre";"9";"Baix Ebre";"43155";"Tortosa";"1";"7";"A";"791";"285";"507";"621";"170";"3";"3";"615";"618"
"43";"Tarragona";"7";"Terres de l'Ebre";"9";"Baix Ebre";"43155";"Tortosa";"1";"7";"B";"514";"201";"322";"399";"115";"1";"3";"395";"398"
"43";"Tarragona";"7";"Terres de l'Ebre";"9";"Baix Ebre";"43155";"Tortosa";"1";"7";"C";"676";"262";"427";"530";"146";"2";"3";"525";"528"
"43";"Tarragona";"7";"Terres de l'Ebre";"9";"Baix Ebre";"43155";"Tortosa";"2";"2";"A";"742";"250";"443";"590";"152";"1";"8";"581";"589"
"43";"Tarragona";"7";"Terres de l'Ebre";"9";"Baix Ebre";"43155";"Tortosa";"2";"2";"B";"704";"239";"458";"555";"149";"5";"5";"545";"550"
"43";"Tarragona";"7";"Terres de l'Ebre";"9";"Baix Ebre";"43155";"Tortosa";"2";"3";"A";"545";"232";"330";"419";"126";"1";"5";"413";"418"
"43";"Tarragona";"7";"Terres de l'Ebre";"9";"Baix Ebre";"43155";"Tortosa";"2";"3";"B";"592";"218";"351";"445";"147";"3";"3";"439";"442"
"43";"Tarragona";"7";"Terres de l'Ebre";"9";"Baix Ebre";"43155";"Tortosa";"2";"4";"U";"654";"214";"352";"466";"188";"4";"1";"461";"462"
"43";"Tarragona";"7";"Terres de l'Ebre";"9";"Baix Ebre";"43155";"Tortosa";"2";"5";"A";"472";"180";"298";"363";"109";"3";"2";"358";"360"
"43";"Tarragona";"7";"Terres de l'Ebre";"9";"Baix Ebre";"43155";"Tortosa";"2";"5";"B";"448";"170";"274";"336";"112";"1";"3";"332";"335"
"43";"Tarragona";"7";"Terres de l'Ebre";"9";"Baix Ebre";"43155";"Tortosa";"3";"1";"U";"486";"170";"237";"294";"192";"0";"2";"292";"294"
"43";"Tarragona";"7";"Terres de l'Ebre";"9";"Baix Ebre";"43155";"Tortosa";"3";"2";"A";"479";"181";"298";"386";"93";"3";"9";"374";"383"
"43";"Tarragona";"7";"Terres de l'Ebre";"9";"Baix Ebre";"43155";"Tortosa";"3";"2";"B";"436";"207";"240";"327";"109";"4";"1";"322";"323"
"43";"Tarragona";"7";"Terres de l'Ebre";"9";"Baix Ebre";"43155";"Tortosa";"3";"3";"A";"551";"150";"252";"348";"203";"5";"2";"341";"343"
"43";"Tarragona";"7";"Terres de l'Ebre";"9";"Baix Ebre";"43155";"Tortosa";"3";"3";"B";"346";"102";"171";"225";"121";"8";"1";"216";"217"
"43";"Tarragona";"7";"Terres de l'Ebre";"9";"Baix Ebre";"43155";"Tortosa";"3";"4";"A";"672";"238";"390";"495";"177";"4";"6";"485";"491"
"43";"Tarragona";"7";"Terres de l'Ebre";"9";"Baix Ebre";"43155";"Tortosa";"3";"4";"B";"611";"197";"328";"427";"184";"0";"4";"423";"427"
"43";"Tarragona";"7";"Terres de l'Ebre";"9";"Baix Ebre";"43155";"Tortosa";"4";"1";"A";"535";"211";"341";"418";"117";"3";"2";"413";"415"
"43";"Tarragona";"7";"Terres de l'Ebre";"9";"Baix Ebre";"43155";"Tortosa";"4";"1";"B";"486";"166";"303";"369";"117";"1";"8";"360";"368"
"43";"Tarragona";"7";"Terres de l'Ebre";"9";"Baix Ebre";"43155";"Tortosa";"4";"2";"A";"476";"145";"266";"339";"137";"1";"8";"330";"338"
"43";"Tarragona";"7";"Terres de l'Ebre";"9";"Baix Ebre";"43155";"Tortosa";"4";"2";"B";"456";"176";"261";"335";"121";"1";"3";"331";"334"
"43";"Tarragona";"7";"Terres de l'Ebre";"9";"Baix Ebre";"43155";"Tortosa";"4";"3";"A";"526";"174";"282";"350";"176";"3";"1";"346";"347"
"43";"Tarragona";"7";"Terres de l'Ebre";"9";"Baix Ebre";"43155";"Tortosa";"4";"3";"B";"551";"175";"290";"363";"188";"4";"5";"354";"359"
"43";"Tarragona";"7";"Terres de l'Ebre";"9";"Baix Ebre";"43155";"Tortosa";"4";"4";"U";"608";"171";"280";"380";"228";"4";"3";"373";"376"
"43";"Tarragona";"7";"Terres de l'Ebre";"9";"Baix Ebre";"43155";"Tortosa";"4";"5";"A";"648";"236";"390";"499";"149";"4";"1";"494";"495"
"43";"Tarragona";"7";"Terres de l'Ebre";"9";"Baix Ebre";"43155";"Tortosa";"4";"5";"B";"535";"205";"329";"406";"129";"3";"3";"400";"403"
"43";"Tarragona";"7";"Terres de l'Ebre";"9";"Baix Ebre";"43155";"Tortosa";"4";"6";"A";"547";"176";"344";"408";"139";"2";"1";"405";"406"
"43";"Tarragona";"7";"Terres de l'Ebre";"9";"Baix Ebre";"43155";"Tortosa";"4";"6";"B";"495";"142";"337";"373";"122";"0";"0";"373";"373"
"43";"Tarragona";"7";"Terres de l'Ebre";"9";"Baix Ebre";"43155";"Tortosa";"4";"7";"A";"517";"180";"314";"381";"136";"1";"2";"378";"380"
"43";"Tarragona";"7";"Terres de l'Ebre";"9";"Baix Ebre";"43155";"Tortosa";"4";"7";"B";"262";"89";"154";"200";"62";"1";"2";"197";"199"
"43";"Tarragona";"7";"Terres de l'Ebre";"9";"Baix Ebre";"43155";"Tortosa";"4";"8";"U";"635";"223";"396";"497";"138";"1";"4";"492";"496"
"43";"Tarragona";"7";"Terres de l'Ebre";"9";"Baix Ebre";"43155";"Tortosa";"4";"9";"A";"571";"185";"337";"415";"156";"2";"4";"409";"413"
"43";"Tarragona";"7";"Terres de l'Ebre";"9";"Baix Ebre";"43155";"Tortosa";"4";"9";"B";"509";"178";"308";"369";"140";"2";"2";"365";"367"
"43";"Tarragona";"7";"Terres de l'Ebre";"22";"Montsià";"43156";"Ulldecona";"1";"1";"A";"437";"159";"271";"337";"100";"4";"3";"330";"333"
"43";"Tarragona";"7";"Terres de l'Ebre";"22";"Montsià";"43156";"Ulldecona";"1";"1";"B";"426";"164";"265";"340";"86";"5";"4";"331";"335"
"43";"Tarragona";"7";"Terres de l'Ebre";"22";"Montsià";"43156";"Ulldecona";"1";"1";"C";"436";"140";"263";"335";"101";"0";"3";"332";"335"
"43";"Tarragona";"7";"Terres de l'Ebre";"22";"Montsià";"43156";"Ulldecona";"1";"2";"A";"585";"146";"347";"443";"142";"8";"4";"431";"435"
"43";"Tarragona";"7";"Terres de l'Ebre";"22";"Montsià";"43156";"Ulldecona";"1";"2";"B";"547";"181";"312";"405";"142";"6";"4";"395";"399"
"43";"Tarragona";"7";"Terres de l'Ebre";"22";"Montsià";"43156";"Ulldecona";"1";"2";"C";"559";"218";"350";"446";"113";"4";"9";"433";"442"
"43";"Tarragona";"7";"Terres de l'Ebre";"22";"Montsià";"43156";"Ulldecona";"2";"1";"A";"493";"178";"281";"356";"137";"3";"2";"351";"353"
"43";"Tarragona";"7";"Terres de l'Ebre";"22";"Montsià";"43156";"Ulldecona";"2";"1";"B";"499";"178";"279";"373";"126";"3";"4";"366";"370"
"43";"Tarragona";"7";"Terres de l'Ebre";"37";"Terra Alta";"43175";"Vilalba dels Arcs";"1";"1";"U";"569";"194";"355";"467";"102";"2";"3";"462";"465"
"43";"Tarragona";"7";"Terres de l'Ebre";"30";"Ribera d'Ebre";"43177";"Vinebre";"1";"1";"U";"295";"115";"200";"258";"37";"2";"4";"252";"256"
"43";"Tarragona";"7";"Terres de l'Ebre";"9";"Baix Ebre";"43052";"Xerta";"1";"1";"A";"484";"196";"340";"399";"85";"0";"7";"392";"399"
"43";"Tarragona";"7";"Terres de l'Ebre";"9";"Baix Ebre";"43052";"Xerta";"1";"1";"B";"467";"175";"346";"396";"71";"10";"5";"381";"386"
